,total_wells_within_5_mils,close_functional_wells,close_non_functional_wells,close_functional_needs_repair_wells,close_unknown_wells,close_known_wells
36879,428,196,136,11,85,343
36880,40,30,1,2,7,33
36881,14,8,4,1,1,13
36882,363,196,91,15,61,302
36883,43,31,3,2,7,36
36884,23,15,3,0,5,18
36885,666,386,150,18,112,554
36886,68,41,8,8,11,57
36887,422,239,95,0,88,334
36888,170,81,54,3,32,138
36889,85,64,5,4,12,73
36890,32,21,9,0,2,30
36891,3,1,0,0,2,1
36892,16,3,7,0,6,10
36893,136,90,16,3,27,109
36894,110,31,39,16,24,86
36895,17,7,7,0,3,14
36896,116,49,32,14,21,95
36897,240,17,181,0,42,198
36898,74,16,16,30,12,62
36899,98,43,37,4,14,84
36900,82,43,21,3,15,67
36901,665,390,141,17,117,548
36902,45,29,7,0,9,36
36903,64,37,13,0,14,50
36904,90,55,19,3,13,77
36905,18,10,7,0,1,17
36906,32,15,10,0,7,25
36907,247,103,15,82,47,200
36908,55,21,23,0,11,44
36909,17,14,3,0,0,17
36910,455,157,156,47,95,360
36911,200,88,54,20,38,162
36912,65,19,16,16,14,51
36913,73,30,20,1,22,51
36914,30,11,13,0,6,24
36915,7,5,0,0,2,5
36916,36,14,17,0,5,31
36917,106,62,23,0,21,85
36918,100,84,2,3,11,89
36919,82,48,12,3,19,63
36920,35,26,0,0,9,26
36921,50,16,4,21,9,41
36922,225,53,24,111,37,188
36923,629,355,153,19,102,527
36924,5,0,3,0,2,3
36925,89,38,20,8,23,66
36926,130,99,3,0,28,102
36927,148,68,52,5,23,125
36928,9,6,2,0,1,8
36929,209,89,66,19,35,174
36930,64,47,8,0,9,55
36931,11,5,5,0,1,10
36932,433,214,79,51,89,344
36933,88,44,26,0,18,70
36934,113,78,18,0,17,96
36935,119,25,64,0,30,89
36936,18,7,5,0,6,12
36937,58,36,14,0,8,50
36938,99,45,35,4,15,84
36939,326,89,154,7,76,250
36940,78,22,41,2,13,65
36941,46,18,20,0,8,38
36942,66,37,18,0,11,55
36943,92,32,39,9,12,80
36944,37,6,26,0,5,32
36945,32,21,9,0,2,30
36946,198,78,37,32,51,147
36947,241,163,18,3,57,184
36948,343,176,94,5,68,275
36949,8,3,3,0,2,6
36950,231,153,60,2,16,215
36951,22,5,15,0,2,20
36952,24,14,5,0,5,19
36953,264,98,110,6,50,214
36954,91,36,21,8,26,65
36955,184,91,32,29,32,152
36956,278,95,125,14,44,234
36957,71,25,29,0,17,54
36958,58,47,0,0,11,47
36959,34,22,6,0,6,28
36960,32,21,9,0,2,30
36961,69,59,0,0,10,59
36962,104,27,49,0,28,76
36963,82,55,7,1,19,63
36964,25,18,3,0,4,21
36965,103,48,36,0,19,84
36966,34,20,7,2,5,29
36967,30,12,14,0,4,26
36968,8,3,2,0,3,5
36969,52,23,19,2,8,44
36970,37,12,20,1,4,33
36971,108,33,55,0,20,88
36972,92,60,16,0,16,76
36973,79,12,51,0,16,63
36974,36,25,5,0,6,30
36975,76,34,22,3,17,59
36976,14,2,12,0,0,14
36977,22,1,17,0,4,18
36978,70,37,14,0,19,51
36979,15,4,5,1,5,10
36980,24,18,0,0,6,18
36981,259,62,48,106,43,216
36982,109,29,60,0,20,89
36983,46,18,20,0,8,38
36984,8,0,5,0,3,5
36985,491,247,94,51,99,392
36986,66,21,30,2,13,53
36987,46,18,20,0,8,38
36988,71,43,12,2,14,57
36989,197,118,14,23,42,155
36990,34,12,13,2,7,27
36991,8,1,3,2,2,6
36992,73,38,18,4,13,60
36993,124,33,68,0,23,101
36994,14,4,2,5,3,11
36995,113,68,21,7,17,96
36996,26,16,6,4,0,26
36997,23,5,15,0,3,20
36998,61,34,5,7,15,46
36999,40,31,6,3,0,40
37000,195,99,34,29,33,162
37001,220,73,82,15,50,170
37002,51,28,10,0,13,38
37003,141,67,37,0,37,104
37004,6,2,3,0,1,5
37005,109,34,53,1,21,88
37006,6,6,0,0,0,6
37007,354,189,93,15,57,297
37008,45,31,9,0,5,40
37009,141,77,25,7,32,109
37010,32,15,8,0,9,23
37011,61,11,40,0,10,51
37012,18,9,4,2,3,15
37013,177,101,31,0,45,132
37014,69,34,17,2,16,53
37015,142,86,29,0,27,115
37016,97,24,57,2,14,83
37017,12,3,4,0,5,7
37018,139,108,5,0,26,113
37019,273,20,194,2,57,216
37020,37,8,18,3,8,29
37021,59,37,9,1,12,47
37022,19,7,4,1,7,12
37023,52,12,23,4,13,39
37024,72,24,28,8,12,60
37025,401,187,116,13,85,316
37026,15,7,4,0,4,11
37027,137,71,43,11,12,125
37028,45,1,35,2,7,38
37029,34,22,5,2,5,29
37030,35,4,22,0,9,26
37031,64,15,39,0,10,54
37032,41,12,16,1,12,29
37033,4,2,1,0,1,3
37034,32,21,9,0,2,30
37035,46,28,9,0,9,37
37036,8,2,4,0,2,6
37037,28,16,8,0,4,24
37038,61,19,25,4,13,48
37039,31,16,10,1,4,27
37040,92,20,40,10,22,70
37041,384,186,103,17,78,306
37042,70,44,5,2,19,51
37043,32,12,2,14,4,28
37044,151,52,40,31,28,123
37045,5,3,1,0,1,4
37046,54,29,13,3,9,45
37047,34,16,8,4,6,28
37048,52,8,27,4,13,39
37049,40,8,18,2,12,28
37050,73,24,26,0,23,50
37051,47,17,21,0,9,38
37052,26,1,7,13,5,21
37053,77,44,21,0,12,65
37054,47,27,9,2,9,38
37055,43,12,20,3,8,35
37056,60,21,26,0,13,47
37057,39,16,11,1,11,28
37058,73,49,8,0,16,57
37059,442,253,83,12,94,348
37060,46,28,2,5,11,35
37061,61,35,16,1,9,52
37062,113,71,16,3,23,90
37063,38,0,33,1,4,34
37064,67,44,9,0,14,53
37065,92,10,60,5,17,75
37066,133,50,43,11,29,104
37067,68,45,5,3,15,53
37068,200,133,20,0,47,153
37069,17,8,5,0,4,13
37070,185,54,103,4,24,161
37071,348,157,112,9,70,278
37072,122,67,35,1,19,103
37073,43,15,16,8,4,39
37074,76,21,27,12,16,60
37075,87,51,19,4,13,74
37076,16,7,6,0,3,13
37077,0,0,0,0,0,0
37078,218,110,68,6,34,184
37079,52,9,19,19,5,47
37080,60,35,14,1,10,50
37081,34,26,1,3,4,30
37082,49,22,15,2,10,39
37083,32,21,9,0,2,30
37084,133,69,20,18,26,107
37085,103,67,1,13,22,81
37086,2,2,0,0,0,2
37087,14,5,3,3,3,11
37088,130,42,49,14,25,105
37089,55,26,8,8,13,42
37090,10,5,5,0,0,10
37091,60,32,17,0,11,49
37092,77,10,52,1,14,63
37093,21,10,6,2,3,18
37094,79,37,28,4,10,69
37095,35,19,8,0,8,27
37096,118,32,44,15,27,91
37097,17,4,11,0,2,15
37098,52,32,11,0,9,43
37099,25,10,11,0,4,21
37100,64,41,5,0,18,46
37101,64,32,7,5,20,44
37102,21,8,5,1,7,14
37103,27,7,14,3,3,24
37104,34,18,6,1,9,25
37105,40,20,10,1,9,31
37106,61,17,35,1,8,53
37107,57,24,23,1,9,48
37108,117,90,6,0,21,96
37109,161,83,40,0,38,123
37110,37,8,19,0,10,27
37111,35,15,13,0,7,28
37112,35,16,10,1,8,27
37113,32,21,9,0,2,30
37114,37,14,10,0,13,24
37115,25,7,10,1,7,18
37116,51,25,19,0,7,44
37117,185,92,55,0,38,147
37118,87,22,45,1,19,68
37119,128,108,2,0,18,110
37120,59,28,17,3,11,48
37121,51,25,18,0,8,43
37122,16,9,6,0,1,15
37123,94,43,28,3,20,74
37124,91,63,6,7,15,76
37125,259,119,76,12,52,207
37126,22,8,6,1,7,15
37127,83,53,17,0,13,70
37128,46,25,11,4,6,40
37129,132,38,67,5,22,110
37130,26,11,7,2,6,20
37131,118,41,45,6,26,92
37132,38,20,13,0,5,33
37133,434,231,109,20,74,360
37134,157,71,51,6,29,128
37135,86,54,12,2,18,68
37136,19,3,8,0,8,11
37137,85,20,48,0,17,68
37138,60,24,23,3,10,50
37139,513,272,86,47,108,405
37140,19,8,4,2,5,14
37141,161,48,87,4,22,139
37142,21,14,5,0,2,19
37143,44,27,7,2,8,36
37144,9,1,3,4,1,8
37145,201,52,22,94,33,168
37146,62,42,6,0,14,48
37147,85,24,22,21,18,67
37148,101,27,57,0,17,84
37149,92,41,30,0,21,71
37150,117,48,10,30,29,88
37151,33,8,15,0,10,23
37152,117,48,10,30,29,88
37153,50,29,13,1,7,43
37154,36,23,3,0,10,26
37155,17,9,6,0,2,15
37156,143,57,57,8,21,122
37157,41,22,4,8,7,34
37158,417,97,176,48,96,321
37159,74,37,17,3,17,57
37160,240,60,101,18,61,179
37161,56,18,28,0,10,46
37162,26,14,6,0,6,20
37163,46,18,20,0,8,38
37164,332,108,140,16,68,264
37165,110,69,15,3,23,87
37166,24,13,3,5,3,21
37167,140,62,28,19,31,109
37168,106,26,57,3,20,86
37169,19,13,2,0,4,15
37170,29,9,12,0,8,21
37171,77,33,16,13,15,62
37172,150,61,34,19,36,114
37173,115,84,7,0,24,91
37174,265,75,128,4,58,207
37175,276,26,193,2,55,221
37176,74,11,49,0,14,60
37177,38,8,19,2,9,29
37178,37,17,6,2,12,25
37179,203,83,36,33,51,152
37180,227,125,65,0,37,190
37181,560,318,119,16,107,453
37182,70,1,55,0,14,56
37183,68,35,19,0,14,54
37184,19,6,9,1,3,16
37185,56,37,12,0,7,49
37186,109,103,0,6,0,109
37187,54,27,8,8,11,43
37188,91,49,11,10,21,70
37189,32,21,9,0,2,30
37190,64,45,12,1,6,58
37191,39,8,26,3,2,37
37192,342,145,121,6,70,272
37193,205,126,38,5,36,169
37194,133,99,6,0,28,105
37195,46,18,20,0,8,38
37196,37,9,24,1,3,34
37197,22,4,11,3,4,18
37198,76,20,35,7,14,62
37199,33,20,9,0,4,29
37200,90,72,3,1,14,76
37201,17,6,9,1,1,16
37202,46,18,20,0,8,38
37203,46,24,9,2,11,35
37204,15,3,8,0,4,11
37205,259,148,42,16,53,206
37206,163,55,50,24,34,129
37207,451,150,158,46,97,354
37208,75,36,15,6,18,57
37209,163,70,34,19,40,123
37210,55,11,33,0,11,44
37211,32,21,9,0,2,30
37212,60,18,18,8,16,44
37213,140,28,58,21,33,107
37214,352,185,93,15,59,293
37215,155,74,49,1,31,124
37216,46,27,11,0,8,38
37217,24,10,11,1,2,22
37218,76,36,21,2,17,59
37219,37,17,13,1,6,31
37220,146,36,76,1,33,113
37221,32,21,9,0,2,30
37222,2,1,1,0,0,2
37223,30,21,4,0,5,25
37224,58,37,12,0,9,49
37225,13,0,11,0,2,11
37226,100,66,15,0,19,81
37227,24,15,4,0,5,19
37228,483,233,95,49,106,377
37229,81,40,23,2,16,65
37230,284,127,102,2,53,231
37231,335,202,63,0,70,265
37232,26,18,2,0,6,20
37233,14,7,5,0,2,12
37234,93,53,23,4,13,80
37235,48,14,14,7,13,35
37236,9,2,2,4,1,8
37237,380,196,89,13,82,298
37238,178,114,23,9,32,146
37239,151,24,98,1,28,123
37240,63,16,8,26,13,50
37241,97,48,16,2,31,66
37242,448,237,108,14,89,359
37243,46,18,20,0,8,38
37244,37,10,18,2,7,30
37245,41,13,18,3,7,34
37246,20,9,5,0,6,14
37247,33,9,12,6,6,27
37248,52,11,26,3,12,40
37249,38,15,17,0,6,32
37250,55,24,14,2,15,40
37251,62,38,13,1,10,52
37252,72,22,26,2,22,50
37253,128,53,32,19,24,104
37254,108,52,31,5,20,88
37255,11,2,8,0,1,10
37256,155,121,9,3,22,133
37257,37,18,4,4,11,26
37258,41,10,23,1,7,34
37259,114,87,5,0,22,92
37260,186,123,27,5,31,155
37261,2,2,0,0,0,2
37262,91,44,18,10,19,72
37263,30,10,18,1,1,29
37264,87,56,13,0,18,69
37265,68,26,26,4,12,56
37266,155,119,2,2,32,123
37267,103,20,60,1,22,81
37268,2,0,2,0,0,2
37269,96,36,31,6,23,73
37270,38,13,16,1,8,30
37271,119,32,33,29,25,94
37272,137,63,42,10,22,115
37273,45,25,10,0,10,35
37274,80,52,5,0,23,57
37275,46,18,20,0,8,38
37276,210,61,102,4,43,167
37277,87,39,25,3,20,67
37278,36,30,0,1,5,31
37279,95,39,28,0,28,67
37280,21,12,4,0,5,16
37281,63,25,19,5,14,49
37282,10,4,5,0,1,9
37283,24,3,11,1,9,15
37284,57,36,7,0,14,43
37285,17,4,7,0,6,11
37286,13,7,3,1,2,11
37287,524,236,135,41,112,412
37288,16,1,11,0,4,12
37289,87,44,24,2,17,70
37290,33,3,6,16,8,25
37291,177,85,26,25,41,136
37292,25,10,9,0,6,19
37293,56,37,12,0,7,49
37294,28,9,12,1,6,22
37295,126,42,45,7,32,94
37296,71,20,39,1,11,60
37297,597,416,51,1,129,468
37298,14,10,2,0,2,12
37299,138,40,68,1,29,109
37300,154,78,45,1,30,124
37301,376,176,123,8,69,307
37302,130,31,71,1,27,103
37303,46,18,20,0,8,38
37304,194,52,78,15,49,145
37305,18,8,2,2,6,12
37306,103,67,25,1,10,93
37307,93,33,40,9,11,82
37308,127,49,43,8,27,100
37309,92,38,34,3,17,75
37310,61,41,1,4,15,46
37311,27,8,12,1,6,21
37312,31,17,9,1,4,27
37313,173,80,55,3,35,138
37314,103,41,27,12,23,80
37315,35,8,16,2,9,26
37316,25,4,13,0,8,17
37317,32,14,11,0,7,25
37318,121,48,37,8,28,93
37319,74,43,18,0,13,61
37320,25,9,10,2,4,21
37321,19,3,12,0,4,15
37322,655,382,143,17,113,542
37323,6,0,4,0,2,4
37324,11,3,6,0,2,9
37325,50,26,15,0,9,41
37326,182,6,147,0,29,153
37327,119,50,38,2,29,90
37328,90,29,32,11,18,72
37329,8,4,3,0,1,7
37330,55,38,6,1,10,45
37331,101,24,33,26,18,83
37332,88,64,5,0,19,69
37333,330,140,115,6,69,261
37334,85,55,19,2,9,76
37335,29,14,12,2,1,28
37336,45,21,12,2,10,35
37337,33,6,19,0,8,25
37338,45,32,5,2,6,39
37339,94,58,19,2,15,79
37340,58,28,8,9,13,45
37341,32,21,2,0,9,23
37342,19,7,8,0,4,15
37343,618,423,59,2,134,484
37344,559,404,40,1,114,445
37345,36,12,16,1,7,29
37346,193,111,21,24,37,156
37347,255,57,131,4,63,192
37348,41,15,13,2,11,30
37349,9,0,9,0,0,9
37350,164,79,27,24,34,130
37351,39,10,25,0,4,35
37352,123,44,38,21,20,103
37353,31,8,20,0,3,28
37354,84,33,10,18,23,61
37355,48,37,1,0,10,38
37356,37,15,4,9,9,28
37357,48,11,23,0,14,34
37358,294,70,46,129,49,245
37359,53,32,5,0,16,37
37360,378,203,106,0,69,309
37361,0,0,0,0,0,0
37362,189,87,44,20,38,151
37363,32,21,9,0,2,30
37364,179,76,27,31,45,134
37365,114,42,28,24,20,94
37366,220,88,72,20,40,180
37367,364,192,103,3,66,298
37368,72,70,0,2,0,72
37369,43,31,7,0,5,38
37370,31,4,9,10,8,23
37371,85,49,23,1,12,73
37372,11,2,7,0,2,9
37373,3,2,0,0,1,2
37374,41,10,25,4,2,39
37375,32,21,9,0,2,30
37376,55,26,15,2,12,43
37377,38,11,21,1,5,33
37378,78,22,27,10,19,59
37379,31,9,12,0,10,21
37380,88,29,30,11,18,70
37381,8,3,3,0,2,6
37382,50,20,17,3,10,40
37383,9,7,2,0,0,9
37384,32,12,12,0,8,24
37385,31,18,9,0,4,27
37386,22,16,4,0,2,20
37387,41,30,9,2,0,41
37388,38,23,9,2,4,34
37389,29,4,20,0,5,24
37390,128,47,46,8,27,101
37391,32,21,9,0,2,30
37392,176,77,28,28,43,133
37393,69,44,7,3,15,54
37394,74,5,55,1,13,61
37395,263,201,15,0,47,216
37396,59,14,39,0,6,53
37397,56,20,25,1,10,46
37398,477,218,165,12,82,395
37399,58,19,12,19,8,50
37400,156,90,28,1,37,119
37401,70,44,14,0,12,58
37402,100,53,24,4,19,81
37403,284,151,69,16,48,236
37404,90,32,33,5,20,70
37405,106,40,30,9,27,79
37406,79,15,56,2,6,73
37407,242,101,14,82,45,197
37408,15,10,3,0,2,13
37409,70,17,37,3,13,57
37410,51,26,6,9,10,41
37411,15,3,11,0,1,14
37412,106,38,25,20,23,83
37413,256,57,138,3,58,198
37414,487,281,64,41,101,386
37415,42,18,10,3,11,31
37416,214,85,14,77,38,176
37417,88,62,5,0,21,67
37418,95,58,11,2,24,71
37419,58,35,9,4,10,48
37420,19,14,3,0,2,17
37421,41,3,29,2,7,34
37422,75,30,21,6,18,57
37423,221,89,75,19,38,183
37424,72,54,2,0,16,56
37425,275,82,131,17,45,230
37426,221,90,41,38,52,169
37427,71,22,28,3,18,53
37428,69,5,48,1,15,54
37429,88,43,19,4,22,66
37430,15,8,4,0,3,12
37431,74,56,7,0,11,63
37432,34,5,22,0,7,27
37433,157,75,42,8,32,125
37434,8,6,2,0,0,8
37435,26,9,8,3,6,20
37436,20,3,0,9,8,12
37437,19,12,1,0,6,13
37438,43,17,16,0,10,33
37439,46,18,20,0,8,38
37440,23,8,8,3,4,19
37441,78,22,25,9,22,56
37442,120,55,34,3,28,92
37443,55,34,9,0,12,43
37444,25,5,1,15,4,21
37445,21,6,10,1,4,17
37446,98,94,0,4,0,98
37447,68,46,7,0,15,53
37448,96,33,26,15,22,74
37449,43,17,22,0,4,39
37450,28,14,7,0,7,21
37451,479,130,201,39,109,370
37452,14,4,6,1,3,11
37453,10,4,5,0,1,9
37454,79,32,22,11,14,65
37455,84,38,23,1,22,62
37456,145,49,71,0,25,120
37457,74,50,12,0,12,62
37458,208,95,34,25,54,154
37459,120,81,11,3,25,95
37460,34,25,2,0,7,27
37461,19,7,7,0,5,14
37462,432,197,105,40,90,342
37463,61,48,1,0,12,49
37464,65,49,6,0,10,55
37465,227,77,88,14,48,179
37466,13,4,3,1,5,8
37467,42,15,21,0,6,36
37468,36,16,8,3,9,27
37469,22,4,14,1,3,19
37470,100,37,41,9,13,87
37471,169,82,52,3,32,137
37472,20,9,5,0,6,14
37473,56,38,7,1,10,46
37474,110,34,36,14,26,84
37475,157,68,25,25,39,118
37476,163,69,35,20,39,124
37477,32,20,5,1,6,26
37478,17,3,12,0,2,15
37479,180,136,3,2,39,141
37480,4,2,0,0,2,2
37481,53,28,19,0,6,47
37482,74,6,43,6,19,55
37483,47,28,10,0,9,38
37484,67,33,11,6,17,50
37485,285,117,120,3,45,240
37486,364,150,95,39,80,284
37487,99,49,22,7,21,78
37488,55,33,6,7,9,46
37489,82,25,41,2,14,68
37490,54,6,15,22,11,43
37491,13,6,4,1,2,11
37492,31,25,4,0,2,29
37493,25,11,12,0,2,23
37494,121,78,12,4,27,94
37495,34,25,2,0,7,27
37496,13,4,7,2,0,13
37497,155,79,45,1,30,125
37498,44,35,2,0,7,37
37499,43,8,22,0,13,30
37500,471,137,193,35,106,365
37501,533,326,91,5,111,422
37502,228,98,15,75,40,188
37503,117,38,39,13,27,90
37504,63,31,16,0,16,47
37505,55,40,8,0,7,48
37506,53,35,3,6,9,44
37507,55,37,8,1,9,46
37508,361,187,92,19,63,298
37509,75,63,1,2,9,66
37510,32,21,9,0,2,30
37511,73,35,21,2,15,58
37512,42,11,20,0,11,31
37513,124,59,32,0,33,91
37514,59,44,12,0,3,56
37515,33,11,10,5,7,26
37516,140,81,29,4,26,114
37517,121,43,53,1,24,97
37518,27,14,2,4,7,20
37519,34,15,12,1,6,28
37520,389,106,185,6,92,297
37521,25,5,14,0,6,19
37522,8,7,1,0,0,8
37523,359,191,101,3,64,295
37524,116,52,23,16,25,91
37525,143,49,33,28,33,110
37526,108,34,52,1,21,87
37527,6,1,5,0,0,6
37528,498,257,109,30,102,396
37529,34,7,8,7,12,22
37530,81,28,30,10,13,68
37531,43,9,17,8,9,34
37532,389,283,19,2,85,304
37533,54,35,7,0,12,42
37534,33,12,10,1,10,23
37535,89,33,38,3,15,74
37536,17,9,0,3,5,12
37537,252,132,81,0,39,213
37538,26,15,6,0,5,21
37539,32,21,9,0,2,30
37540,102,34,24,25,19,83
37541,8,4,1,1,2,6
37542,58,42,7,4,5,53
37543,36,11,18,0,7,29
37544,56,37,12,0,7,49
37545,13,6,6,0,1,12
37546,53,32,5,0,16,37
37547,322,172,87,13,50,272
37548,12,8,3,0,1,11
37549,61,19,31,1,10,51
37550,76,30,34,2,10,66
37551,202,49,40,77,36,166
37552,45,28,10,0,7,38
37553,32,5,8,10,9,23
37554,113,72,24,0,17,96
37555,45,24,11,0,10,35
37556,24,7,13,0,4,20
37557,60,7,38,0,15,45
37558,419,208,102,23,86,333
37559,476,131,200,38,107,369
37560,41,11,10,14,6,35
37561,65,19,27,3,16,49
37562,53,32,4,7,10,43
37563,84,39,28,1,16,68
37564,18,8,4,1,5,13
37565,71,26,27,1,17,54
37566,129,90,10,2,27,102
37567,57,35,3,10,9,48
37568,130,75,28,0,27,103
37569,219,124,42,12,41,178
37570,38,18,12,1,7,31
37571,113,82,13,0,18,95
37572,11,1,6,0,4,7
37573,323,139,113,10,61,262
37574,70,22,36,0,12,58
37575,127,66,12,21,28,99
37576,44,29,2,1,12,32
37577,45,6,20,12,7,38
37578,10,4,4,0,2,8
37579,36,18,9,3,6,30
37580,197,97,31,33,36,161
37581,107,83,3,0,21,86
37582,67,17,30,11,9,58
37583,44,29,7,0,8,36
37584,48,37,0,1,10,38
37585,36,15,20,0,1,35
37586,33,24,5,0,4,29
37587,20,6,0,7,7,13
37588,27,13,10,0,4,23
37589,332,168,99,5,60,272
37590,428,135,178,23,92,336
37591,65,33,9,9,14,51
37592,80,39,29,1,11,69
37593,46,18,20,0,8,38
37594,56,20,19,2,15,41
37595,104,43,18,20,23,81
37596,162,82,47,1,32,130
37597,16,10,1,1,4,12
37598,36,18,9,3,6,30
37599,63,47,12,0,4,59
37600,42,27,7,3,5,37
37601,227,75,87,13,52,175
37602,47,11,20,4,12,35
37603,233,79,89,15,50,183
37604,36,15,11,0,10,26
37605,31,4,19,0,8,23
37606,89,21,48,0,20,69
37607,41,7,18,3,13,28
37608,50,24,17,0,9,41
37609,209,92,60,13,44,165
37610,515,280,114,12,109,406
37611,36,17,14,0,5,31
37612,169,60,74,0,35,134
37613,97,27,21,28,21,76
37614,28,10,12,1,5,23
37615,284,123,98,10,53,231
37616,106,49,34,4,19,87
37617,289,196,68,3,22,267
37618,81,34,21,3,23,58
37619,27,15,8,0,4,23
37620,60,30,11,2,17,43
37621,13,6,7,0,0,13
37622,344,249,27,0,68,276
37623,35,12,14,0,9,26
37624,254,56,151,0,47,207
37625,54,36,3,6,9,45
37626,342,95,158,9,80,262
37627,38,29,6,3,0,38
37628,129,94,5,2,28,101
37629,451,232,112,14,93,358
37630,31,8,11,4,8,23
37631,38,17,16,0,5,33
37632,56,29,13,4,10,46
37633,3,1,0,0,2,1
37634,140,80,23,3,34,106
37635,18,2,12,0,4,14
37636,50,23,10,3,14,36
37637,188,108,22,23,35,153
37638,119,36,50,7,26,93
37639,40,17,9,1,13,27
37640,33,18,5,2,8,25
37641,83,64,1,0,18,65
37642,88,68,0,4,16,72
37643,46,18,20,0,8,38
37644,14,4,5,1,4,10
37645,169,81,52,3,33,136
37646,51,26,14,1,10,41
37647,19,5,11,0,3,16
37648,40,20,10,0,10,30
37649,35,9,14,3,9,26
37650,56,16,27,0,13,43
37651,94,41,17,13,23,71
37652,98,24,39,13,22,76
37653,24,1,13,0,10,14
37654,8,3,4,0,1,7
37655,360,159,125,6,70,290
37656,421,191,139,8,83,338
37657,30,10,11,0,9,21
37658,28,11,9,0,8,20
37659,26,6,15,0,5,21
37660,25,10,7,3,5,20
37661,9,2,5,0,2,7
37662,143,49,33,28,33,110
37663,33,21,2,0,10,23
37664,37,25,5,2,5,32
37665,61,29,7,11,14,47
37666,405,229,93,0,83,322
37667,91,70,8,0,13,78
37668,47,21,20,0,6,41
37669,106,25,60,3,18,88
37670,158,117,9,4,28,130
37671,184,77,66,4,37,147
37672,133,78,41,0,14,119
37673,12,4,2,0,6,6
37674,82,34,30,0,18,64
37675,41,29,4,0,8,33
37676,70,54,1,0,15,55
37677,345,181,84,20,60,285
37678,82,52,14,2,14,68
37679,38,19,12,0,7,31
37680,67,35,3,16,13,54
37681,76,26,39,0,11,65
37682,66,14,25,3,24,42
37683,30,7,16,0,7,23
37684,32,21,9,0,2,30
37685,285,136,79,12,58,227
37686,130,47,27,26,30,100
37687,440,230,117,18,75,365
37688,178,101,32,0,45,133
37689,86,45,26,0,15,71
37690,139,90,19,0,30,109
37691,2,1,0,0,1,1
37692,63,22,26,1,14,49
37693,73,28,25,0,20,53
37694,238,116,76,4,42,196
37695,21,10,7,1,3,18
37696,16,7,8,0,1,15
37697,135,72,30,5,28,107
37698,43,4,33,1,5,38
37699,69,11,43,0,15,54
37700,13,3,7,1,2,11
37701,17,1,13,0,3,14
37702,9,5,3,0,1,8
37703,67,31,19,2,15,52
37704,15,1,12,0,2,13
37705,65,12,33,6,14,51
37706,39,18,13,0,8,31
37707,45,19,21,0,5,40
37708,39,13,19,0,7,32
37709,46,18,20,0,8,38
37710,70,45,4,10,11,59
37711,39,1,30,0,8,31
37712,158,113,20,0,25,133
37713,68,30,21,3,14,54
37714,74,45,18,0,11,63
37715,434,206,135,12,81,353
37716,85,24,35,11,15,70
37717,278,95,126,14,43,235
37718,32,21,9,0,2,30
37719,30,8,12,2,8,22
37720,91,53,20,0,18,73
37721,18,4,7,0,7,11
37722,373,210,85,0,78,295
37723,572,321,141,19,91,481
37724,45,14,20,3,8,37
37725,51,8,22,7,14,37
37726,434,204,112,29,89,345
37727,198,53,39,67,39,159
37728,39,23,8,0,8,31
37729,62,13,37,3,9,53
37730,70,19,26,9,16,54
37731,528,235,128,47,118,410
37732,33,7,16,1,9,24
37733,50,16,23,4,7,43
37734,131,82,25,3,21,110
37735,42,10,14,9,9,33
37736,35,8,18,0,9,26
37737,63,31,23,2,7,56
37738,233,93,14,82,44,189
37739,9,2,2,3,2,7
37740,31,14,7,0,10,21
37741,30,22,3,1,4,26
37742,110,45,36,10,19,91
37743,48,19,21,0,8,40
37744,40,20,10,1,9,31
37745,27,15,9,2,1,26
37746,159,72,51,5,31,128
37747,39,3,27,0,9,30
37748,135,101,4,2,28,107
37749,31,9,18,0,4,27
37750,151,37,72,4,38,113
37751,139,83,29,0,27,112
37752,79,47,16,3,13,66
37753,70,44,8,2,16,54
37754,63,11,37,0,15,48
37755,447,208,100,41,98,349
37756,66,36,17,0,13,53
37757,35,13,13,2,7,28
37758,121,82,12,2,25,96
37759,27,3,22,0,2,25
37760,232,78,90,13,51,181
37761,379,206,114,0,59,320
37762,10,5,3,0,2,8
37763,90,51,16,1,22,68
37764,100,39,21,12,28,72
37765,147,96,27,0,24,123
37766,17,5,5,0,7,10
37767,26,9,9,2,6,20
37768,49,24,17,0,8,41
37769,38,17,16,0,5,33
37770,45,26,8,0,11,34
37771,343,146,120,6,71,272
37772,29,12,7,7,3,26
37773,12,2,7,1,2,10
37774,167,81,52,3,31,136
37775,149,29,91,1,28,121
37776,139,91,29,3,16,123
37777,32,17,13,0,2,30
37778,108,21,51,15,21,87
37779,63,35,19,1,8,55
37780,58,47,0,0,11,47
37781,63,30,16,1,16,47
37782,70,36,24,2,8,62
37783,24,12,8,2,2,22
37784,182,111,32,5,34,148
37785,58,18,15,13,12,46
37786,9,8,0,0,1,8
37787,67,20,35,0,12,55
37788,39,24,8,4,3,36
37789,26,14,3,0,9,17
37790,206,89,85,0,32,174
37791,44,10,4,21,9,35
37792,21,3,13,0,5,16
37793,55,18,21,8,8,47
37794,34,13,20,0,1,33
37795,46,18,20,0,8,38
37796,235,55,25,116,39,196
37797,164,84,39,0,41,123
37798,84,58,5,0,21,63
37799,430,200,93,50,87,343
37800,85,20,36,14,15,70
37801,96,41,38,4,13,83
37802,21,13,6,0,2,19
37803,116,41,47,0,28,88
37804,191,136,15,1,39,152
37805,17,3,11,0,3,14
37806,8,2,4,0,2,6
37807,52,24,17,2,9,43
37808,36,26,3,2,5,31
37809,105,40,28,14,23,82
37810,5,1,3,0,1,4
37811,26,10,13,0,3,23
37812,111,30,58,0,23,88
37813,60,27,22,0,11,49
37814,117,52,31,9,25,92
37815,225,150,34,0,41,184
37816,46,18,20,0,8,38
37817,81,42,9,19,11,70
37818,228,124,35,25,44,184
37819,63,41,13,0,9,54
37820,55,15,17,15,8,47
37821,30,6,13,1,10,20
37822,31,19,3,0,9,22
37823,16,4,8,0,4,12
37824,81,25,34,5,17,64
37825,26,16,6,1,3,23
37826,17,4,7,1,5,12
37827,27,22,1,0,4,23
37828,76,53,2,0,21,55
37829,84,23,43,4,14,70
37830,46,16,16,0,14,32
37831,128,97,4,2,25,103
37832,68,29,27,1,11,57
37833,17,9,6,0,2,15
37834,21,14,5,0,2,19
37835,114,49,13,18,34,80
37836,26,19,3,1,3,23
37837,108,79,8,0,21,87
37838,77,27,36,0,14,63
37839,98,37,26,16,19,79
37840,13,7,0,1,5,8
37841,12,0,11,0,1,11
37842,79,42,16,1,20,59
37843,64,35,15,0,14,50
37844,7,3,2,0,2,5
37845,9,1,6,0,2,7
37846,32,21,9,0,2,30
37847,95,44,21,12,18,77
37848,36,6,21,0,9,27
37849,271,204,15,0,52,219
37850,85,38,29,4,14,71
37851,20,5,10,0,5,15
37852,99,66,8,4,21,78
37853,102,64,10,5,23,79
37854,445,139,191,15,100,345
37855,65,21,26,7,11,54
37856,21,8,9,0,4,17
37857,27,4,13,4,6,21
37858,50,41,1,0,8,42
37859,13,13,0,0,0,13
37860,16,6,5,0,5,11
37861,491,270,78,41,102,389
37862,114,32,59,0,23,91
37863,100,34,45,1,20,80
37864,34,7,16,3,8,26
37865,123,60,37,4,22,101
37866,38,7,14,5,12,26
37867,262,141,78,0,43,219
37868,4,2,1,0,1,3
37869,36,17,10,2,7,29
37870,5,0,4,0,1,4
37871,51,30,5,1,15,36
37872,49,17,20,1,11,38
37873,32,21,9,0,2,30
37874,170,88,36,9,37,133
37875,128,50,38,14,26,102
37876,73,44,17,0,12,61
37877,275,18,203,2,52,223
37878,52,38,2,0,12,40
37879,16,2,7,4,3,13
37880,167,81,52,3,31,136
37881,50,13,19,6,12,38
37882,13,1,9,0,3,10
37883,31,11,11,0,9,22
37884,46,27,10,0,9,37
37885,34,2,24,0,8,26
37886,113,86,2,0,25,88
37887,93,21,31,22,19,74
37888,25,2,19,0,4,21
37889,98,63,24,0,11,87
37890,55,13,27,10,5,50
37891,65,28,14,7,16,49
37892,69,19,24,16,10,59
37893,45,13,20,1,11,34
37894,95,43,24,12,16,79
37895,137,72,35,0,30,107
37896,32,21,9,0,2,30
37897,58,12,30,0,16,42
37898,30,10,15,1,4,26
37899,38,21,7,0,10,28
37900,19,14,3,0,2,17
37901,99,32,40,10,17,82
37902,114,40,33,15,26,88
37903,14,6,3,1,4,10
37904,82,56,8,3,15,67
37905,131,42,48,17,24,107
37906,163,64,39,23,37,126
37907,149,76,50,10,13,136
37908,35,24,2,0,9,26
37909,187,99,56,0,32,155
37910,53,15,25,5,8,45
37911,56,35,7,1,13,43
37912,34,12,13,0,9,25
37913,126,46,47,13,20,106
37914,209,139,22,0,48,161
37915,120,45,42,13,20,100
37916,104,33,50,1,20,84
37917,71,20,27,7,17,54
37918,126,51,29,20,26,100
37919,60,42,11,5,2,58
37920,39,12,19,1,7,32
37921,39,22,3,0,14,25
37922,65,46,9,0,10,55
37923,246,130,34,36,46,200
37924,5,1,2,0,2,3
37925,32,21,9,0,2,30
37926,62,14,7,28,13,49
37927,50,0,32,3,15,35
37928,83,43,19,1,20,63
37929,22,9,7,1,5,17
37930,37,21,4,0,12,25
37931,68,41,14,0,13,55
37932,136,57,42,0,37,99
37933,32,21,9,0,2,30
37934,8,4,2,0,2,6
37935,75,34,26,0,15,60
37936,25,3,17,1,4,21
37937,54,13,29,2,10,44
37938,46,18,20,0,8,38
37939,32,19,5,1,7,25
37940,88,32,18,10,28,60
37941,163,65,56,17,25,138
37942,345,149,122,6,68,277
37943,13,2,6,2,3,10
37944,11,3,3,0,5,6
37945,200,88,54,20,38,162
37946,36,25,6,1,4,32
37947,143,64,43,7,29,114
37948,28,19,5,0,4,24
37949,57,14,33,0,10,47
37950,171,81,55,3,32,139
37951,98,39,23,14,22,76
37952,46,36,3,0,7,39
37953,56,3,40,1,12,44
37954,111,39,40,5,27,84
37955,21,15,2,0,4,17
37956,19,5,12,1,1,18
37957,124,105,2,0,17,107
37958,59,36,10,1,12,47
37959,139,80,22,3,34,105
37960,204,55,53,56,40,164
37961,29,10,13,0,6,23
37962,29,9,15,0,5,24
37963,93,41,27,1,24,69
37964,62,45,4,3,10,52
37965,27,8,15,0,4,23
37966,12,5,2,1,4,8
37967,434,204,139,12,79,355
37968,22,3,13,0,6,16
37969,445,256,85,12,92,353
37970,9,2,3,1,3,6
37971,151,24,98,1,28,123
37972,49,20,18,2,9,40
37973,23,13,0,5,5,18
37974,198,81,50,23,44,154
37975,32,24,2,0,6,26
37976,84,24,22,20,18,66
37977,46,21,9,3,13,33
37978,23,8,13,0,2,21
37979,47,12,27,0,8,39
37980,57,11,5,31,10,47
37981,286,179,44,0,63,223
37982,188,123,47,3,15,173
37983,90,64,15,1,10,80
37984,50,11,17,7,15,35
37985,215,147,53,2,13,202
37986,142,58,31,24,29,113
37987,20,0,14,0,6,14
37988,601,383,87,5,126,475
37989,48,35,6,1,6,42
37990,34,10,18,4,2,32
37991,107,45,37,1,24,83
37992,24,15,5,1,3,21
37993,202,111,30,21,40,162
37994,109,104,0,5,0,109
37995,151,50,8,67,26,125
37996,29,13,13,0,3,26
37997,19,5,11,0,3,16
37998,657,375,153,22,107,550
37999,188,6,151,0,31,157
38000,70,16,26,11,17,53
38001,32,21,9,0,2,30
38002,54,30,15,3,6,48
38003,32,21,9,0,2,30
38004,46,29,7,6,4,42
38005,17,13,2,0,2,15
38006,98,54,19,7,18,80
38007,26,17,0,0,9,17
38008,57,29,8,12,8,49
38009,77,39,26,4,8,69
38010,88,44,25,2,17,71
38011,98,94,0,4,0,98
38012,97,64,14,0,19,78
38013,11,8,0,1,2,9
38014,55,33,14,2,6,49
38015,62,18,33,1,10,52
38016,465,222,144,13,86,379
38017,25,11,11,0,3,22
38018,76,42,20,0,14,62
38019,15,6,6,0,3,12
38020,85,54,13,9,9,76
38021,40,7,22,2,9,31
38022,92,50,21,4,17,75
38023,13,6,4,1,2,11
38024,32,21,9,0,2,30
38025,35,1,29,0,5,30
38026,50,30,7,1,12,38
38027,82,38,23,0,21,61
38028,150,99,28,0,23,127
38029,103,70,19,0,14,89
38030,360,102,138,33,87,273
38031,352,185,96,3,68,284
38032,50,7,33,0,10,40
38033,67,20,20,9,18,49
38034,45,32,2,0,11,34
38035,87,51,14,1,21,66
38036,380,219,82,0,79,301
38037,168,34,95,8,31,137
38038,12,5,4,0,3,9
38039,249,162,69,2,16,233
38040,591,429,39,1,122,469
38041,69,10,36,5,18,51
38042,14,11,1,1,1,13
38043,17,0,13,0,4,13
38044,46,18,20,0,8,38
38045,534,386,38,1,109,425
38046,39,8,13,7,11,28
38047,88,19,45,9,15,73
38048,69,28,25,2,14,55
38049,194,142,14,1,37,157
38050,110,41,43,3,23,87
38051,451,221,116,19,95,356
38052,39,11,22,0,6,33
38053,101,80,3,0,18,83
38054,135,53,38,13,31,104
38055,79,43,21,0,15,64
38056,32,21,9,0,2,30
38057,52,17,23,0,12,40
38058,42,37,0,0,5,37
38059,97,56,25,12,4,93
38060,107,42,30,9,26,81
38061,50,36,1,0,13,37
38062,184,139,2,2,41,143
38063,35,26,4,5,0,35
38064,46,18,20,0,8,38
38065,14,9,2,0,3,11
38066,32,21,9,0,2,30
38067,40,16,17,0,7,33
38068,31,13,14,0,4,27
38069,78,46,18,0,14,64
38070,291,36,200,2,53,238
38071,44,11,22,0,11,33
38072,11,4,4,0,3,8
38073,46,39,2,0,5,41
38074,93,34,38,10,11,82
38075,44,21,14,3,6,38
38076,16,2,9,1,4,12
38077,74,10,49,0,15,59
38078,65,44,8,2,11,54
38079,380,202,91,14,73,307
38080,35,22,5,1,7,28
38081,35,14,15,0,6,29
38082,17,6,7,1,3,14
38083,113,35,37,14,27,86
38084,198,79,42,31,46,152
38085,52,7,28,5,12,40
38086,234,165,19,0,50,184
38087,103,73,12,10,8,95
38088,283,76,34,125,48,235
38089,76,10,42,5,19,57
38090,114,32,44,19,19,95
38091,7,0,6,0,1,6
38092,32,21,9,0,2,30
38093,19,4,14,0,1,18
38094,635,367,149,17,102,533
38095,513,316,72,7,118,395
38096,51,32,4,6,9,42
38097,223,74,99,2,48,175
38098,222,120,35,21,46,176
38099,62,33,16,0,13,49
38100,23,5,13,0,5,18
38101,46,34,4,0,8,38
38102,12,1,7,1,3,9
38103,121,64,37,1,19,102
38104,38,1,29,0,8,30
38105,22,5,15,0,2,20
38106,21,8,2,9,2,19
38107,76,30,8,17,21,55
38108,55,23,18,2,12,43
38109,26,12,10,0,4,22
38110,103,38,39,12,14,89
38111,213,91,63,20,39,174
38112,74,34,13,11,16,58
38113,54,34,13,4,3,51
38114,50,16,22,4,8,42
38115,7,3,4,0,0,7
38116,170,69,37,20,44,126
38117,148,13,102,2,31,117
38118,67,28,31,0,8,59
38119,139,91,26,0,22,117
38120,11,3,5,2,1,10
38121,46,27,9,4,6,40
38122,74,8,48,5,13,61
38123,38,26,3,2,7,31
38124,53,30,11,0,12,41
38125,15,5,10,0,0,15
38126,13,6,4,0,3,10
38127,199,108,40,14,37,162
38128,180,71,56,7,46,134
38129,42,18,13,0,11,31
38130,335,145,87,35,68,267
38131,99,34,41,11,13,86
38132,7,3,2,0,2,5
38133,64,36,16,0,12,52
38134,95,54,23,1,17,78
38135,467,235,122,13,97,370
38136,507,242,106,57,102,405
38137,183,102,33,1,47,136
38138,68,44,12,0,12,56
38139,14,8,0,2,4,10
38140,206,50,39,79,38,168
38141,10,4,1,2,3,7
38142,57,27,8,8,14,43
38143,417,196,121,13,87,330
38144,61,39,9,2,11,50
38145,14,5,5,2,2,12
38146,28,15,7,1,5,23
38147,61,47,1,0,13,48
38148,131,77,29,0,25,106
38149,11,5,2,1,3,8
38150,32,21,9,0,2,30
38151,603,340,146,20,97,506
38152,449,225,117,12,95,354
38153,8,2,4,1,1,7
38154,147,37,75,1,34,113
38155,50,34,9,0,7,43
38156,19,12,4,0,3,16
38157,20,1,11,0,8,12
38158,139,91,28,0,20,119
38159,63,41,13,0,9,54
38160,173,130,6,1,36,137
38161,103,52,26,4,21,82
38162,89,32,19,10,28,61
38163,261,156,41,15,49,212
38164,14,5,5,0,4,10
38165,32,21,9,0,2,30
38166,12,7,2,0,3,9
38167,164,51,83,0,30,134
38168,14,8,3,0,3,11
38169,267,18,198,0,51,216
38170,63,15,23,6,19,44
38171,77,48,15,0,14,63
38172,37,11,22,0,4,33
38173,147,50,74,4,19,128
38174,28,2,16,5,5,23
38175,56,19,31,0,6,50
38176,32,21,9,0,2,30
38177,19,5,10,1,3,16
38178,98,47,14,16,21,77
38179,26,2,18,0,6,20
38180,550,397,33,1,119,431
38181,437,141,158,48,90,347
38182,39,1,9,22,7,32
38183,56,39,3,0,14,42
38184,27,8,16,1,2,25
38185,53,30,14,2,7,46
38186,82,27,26,8,21,61
38187,31,6,14,1,10,21
38188,91,29,46,0,16,75
38189,73,41,16,2,14,59
38190,44,20,14,0,10,34
38191,105,26,27,29,23,82
38192,45,29,9,1,6,39
38193,40,0,28,0,12,28
38194,166,99,37,1,29,137
38195,493,245,96,54,98,395
38196,37,11,20,0,6,31
38197,328,163,103,5,57,271
38198,8,4,4,0,0,8
38199,4,1,2,1,0,4
38200,66,22,29,1,14,52
38201,22,2,8,8,4,18
38202,427,203,119,14,91,336
38203,9,8,0,0,1,8
38204,12,3,9,0,0,12
38205,21,9,7,0,5,16
38206,158,92,36,1,29,129
38207,38,15,8,8,7,31
38208,283,194,66,3,20,263
38209,98,30,48,0,20,78
38210,6,4,2,0,0,6
38211,39,11,22,1,5,34
38212,61,32,13,2,14,47
38213,6,6,0,0,0,6
38214,20,9,4,0,7,13
38215,22,17,0,0,5,17
38216,343,158,87,27,71,272
38217,93,41,27,1,24,69
38218,61,29,23,2,7,54
38219,41,8,23,0,10,31
38220,54,34,7,0,13,41
38221,5,4,0,0,1,4
38222,26,5,14,1,6,20
38223,40,19,17,2,2,38
38224,30,22,5,3,0,30
38225,57,24,21,1,11,46
38226,93,61,13,11,8,85
38227,70,32,21,0,17,53
38228,44,19,16,0,9,35
38229,27,2,22,1,2,25
38230,221,75,82,15,49,172
38231,89,54,16,0,19,70
38232,38,5,14,9,10,28
38233,25,16,1,5,3,22
38234,298,37,205,2,54,244
38235,16,6,9,0,1,15
38236,100,64,9,5,22,78
38237,33,19,6,0,8,25
38238,125,64,15,18,28,97
38239,43,28,5,0,10,33
38240,45,9,27,0,9,36
38241,437,161,138,43,95,342
38242,53,21,17,5,10,43
38243,84,16,42,6,20,64
38244,76,22,32,6,16,60
38245,582,339,131,15,97,485
38246,32,21,9,0,2,30
38247,122,45,37,15,25,97
38248,43,13,20,3,7,36
38249,11,4,4,0,3,8
38250,38,25,1,1,11,27
38251,660,366,164,24,106,554
38252,61,44,6,1,10,51
38253,48,18,12,3,15,33
38254,23,12,8,0,3,20
38255,235,103,74,16,42,193
38256,29,22,1,0,6,23
38257,56,18,11,8,19,37
38258,14,6,1,3,4,10
38259,38,18,9,1,10,28
38260,62,34,15,2,11,51
38261,82,30,36,5,11,71
38262,106,26,40,13,27,79
38263,220,149,30,0,41,179
38264,72,36,14,5,17,55
38265,668,384,156,22,106,562
38266,42,20,16,1,5,37
38267,78,23,26,11,18,60
38268,16,11,3,0,2,14
38269,54,37,4,1,12,42
38270,73,42,10,5,16,57
38271,85,46,21,1,17,68
38272,85,34,21,11,19,66
38273,136,76,23,3,34,102
38274,53,37,4,1,11,42
38275,496,210,125,50,111,385
38276,36,16,8,3,9,27
38277,60,35,15,5,5,55
38278,78,23,24,9,22,56
38279,137,106,12,0,19,118
38280,28,11,10,0,7,21
38281,18,3,7,0,8,10
38282,21,9,8,0,4,17
38283,7,0,7,0,0,7
38284,43,2,32,0,9,34
38285,98,57,20,0,21,77
38286,68,2,40,19,7,61
38287,157,56,51,24,26,131
38288,66,30,18,5,13,53
38289,42,12,19,3,8,34
38290,40,9,23,0,8,32
38291,93,39,33,5,16,77
38292,35,17,9,3,6,29
38293,242,127,76,0,39,203
38294,26,3,20,0,3,23
38295,415,303,24,0,88,327
38296,173,109,12,13,39,134
38297,61,36,7,2,16,45
38298,26,10,14,0,2,24
38299,32,21,9,0,2,30
38300,95,21,31,24,19,76
38301,94,61,15,0,18,76
38302,111,52,25,14,20,91
38303,107,51,18,16,22,85
38304,64,37,16,0,11,53
38305,22,9,7,2,4,18
38306,26,10,11,2,3,23
38307,145,64,45,10,26,119
38308,29,12,12,0,5,24
38309,46,25,16,0,5,41
38310,50,23,18,0,9,41
38311,59,35,10,1,13,46
38312,24,14,8,0,2,22
38313,48,15,24,1,8,40
38314,86,65,1,0,20,66
38315,46,18,20,0,8,38
38316,466,348,25,0,93,373
38317,32,21,9,0,2,30
38318,79,26,8,28,17,62
38319,474,217,161,11,85,389
38320,16,5,7,0,4,12
38321,65,15,28,12,10,55
38322,86,48,21,0,17,69
38323,41,5,25,0,11,30
38324,87,39,26,4,18,69
38325,62,34,18,0,10,52
38326,37,8,22,1,6,31
38327,84,42,27,0,15,69
38328,360,109,168,5,78,282
38329,22,4,16,0,2,20
38330,14,9,3,0,2,12
38331,249,21,180,2,46,203
38332,35,26,6,3,0,35
38333,420,132,172,17,99,321
38334,198,77,37,33,51,147
38335,306,228,12,2,64,242
38336,83,29,30,10,14,69
38337,2,0,1,0,1,1
38338,53,21,17,0,15,38
38339,57,29,13,0,15,42
38340,52,29,11,0,12,40
38341,2,1,0,1,0,2
38342,127,75,21,3,28,99
38343,12,1,10,0,1,11
38344,38,13,20,1,4,34
38345,28,14,9,2,3,25
38346,69,21,31,4,13,56
38347,300,127,105,6,62,238
38348,54,24,12,5,13,41
38349,54,15,28,0,11,43
38350,80,52,15,0,13,67
38351,49,32,7,0,10,39
38352,51,28,11,0,12,39
38353,17,5,4,6,2,15
38354,37,22,10,0,5,32
38355,15,5,6,1,3,12
38356,57,14,27,5,11,46
38357,32,21,9,0,2,30
38358,39,8,24,0,7,32
38359,39,5,28,0,6,33
38360,80,34,20,12,14,66
38361,31,16,3,4,8,23
38362,112,54,16,15,27,85
38363,158,56,44,29,29,129
38364,61,37,13,3,8,53
38365,21,8,10,0,3,18
38366,209,161,8,0,40,169
38367,63,37,7,7,12,51
38368,67,33,12,0,22,45
38369,77,35,28,0,14,63
38370,72,40,13,2,17,55
38371,126,80,29,0,17,109
38372,21,0,15,0,6,15
38373,30,10,7,6,7,23
38374,38,12,12,7,7,31
38375,44,21,10,1,12,32
38376,50,30,10,2,8,42
38377,26,12,11,0,3,23
38378,32,21,9,0,2,30
38379,629,364,146,17,102,527
38380,101,58,19,4,20,81
38381,74,12,50,0,12,62
38382,484,220,168,11,85,399
38383,99,77,2,0,20,79
38384,76,19,24,21,12,64
38385,405,119,150,44,92,313
38386,83,22,42,9,10,73
38387,71,54,5,1,11,60
38388,81,53,11,3,14,67
38389,15,4,7,0,4,11
38390,234,60,119,6,49,185
38391,32,21,9,0,2,30
38392,10,2,3,0,5,5
38393,18,4,9,0,5,13
38394,58,19,21,8,10,48
38395,183,146,9,0,28,155
38396,50,18,18,1,13,37
38397,59,34,6,9,10,49
38398,59,31,11,6,11,48
38399,42,7,29,0,6,36
38400,108,51,26,6,25,83
38401,23,6,8,2,7,16
38402,89,21,41,16,11,78
38403,27,14,10,2,1,26
38404,16,5,5,0,6,10
38405,11,6,2,0,3,8
38406,31,13,11,2,5,26
38407,23,5,9,5,4,19
38408,30,16,5,0,9,21
38409,162,67,35,21,39,123
38410,42,7,24,0,11,31
38411,55,5,35,1,14,41
38412,98,37,40,4,17,81
38413,3,2,1,0,0,3
38414,8,2,2,3,1,7
38415,40,22,7,4,7,33
38416,80,14,41,6,19,61
38417,230,160,51,3,16,214
38418,75,51,15,6,3,72
38419,46,18,20,0,8,38
38420,247,134,58,14,41,206
38421,32,21,9,0,2,30
38422,460,340,20,0,100,360
38423,130,48,41,17,24,106
38424,188,125,12,11,40,148
38425,73,23,24,5,21,52
38426,110,38,42,11,19,91
38427,171,45,59,29,38,133
38428,91,42,15,10,24,67
38429,46,15,20,1,10,36
38430,7,3,1,2,1,6
38431,149,54,46,22,27,122
38432,69,32,28,0,9,60
38433,28,13,6,0,9,19
38434,145,69,41,0,35,110
38435,26,7,11,0,8,18
38436,9,6,3,0,0,9
38437,458,224,92,44,98,360
38438,41,21,9,2,9,32
38439,0,0,0,0,0,0
38440,40,27,1,1,11,29
38441,75,46,18,0,11,64
38442,31,11,14,0,6,25
38443,209,49,22,102,36,173
38444,122,50,37,14,21,101
38445,61,14,24,14,9,52
38446,44,38,1,0,5,39
38447,14,6,3,0,5,9
38448,261,102,56,38,65,196
38449,91,57,11,2,21,70
38450,4,1,1,0,2,2
38451,39,9,17,4,9,30
38452,113,38,28,21,26,87
38453,312,82,152,5,73,239
38454,381,186,94,16,85,296
38455,78,42,16,0,20,58
38456,39,23,8,0,8,31
38457,26,1,19,1,5,21
38458,46,18,20,0,8,38
38459,52,17,12,17,6,46
38460,183,67,56,26,34,149
38461,32,21,9,0,2,30
38462,14,3,5,2,4,10
38463,225,20,163,2,40,185
38464,51,40,1,0,10,41
38465,112,47,14,17,34,78
38466,84,48,18,0,18,66
38467,32,15,4,5,8,24
38468,67,51,11,0,5,62
38469,141,79,40,12,10,131
38470,178,126,15,2,35,143
38471,444,213,135,12,84,360
38472,287,208,14,3,62,225
38473,29,15,11,2,1,28
38474,15,5,7,0,3,12
38475,77,47,21,1,8,69
38476,41,20,12,1,8,33
38477,92,55,16,3,18,74
38478,48,18,14,1,15,33
38479,36,22,5,1,8,28
38480,120,43,31,17,29,91
38481,89,53,18,4,14,75
38482,243,100,15,83,45,198
38483,16,3,11,0,2,14
38484,466,219,148,11,88,378
38485,58,36,10,4,8,50
38486,34,11,17,0,6,28
38487,123,101,4,0,18,105
38488,212,94,84,5,29,183
38489,55,25,5,5,20,35
38490,78,48,8,8,14,64
38491,115,49,5,41,20,95
38492,637,371,142,16,108,529
38493,77,22,24,9,22,55
38494,8,0,3,0,5,3
38495,10,0,5,0,5,5
38496,98,24,58,1,15,83
38497,49,24,10,5,10,39
38498,85,52,18,2,13,72
38499,159,60,41,22,36,123
38500,36,7,16,4,9,27
38501,63,34,4,13,12,51
38502,26,13,6,0,7,19
38503,190,144,7,0,39,151
38504,158,80,38,0,40,118
38505,82,47,20,0,15,67
38506,50,5,37,1,7,43
38507,157,52,46,32,27,130
38508,41,6,24,0,11,30
38509,43,14,18,4,7,36
38510,213,52,40,83,38,175
38511,162,124,10,1,27,135
38512,73,30,20,1,22,51
38513,189,124,29,5,31,158
38514,438,134,190,16,98,340
38515,38,22,5,1,10,28
38516,198,78,41,32,47,151
38517,31,14,6,3,8,23
38518,197,145,13,1,38,159
38519,21,2,14,0,5,16
38520,277,63,159,1,54,223
38521,41,13,20,2,6,35
38522,76,38,23,0,15,61
38523,189,46,28,81,34,155
38524,22,5,14,0,3,19
38525,33,2,22,0,9,24
38526,25,5,17,0,3,22
38527,206,158,8,0,40,166
38528,37,20,9,0,8,29
38529,64,25,12,14,13,51
38530,106,52,14,12,28,78
38531,57,15,27,0,15,42
38532,36,23,7,0,6,30
38533,32,21,9,0,2,30
38534,138,100,6,3,29,109
38535,117,57,36,4,20,97
38536,137,59,41,9,28,109
38537,376,165,131,11,69,307
38538,23,6,11,0,6,17
38539,30,22,0,0,8,22
38540,34,8,15,1,10,24
38541,106,45,27,7,27,79
38542,111,84,2,0,25,86
38543,32,16,5,3,8,24
38544,134,61,41,10,22,112
38545,219,90,38,38,53,166
38546,53,34,8,0,11,42
38547,38,25,5,0,8,30
38548,85,55,15,0,15,70
38549,8,3,2,0,3,5
38550,70,22,38,0,10,60
38551,55,24,14,2,15,40
38552,54,43,1,0,10,44
38553,89,72,0,4,13,76
38554,21,3,16,0,2,19
38555,76,20,28,12,16,60
38556,73,40,20,0,13,60
38557,6,2,3,0,1,5
38558,139,108,5,6,20,119
38559,46,23,14,1,8,38
38560,11,5,4,0,2,9
38561,55,16,21,9,9,46
38562,373,270,19,2,82,291
38563,23,14,2,0,7,16
38564,18,8,5,0,5,13
38565,56,13,19,6,18,38
38566,22,8,11,0,3,19
38567,48,31,8,1,8,40
38568,6,0,4,0,2,4
38569,42,28,5,1,8,34
38570,38,20,12,0,6,32
38571,88,41,34,3,10,78
38572,53,27,12,1,13,40
38573,43,27,10,0,6,37
38574,92,45,27,4,16,76
38575,287,196,67,3,21,266
38576,22,10,9,0,3,19
38577,33,7,16,4,6,27
38578,45,26,9,0,10,35
38579,68,39,3,13,13,55
38580,35,9,18,0,8,27
38581,48,27,16,0,5,43
38582,35,19,9,0,7,28
38583,79,26,32,9,12,67
38584,100,77,7,0,16,84
38585,7,7,0,0,0,7
38586,9,2,5,0,2,7
38587,355,158,123,4,70,285
38588,20,5,11,0,4,16
38589,61,17,27,2,15,46
38590,129,94,6,1,28,101
38591,42,23,7,1,11,31
38592,80,38,32,1,9,71
38593,8,4,2,0,2,6
38594,202,108,61,0,33,169
38595,139,74,42,12,11,128
38596,114,54,27,6,27,87
38597,60,29,19,2,10,50
38598,10,1,8,0,1,9
38599,245,11,186,0,48,197
38600,31,2,22,1,6,25
38601,20,14,1,0,5,15
38602,161,75,52,1,33,128
38603,671,390,146,18,117,554
38604,17,7,3,0,7,10
38605,63,29,20,0,14,49
38606,247,103,15,82,47,200
38607,47,29,3,0,15,32
38608,48,26,17,0,5,43
38609,264,148,34,31,51,213
38610,205,103,34,32,36,169
38611,182,133,13,2,34,148
38612,46,18,20,0,8,38
38613,14,12,0,0,2,12
38614,12,3,7,0,2,10
38615,38,7,10,16,5,33
38616,434,201,97,49,87,347
38617,32,21,9,0,2,30
38618,46,28,5,7,6,40
38619,516,254,100,55,107,409
38620,85,33,39,0,13,72
38621,62,49,2,0,11,51
38622,59,29,16,4,10,49
38623,162,117,9,5,31,131
38624,46,18,20,0,8,38
38625,265,180,20,3,62,203
38626,153,107,22,0,24,129
38627,57,0,38,3,16,41
38628,20,12,6,0,2,18
38629,18,11,2,0,5,13
38630,105,42,35,6,22,83
38631,45,23,10,2,10,35
38632,203,84,66,20,33,170
38633,54,20,23,0,11,43
38634,120,90,4,2,24,96
38635,60,24,25,0,11,49
38636,62,2,44,0,16,46
38637,48,27,10,0,11,37
38638,9,3,4,0,2,7
38639,17,1,11,0,5,12
38640,45,30,1,0,14,31
38641,60,32,10,4,14,46
38642,89,46,12,2,29,60
38643,13,1,6,0,6,7
38644,36,24,3,0,9,27
38645,47,2,35,2,8,39
38646,32,21,9,0,2,30
38647,29,22,4,0,3,26
38648,25,1,17,2,5,20
38649,43,14,17,3,9,34
38650,32,8,12,4,8,24
38651,61,40,13,0,8,53
38652,595,343,124,18,110,485
38653,59,25,16,1,17,42
38654,148,69,50,4,25,123
38655,38,23,7,0,8,30
38656,7,5,2,0,0,7
38657,54,26,16,0,12,42
38658,247,103,15,82,47,200
38659,55,30,14,2,9,46
38660,3,0,3,0,0,3
38661,73,30,20,1,22,51
38662,94,29,43,3,19,75
38663,28,5,19,0,4,24
38664,66,30,24,0,12,54
38665,58,18,26,4,10,48
38666,71,47,7,1,16,55
38667,44,5,26,1,12,32
38668,219,162,15,3,39,180
38669,62,34,9,0,19,43
38670,13,8,3,0,2,11
38671,16,8,3,0,5,11
38672,255,127,74,0,54,201
38673,66,24,18,8,16,50
38674,64,34,15,0,15,49
38675,71,7,38,14,12,59
38676,20,12,4,0,4,16
38677,140,55,44,9,32,108
38678,46,18,20,0,8,38
38679,253,21,183,2,47,206
38680,35,15,3,12,5,30
38681,22,3,7,5,7,15
38682,8,3,3,0,2,6
38683,46,18,20,0,8,38
38684,329,140,114,6,69,260
38685,115,55,25,2,33,82
38686,32,21,9,0,2,30
38687,39,1,32,0,6,33
38688,26,7,9,1,9,17
38689,52,13,26,2,11,41
38690,27,9,13,1,4,23
38691,91,40,24,3,24,67
38692,433,144,149,48,92,341
38693,12,10,1,0,1,11
38694,118,50,45,2,21,97
38695,43,18,17,1,7,36
38696,62,16,30,1,15,47
38697,206,107,34,28,37,169
38698,77,54,4,2,17,60
38699,379,219,81,16,63,316
38700,34,14,9,3,8,26
38701,438,209,105,35,89,349
38702,185,60,12,79,34,151
38703,45,14,24,1,6,39
38704,165,85,39,0,41,124
38705,16,12,2,0,2,14
38706,31,6,16,2,7,24
38707,25,5,14,0,6,19
38708,32,21,9,0,2,30
38709,91,67,16,2,6,85
38710,98,43,33,4,18,80
38711,222,105,67,4,46,176
38712,82,21,46,0,15,67
38713,455,171,143,45,96,359
38714,47,15,21,0,11,36
38715,272,92,116,9,55,217
38716,14,10,2,0,2,12
38717,139,88,31,0,20,119
38718,170,112,27,1,30,140
38719,43,22,11,3,7,36
38720,10,0,8,0,2,8
38721,125,89,5,5,26,99
38722,242,97,18,82,45,197
38723,11,2,6,1,2,9
38724,84,55,12,0,17,67
38725,26,9,5,8,4,22
38726,64,33,25,1,5,59
38727,23,5,14,0,4,19
38728,108,25,39,25,19,89
38729,53,38,1,1,13,40
38730,39,17,11,1,10,29
38731,33,12,14,0,7,26
38732,46,18,20,0,8,38
38733,39,12,18,0,9,30
38734,75,31,31,3,10,65
38735,137,102,15,0,20,117
38736,27,14,2,4,7,20
38737,70,10,49,6,5,65
38738,178,46,95,4,33,145
38739,34,8,14,3,9,25
38740,280,159,29,33,59,221
38741,99,47,30,5,17,82
38742,57,32,17,0,8,49
38743,198,132,21,0,45,153
38744,48,32,2,0,14,34
38745,49,24,10,5,10,39
38746,55,30,14,2,9,46
38747,140,63,41,6,30,110
38748,81,41,17,5,18,63
38749,183,74,39,27,43,140
38750,55,12,32,2,9,46
38751,26,20,2,0,4,22
38752,17,5,10,0,2,15
38753,631,352,158,21,100,531
38754,111,62,29,1,19,92
38755,62,13,37,0,12,50
38756,58,29,16,0,13,45
38757,9,5,2,0,2,7
38758,22,8,11,0,3,19
38759,303,148,75,19,61,242
38760,22,15,3,2,2,20
38761,22,4,14,1,3,19
38762,51,19,14,4,14,37
38763,32,21,9,0,2,30
38764,19,5,7,0,7,12
38765,80,42,13,9,16,64
38766,157,76,47,1,33,124
38767,419,305,31,0,83,336
38768,35,24,2,0,9,26
38769,11,6,3,1,1,10
38770,206,136,22,0,48,158
38771,24,8,7,4,5,19
38772,246,102,15,82,47,199
38773,78,5,54,1,18,60
38774,272,111,103,8,50,222
38775,96,75,3,0,18,78
38776,450,140,185,29,96,354
38777,47,23,17,0,7,40
38778,29,17,7,0,5,24
38779,63,24,21,6,12,51
38780,513,256,98,53,106,407
38781,17,6,3,0,8,9
38782,15,4,4,4,3,12
38783,87,67,0,4,16,71
38784,498,251,93,51,103,395
38785,436,214,81,51,90,346
38786,24,9,12,0,3,21
38787,23,11,8,0,4,19
38788,6,4,2,0,0,6
38789,17,8,3,1,5,12
38790,197,78,63,20,36,161
38791,217,68,104,11,34,183
38792,9,8,0,0,1,8
38793,187,58,91,8,30,157
38794,68,53,2,0,13,55
38795,77,28,37,1,11,66
38796,97,21,43,8,25,72
38797,58,23,20,5,10,48
38798,8,2,1,4,1,7
38799,55,15,21,10,9,46
38800,59,29,18,0,12,47
38801,39,2,19,12,6,33
38802,46,27,14,0,5,41
38803,7,5,1,0,1,6
38804,32,21,9,0,2,30
38805,180,132,13,1,34,146
38806,64,25,19,8,12,52
38807,66,21,33,0,12,54
38808,27,16,8,0,3,24
38809,37,22,6,1,8,29
38810,37,15,12,2,8,29
38811,305,129,107,6,63,242
38812,195,126,14,14,41,154
38813,178,74,54,17,33,145
38814,67,38,19,0,10,57
38815,91,29,45,1,16,75
38816,27,18,3,3,3,24
38817,23,15,3,0,5,18
38818,16,2,13,0,1,15
38819,43,22,6,4,11,32
38820,19,11,5,0,3,16
38821,31,9,17,0,5,26
38822,35,24,4,1,6,29
38823,18,9,8,0,1,17
38824,39,19,6,2,12,27
38825,23,16,3,0,4,19
38826,37,3,25,0,9,28
38827,3,1,2,0,0,3
38828,82,43,9,19,11,71
38829,68,32,22,0,14,54
38830,91,60,20,0,11,80
38831,136,71,35,0,30,106
38832,13,2,7,0,4,9
38833,79,36,26,10,7,72
38834,99,25,43,16,15,84
38835,144,82,47,0,15,129
38836,145,59,45,8,33,112
38837,513,278,83,48,104,409
38838,109,65,20,7,17,92
38839,286,148,96,0,42,244
38840,48,30,8,2,8,40
38841,5,2,0,0,3,2
38842,8,5,1,1,1,7
38843,42,14,17,2,9,33
38844,59,34,13,1,11,48
38845,76,37,15,6,18,58
38846,45,13,16,11,5,40
38847,49,19,24,0,6,43
38848,36,21,6,1,8,28
38849,74,34,26,0,14,60
38850,163,50,53,25,35,128
38851,128,86,17,1,24,104
38852,21,15,2,1,3,18
38853,41,7,23,0,11,30
38854,54,36,6,1,11,43
38855,61,24,30,0,7,54
38856,29,4,16,1,8,21
38857,52,34,5,0,13,39
38858,178,79,55,6,38,140
38859,30,15,8,4,3,27
38860,363,148,120,23,72,291
38861,29,14,8,3,4,25
38862,79,52,5,9,13,66
38863,168,106,31,5,26,142
38864,149,62,30,23,34,115
38865,59,43,4,0,12,47
38866,114,2,93,0,19,95
38867,10,2,8,0,0,10
38868,41,23,11,0,7,34
38869,19,8,7,0,4,15
38870,30,3,21,0,6,24
38871,18,4,8,0,6,12
38872,326,85,160,5,76,250
38873,44,17,21,0,6,38
38874,376,226,62,19,69,307
38875,51,16,20,2,13,38
38876,8,3,2,2,1,7
38877,283,34,196,2,51,232
38878,28,7,15,0,6,22
38879,19,10,2,2,5,14
38880,157,97,32,1,27,130
38881,207,112,33,23,39,168
38882,30,23,2,0,5,25
38883,22,15,4,0,3,19
38884,181,129,13,1,38,143
38885,20,13,2,1,4,16
38886,173,52,85,3,33,140
38887,101,23,46,11,21,80
38888,47,31,8,2,6,41
38889,575,400,50,1,124,451
38890,90,33,42,1,14,76
38891,105,25,57,3,20,85
38892,188,115,39,19,15,173
38893,82,41,18,2,21,61
38894,43,4,28,0,11,32
38895,87,41,33,0,13,74
38896,97,57,15,1,24,73
38897,216,116,55,0,45,171
38898,108,27,29,29,23,85
38899,123,92,7,0,24,99
38900,41,24,11,0,6,35
38901,72,34,29,1,8,64
38902,102,19,60,1,22,80
38903,151,62,62,8,19,132
38904,152,80,34,7,31,121
38905,30,13,12,0,5,25
38906,14,8,4,0,2,12
38907,33,21,5,0,7,26
38908,4,1,3,0,0,4
38909,338,147,116,6,69,269
38910,18,5,10,0,3,15
38911,132,12,79,15,26,106
38912,23,8,10,0,5,18
38913,453,140,185,28,100,353
38914,75,20,35,7,13,62
38915,48,25,10,0,13,35
38916,15,4,7,0,4,11
38917,82,33,33,1,15,67
38918,117,48,15,17,37,80
38919,128,70,26,5,27,101
38920,271,126,96,3,46,225
38921,46,12,21,5,8,38
38922,71,34,19,3,15,56
38923,161,112,35,2,12,149
38924,6,2,2,0,2,4
38925,15,9,1,4,1,14
38926,135,77,31,4,23,112
38927,234,183,12,0,39,195
38928,85,49,12,3,21,64
38929,78,13,41,7,17,61
38930,25,9,11,1,4,21
38931,74,23,28,10,13,61
38932,132,49,48,13,22,110
38933,29,5,22,0,2,27
38934,154,102,10,7,35,119
38935,317,135,109,6,67,250
38936,29,7,17,2,3,26
38937,60,31,7,9,13,47
38938,33,22,2,0,9,24
38939,79,32,20,5,22,57
38940,21,15,4,0,2,19
38941,229,153,34,0,42,187
38942,67,37,17,0,13,54
38943,660,363,163,24,110,550
38944,43,7,15,11,10,33
38945,193,141,13,1,38,155
38946,64,46,1,0,17,47
38947,118,58,20,15,25,93
38948,50,34,2,1,13,37
38949,37,22,6,1,8,29
38950,42,19,11,1,11,31
38951,73,63,2,0,8,65
38952,56,24,17,3,12,44
38953,35,7,25,0,3,32
38954,26,17,0,0,9,17
38955,51,26,12,1,12,39
38956,32,21,9,0,2,30
38957,38,9,23,1,5,33
38958,35,18,9,0,8,27
38959,69,16,28,12,13,56
38960,158,71,51,6,30,128
38961,36,16,13,0,7,29
38962,303,83,35,137,48,255
38963,19,9,6,1,3,16
38964,26,12,5,3,6,20
38965,70,33,15,13,9,61
38966,145,58,56,6,25,120
38967,112,58,23,6,25,87
38968,28,14,5,1,8,20
38969,26,12,12,1,1,25
38970,65,17,3,32,13,52
38971,24,9,7,3,5,19
38972,195,75,36,34,50,145
38973,139,82,31,0,26,113
38974,202,101,36,28,37,165
38975,27,7,7,5,8,19
38976,206,42,53,69,42,164
38977,37,18,6,8,5,32
38978,89,47,11,2,29,60
38979,235,166,20,0,49,186
38980,14,3,8,1,2,12
38981,21,6,10,0,5,16
38982,47,13,24,0,10,37
38983,15,12,0,0,3,12
38984,31,18,3,2,8,23
38985,36,16,13,0,7,29
38986,58,23,13,9,13,45
38987,47,16,20,1,10,37
38988,2,2,0,0,0,2
38989,92,31,38,5,18,74
38990,35,21,4,4,6,29
38991,31,11,19,1,0,31
38992,42,3,28,0,11,31
38993,46,25,10,0,11,35
38994,15,3,9,1,2,13
38995,56,42,3,2,9,47
38996,586,348,117,17,104,482
38997,36,9,19,0,8,28
38998,223,149,33,0,41,182
38999,26,4,8,4,10,16
39000,126,39,47,6,34,92
39001,37,12,16,0,9,28
39002,11,5,5,0,1,10
39003,110,39,47,0,24,86
39004,112,34,35,14,29,83
39005,243,100,15,83,45,198
39006,31,14,13,0,4,27
39007,121,42,48,12,19,102
39008,13,4,8,0,1,12
39009,46,18,20,0,8,38
39010,92,50,16,6,20,72
39011,49,23,11,5,10,39
39012,8,2,4,0,2,6
39013,35,14,13,3,5,30
39014,10,2,6,0,2,8
39015,213,129,39,7,38,175
39016,101,38,37,8,18,83
39017,175,5,139,0,31,144
39018,164,70,50,6,38,126
39019,238,166,52,2,18,220
39020,93,50,21,6,16,77
39021,70,22,34,5,9,61
39022,89,69,0,4,16,73
39023,575,324,140,19,92,483
39024,362,210,80,15,57,305
39025,200,81,37,35,47,153
39026,126,56,41,2,27,99
39027,41,9,18,2,12,29
39028,512,259,96,52,105,407
39029,200,83,66,19,32,168
39030,153,88,17,19,29,124
39031,24,15,4,0,5,19
39032,24,5,13,0,6,18
39033,30,1,25,0,4,26
39034,138,59,27,24,28,110
39035,32,21,9,0,2,30
39036,51,28,8,2,13,38
39037,6,3,0,3,0,6
39038,37,7,27,0,3,34
39039,51,27,7,8,9,42
39040,42,30,10,2,0,42
39041,79,48,16,0,15,64
39042,665,387,144,18,116,549
39043,85,23,37,3,22,63
39044,160,101,29,0,30,130
39045,34,13,13,0,8,26
39046,42,13,22,0,7,35
39047,105,59,22,1,23,82
39048,60,32,19,0,9,51
39049,128,42,47,5,34,94
39050,73,39,15,2,17,56
39051,31,20,3,0,8,23
39052,136,80,30,0,26,110
39053,76,39,22,2,13,63
39054,86,51,17,0,18,68
39055,74,20,24,18,12,62
39056,66,5,45,0,16,50
39057,91,34,23,13,21,70
39058,205,103,33,32,37,168
39059,32,21,9,0,2,30
39060,68,38,12,2,16,52
39061,18,4,11,0,3,15
39062,31,9,7,10,5,26
39063,194,131,19,0,44,150
39064,13,4,3,0,6,7
39065,24,2,7,11,4,20
39066,33,4,19,2,8,25
39067,28,2,21,1,4,24
39068,73,53,9,4,7,66
39069,71,49,4,2,16,55
39070,186,39,50,63,34,152
39071,109,20,54,15,20,89
39072,205,68,81,15,41,164
39073,54,14,18,9,13,41
39074,141,76,26,7,32,109
39075,27,7,2,11,7,20
39076,10,6,1,0,3,7
39077,27,2,10,8,7,20
39078,346,186,89,15,56,290
39079,94,60,17,0,17,77
39080,44,6,26,4,8,36
39081,133,72,24,4,33,100
39082,97,20,61,0,16,81
39083,59,41,9,0,9,50
39084,79,25,28,14,12,67
39085,53,15,25,0,13,40
39086,220,149,30,0,41,179
39087,638,394,92,9,143,495
39088,29,2,22,1,4,25
39089,36,29,2,0,5,31
39090,176,47,56,37,36,140
39091,46,22,7,8,9,37
39092,32,14,9,1,8,24
39093,37,10,16,0,11,26
39094,208,137,51,4,16,192
39095,39,20,14,0,5,34
39096,32,21,9,0,2,30
39097,43,32,3,1,7,36
39098,43,34,1,0,8,35
39099,36,8,23,2,3,33
39100,46,18,20,0,8,38
39101,55,37,3,5,10,45
39102,33,12,10,3,8,25
39103,32,21,9,0,2,30
39104,8,1,5,0,2,6
39105,33,2,25,0,6,27
39106,109,61,20,4,24,85
39107,99,37,31,8,23,76
39108,39,2,23,0,14,25
39109,39,12,15,2,10,29
39110,22,5,7,4,6,16
39111,7,3,2,1,1,6
39112,78,18,35,3,22,56
39113,71,19,5,32,15,56
39114,318,190,59,0,69,249
39115,37,1,29,0,7,30
39116,62,26,20,5,11,51
39117,137,102,6,0,29,108
39118,31,9,19,0,3,28
39119,124,82,23,0,19,105
39120,44,1,36,0,7,37
39121,32,18,4,0,10,22
39122,46,18,20,0,8,38
39123,40,17,17,0,6,34
39124,58,19,12,19,8,50
39125,356,184,109,5,58,298
39126,70,9,16,32,13,57
39127,60,25,24,0,11,49
39128,75,40,19,4,12,63
39129,40,27,3,2,8,32
39130,207,107,50,0,50,157
39131,164,99,35,1,29,135
39132,39,6,20,4,9,30
39133,400,181,136,12,71,329
39134,125,56,33,12,24,101
39135,24,12,8,2,2,22
39136,40,1,35,0,4,36
39137,48,16,18,5,9,39
39138,5,2,2,0,1,4
39139,398,230,84,16,68,330
39140,87,48,22,0,17,70
39141,103,38,26,12,27,76
39142,453,212,142,10,89,364
39143,31,0,11,15,5,26
39144,45,5,28,0,12,33
39145,69,24,26,6,13,56
39146,52,22,18,0,12,40
39147,277,26,197,2,52,225
39148,85,41,25,2,17,68
39149,46,15,8,13,10,36
39150,190,121,34,3,32,158
39151,16,9,4,0,3,13
39152,169,47,52,35,35,134
39153,25,10,13,0,2,23
39154,281,191,66,3,21,260
39155,30,9,11,3,7,23
39156,117,24,59,0,34,83
39157,44,7,25,4,8,36
39158,114,80,8,7,19,95
39159,38,19,13,0,6,32
39160,25,4,15,0,6,19
39161,42,17,18,0,7,35
39162,290,70,67,95,58,232
39163,27,15,4,0,8,19
39164,37,22,9,2,4,33
39165,1,0,0,1,0,1
39166,72,37,23,0,12,60
39167,62,40,10,2,10,52
39168,75,53,4,0,18,57
39169,53,32,5,0,16,37
39170,51,26,14,1,10,41
39171,8,2,2,1,3,5
39172,88,16,57,0,15,73
39173,632,365,148,17,102,530
39174,45,31,1,2,11,34
39175,45,29,6,6,4,41
39176,33,11,16,1,5,28
39177,420,199,116,16,89,331
39178,137,99,8,2,28,109
39179,152,60,46,9,37,115
39180,59,22,27,0,10,49
39181,580,413,45,1,121,459
39182,46,30,7,0,9,37
39183,22,11,5,0,6,16
39184,353,194,89,15,55,298
39185,42,13,15,7,7,35
39186,53,28,9,7,9,44
39187,150,45,73,0,32,118
39188,188,103,54,0,31,157
39189,12,5,4,1,2,10
39190,82,32,11,13,26,56
39191,16,11,0,0,5,11
39192,149,44,78,4,23,126
39193,4,2,1,0,1,3
39194,378,219,81,16,62,316
39195,55,34,7,0,14,41
39196,19,2,10,0,7,12
39197,62,17,33,3,9,53
39198,58,34,14,0,10,48
39199,13,9,1,0,3,10
39200,220,110,37,35,38,182
39201,52,29,11,0,12,40
39202,152,67,32,18,35,117
39203,26,15,3,4,4,22
39204,339,194,74,14,57,282
39205,20,12,2,0,6,14
39206,3,0,1,0,2,1
39207,10,6,1,0,3,7
39208,17,0,12,0,5,12
39209,106,57,34,7,8,98
39210,25,18,3,0,4,21
39211,28,10,11,0,7,21
39212,100,58,8,11,23,77
39213,90,58,14,0,18,72
39214,50,29,17,0,4,46
39215,47,13,24,0,10,37
39216,18,6,10,0,2,16
39217,55,29,14,0,12,43
39218,6,0,3,0,3,3
39219,27,17,3,0,7,20
39220,53,26,18,0,9,44
39221,154,45,68,4,37,117
39222,86,43,5,25,13,73
39223,45,34,0,1,10,35
39224,27,14,6,3,4,23
39225,103,48,31,6,18,85
39226,57,19,28,2,8,49
39227,55,26,17,0,12,43
39228,322,131,129,5,57,265
39229,535,260,115,46,114,421
39230,4,4,0,0,0,4
39231,51,17,18,7,9,42
39232,67,25,28,3,11,56
39233,93,47,13,2,31,62
39234,94,41,27,1,25,69
39235,51,22,18,1,10,41
39236,27,9,11,1,6,21
39237,11,4,2,1,4,7
39238,49,24,13,1,11,38
39239,127,27,45,30,25,102
39240,142,26,89,1,26,116
39241,32,6,17,4,5,27
39242,53,12,27,1,13,40
39243,23,11,2,3,7,16
39244,49,31,4,0,14,35
39245,100,59,12,5,24,76
39246,108,56,41,1,10,98
39247,142,93,31,3,15,127
39248,30,7,11,3,9,21
39249,55,35,11,3,6,49
39250,55,33,14,2,6,49
39251,171,113,27,1,30,141
39252,196,100,36,26,34,162
39253,36,2,26,1,7,29
39254,190,104,55,0,31,159
39255,189,103,55,0,31,158
39256,14,8,3,1,2,12
39257,31,17,11,0,3,28
39258,192,87,56,11,38,154
39259,51,6,31,0,14,37
39260,54,34,10,3,7,47
39261,124,25,68,1,30,94
39262,30,14,12,0,4,26
39263,12,4,6,1,1,11
39264,143,98,18,0,27,116
39265,534,303,105,11,115,419
39266,130,44,49,12,25,105
39267,222,141,61,3,17,205
39268,44,8,24,3,9,35
39269,49,35,2,0,12,37
39270,44,31,9,4,0,44
39271,14,8,2,1,3,11
39272,124,28,40,22,34,90
39273,40,4,25,0,11,29
39274,42,5,26,0,11,31
39275,79,45,18,2,14,65
39276,655,374,155,20,106,549
39277,12,6,2,1,3,9
39278,102,70,7,5,20,82
39279,55,19,24,2,10,45
39280,13,8,2,0,3,10
39281,6,2,3,0,1,5
39282,12,0,11,0,1,11
39283,119,58,28,8,25,94
39284,48,25,16,0,7,41
39285,81,54,7,1,19,62
39286,165,97,38,1,29,136
39287,96,44,32,4,16,80
39288,45,11,31,0,3,42
39289,22,1,16,0,5,17
39290,87,49,23,3,12,75
39291,33,11,13,1,8,25
39292,105,31,43,10,21,84
39293,19,9,3,0,7,12
39294,118,56,36,3,23,95
39295,137,63,38,9,27,110
39296,220,149,30,0,41,179
39297,154,4,127,0,23,131
39298,154,108,7,5,34,120
39299,41,25,6,0,10,31
39300,32,21,9,0,2,30
39301,29,19,6,0,4,25
39302,12,0,10,0,2,10
39303,32,20,0,6,6,26
39304,91,73,0,4,14,77
39305,12,8,3,0,1,11
39306,88,30,33,8,17,71
39307,26,2,15,4,5,21
39308,43,13,17,4,9,34
39309,27,13,13,0,1,26
39310,93,63,12,2,16,77
39311,36,15,14,1,6,30
39312,33,21,6,2,4,29
39313,75,49,8,2,16,59
39314,65,22,31,2,10,55
39315,56,24,10,13,9,47
39316,135,47,46,19,23,112
39317,92,53,13,4,22,70
39318,28,8,9,3,8,20
39319,254,49,154,2,49,205
39320,66,31,15,0,20,46
39321,50,32,8,0,10,40
39322,33,14,12,0,7,26
39323,98,29,39,3,27,71
39324,56,41,6,4,5,51
39325,78,44,15,2,17,61
39326,73,55,5,4,9,64
39327,45,25,12,0,8,37
39328,354,156,123,6,69,285
39329,20,10,4,0,6,14
39330,76,9,49,1,17,59
39331,462,178,136,47,101,361
39332,64,2,42,14,6,58
39333,19,6,8,0,5,14
39334,41,10,25,4,2,39
39335,114,38,42,7,27,87
39336,45,7,24,3,11,34
39337,17,11,3,1,2,15
39338,15,2,6,1,6,9
39339,327,145,108,7,67,260
39340,200,100,50,0,50,150
39341,24,15,4,0,5,19
39342,156,111,6,4,35,121
39343,33,17,11,0,5,28
39344,151,106,19,0,26,125
39345,22,6,8,0,8,14
39346,12,4,5,1,2,10
39347,675,387,160,22,106,569
39348,62,21,23,3,15,47
39349,46,18,20,0,8,38
39350,27,14,7,2,4,23
39351,102,31,42,0,29,73
39352,35,7,11,11,6,29
39353,235,155,34,0,46,189
39354,22,6,8,2,6,16
39355,258,133,88,0,37,221
39356,46,18,20,0,8,38
39357,73,16,42,1,14,59
39358,16,8,5,0,3,13
39359,176,108,37,19,12,164
39360,166,83,48,1,34,132
39361,77,38,20,8,11,66
39362,143,66,48,5,24,119
39363,6,2,2,0,2,4
39364,132,98,6,0,28,104
39365,47,6,27,5,9,38
39366,391,119,180,8,84,307
39367,73,44,13,0,16,57
39368,277,133,85,5,54,223
39369,27,8,16,0,3,24
39370,135,61,42,10,22,113
39371,107,47,35,3,22,85
39372,28,4,6,10,8,20
39373,76,46,10,7,13,63
39374,2,1,0,0,1,1
39375,32,21,9,0,2,30
39376,107,72,15,2,18,89
39377,25,17,2,0,6,19
39378,4,0,3,0,1,3
39379,68,37,17,1,13,55
39380,49,11,29,0,9,40
39381,55,1,21,25,8,47
39382,51,33,9,0,9,42
39383,47,30,8,0,9,38
39384,140,108,5,6,21,119
39385,55,23,17,2,13,42
39386,25,0,20,0,5,20
39387,52,41,1,0,10,42
39388,442,141,189,13,99,343
39389,33,21,4,0,8,25
39390,139,80,30,5,24,115
39391,40,11,18,0,11,29
39392,67,25,25,3,14,53
39393,36,2,29,0,5,31
39394,14,0,12,0,2,12
39395,27,14,10,2,1,26
39396,14,6,4,1,3,11
39397,38,13,20,1,4,34
39398,43,14,19,3,7,36
39399,38,0,33,1,4,34
39400,77,43,19,0,15,62
39401,22,4,17,0,1,21
39402,1,0,1,0,0,1
39403,5,3,1,1,0,5
39404,19,8,9,0,2,17
39405,92,50,24,0,18,74
39406,148,69,51,5,23,125
39407,3,1,0,0,2,1
39408,57,22,15,2,18,39
39409,27,3,20,0,4,23
39410,45,9,30,0,6,39
39411,56,18,14,9,15,41
39412,39,22,10,0,7,32
39413,13,7,2,1,3,10
39414,149,73,18,25,33,116
39415,46,18,20,0,8,38
39416,55,20,22,3,10,45
39417,65,29,24,3,9,56
39418,72,54,2,0,16,56
39419,86,48,19,0,19,67
39420,43,11,19,0,13,30
39421,61,29,23,2,7,54
39422,32,8,15,4,5,27
39423,206,80,28,61,37,169
39424,178,100,33,0,45,133
39425,37,6,21,0,10,27
39426,159,62,54,19,24,135
39427,58,27,9,14,8,50
39428,19,12,2,0,5,14
39429,35,4,21,4,6,29
39430,71,46,12,0,13,58
39431,50,16,23,4,7,43
39432,29,11,14,0,4,25
39433,16,10,4,0,2,14
39434,49,9,24,12,4,45
39435,81,31,10,22,18,63
39436,465,323,42,1,99,366
39437,190,87,51,13,39,151
39438,348,80,172,7,89,259
39439,45,24,14,0,7,38
39440,129,45,48,8,28,101
39441,156,76,48,1,31,125
39442,5,3,1,0,1,4
39443,40,30,1,2,7,33
39444,32,4,24,1,3,29
39445,14,7,5,0,2,12
39446,25,6,14,0,5,20
39447,87,22,46,0,19,68
39448,23,1,16,0,6,17
39449,70,20,32,1,17,53
39450,123,94,4,2,23,100
39451,95,31,5,45,14,81
39452,230,157,31,0,42,188
39453,142,26,88,1,27,115
39454,75,18,34,3,20,55
39455,115,23,54,16,22,93
39456,32,21,9,0,2,30
39457,5,4,0,0,1,4
39458,97,44,36,0,17,80
39459,69,36,21,0,12,57
39460,83,16,51,0,16,67
39461,33,7,16,1,9,24
39462,131,70,40,0,21,110
39463,31,5,21,0,5,26
39464,99,40,33,8,18,81
39465,1,1,0,0,0,1
39466,597,334,144,17,102,495
39467,48,13,15,12,8,40
39468,6,0,4,0,2,4
39469,42,22,10,0,10,32
39470,56,14,12,21,9,47
39471,102,51,34,1,16,86
39472,31,12,9,3,7,24
39473,95,50,26,0,19,76
39474,28,7,11,1,9,19
39475,126,89,5,5,27,99
39476,25,13,3,0,9,16
39477,24,8,7,3,6,18
39478,73,33,26,0,14,59
39479,63,20,23,3,17,46
39480,78,49,18,0,11,67
39481,32,15,7,1,9,23
39482,32,21,9,0,2,30
39483,5,1,0,0,4,1
39484,150,54,39,28,29,121
39485,54,25,10,6,13,41
39486,39,6,23,0,10,29
39487,79,29,24,8,18,61
39488,127,28,44,30,25,102
39489,128,45,63,0,20,108
39490,168,78,52,3,35,133
39491,21,7,9,1,4,17
39492,72,26,29,1,16,56
39493,23,15,4,0,4,19
39494,98,45,35,1,17,81
39495,20,3,12,0,5,15
39496,51,27,14,2,8,43
39497,16,10,5,0,1,15
39498,42,19,19,1,3,39
39499,86,30,27,10,19,67
39500,109,84,3,0,22,87
39501,56,22,21,1,12,44
39502,45,37,2,0,6,39
39503,23,9,10,1,3,20
39504,314,191,48,9,66,248
39505,156,79,45,1,31,125
39506,113,64,16,7,26,87
39507,343,146,120,6,71,272
39508,38,20,12,2,4,34
39509,32,21,9,0,2,30
39510,157,80,45,1,31,126
39511,53,19,25,1,8,45
39512,68,44,12,0,12,56
39513,21,13,2,1,5,16
39514,44,35,2,0,7,37
39515,131,102,9,0,20,111
39516,34,20,7,0,7,27
39517,83,43,19,0,21,62
39518,56,25,7,11,13,43
39519,49,21,20,0,8,41
39520,122,37,54,7,24,98
39521,63,49,0,0,14,49
39522,116,51,31,9,25,91
39523,15,6,3,4,2,13
39524,44,30,6,0,8,36
39525,57,20,27,0,10,47
39526,26,7,13,0,6,20
39527,95,40,34,1,20,75
39528,27,10,11,2,4,23
39529,36,14,15,3,4,32
39530,449,246,99,14,90,359
39531,32,10,14,4,4,28
39532,56,16,28,0,12,44
39533,150,100,27,1,22,128
39534,35,16,9,0,10,25
39535,73,17,25,19,12,61
39536,92,46,32,0,14,78
39537,168,49,94,4,21,147
39538,119,82,11,3,23,96
39539,97,78,3,0,16,81
39540,14,5,4,0,5,9
39541,86,46,19,4,17,69
39542,97,49,33,0,15,82
39543,5,4,1,0,0,5
39544,69,44,11,2,12,57
39545,11,4,3,1,3,8
39546,146,92,28,0,26,120
39547,43,7,24,2,10,33
39548,33,11,11,1,10,23
39549,90,74,3,0,13,77
39550,10,4,4,0,2,8
39551,223,169,8,1,45,178
39552,35,23,4,0,8,27
39553,19,8,7,0,4,15
39554,76,33,22,9,12,64
39555,38,5,24,2,7,31
39556,26,17,4,1,4,22
39557,19,8,8,1,2,17
39558,83,22,49,0,12,71
39559,46,23,7,2,14,32
39560,39,26,7,0,6,33
39561,34,6,20,0,8,26
39562,86,26,18,23,19,67
39563,22,7,11,1,3,19
39564,25,9,13,0,3,22
39565,244,167,15,2,60,184
39566,45,25,8,4,8,37
39567,117,53,47,3,14,103
39568,69,8,54,0,7,62
39569,5,4,0,0,1,4
39570,15,7,7,0,1,14
39571,123,42,36,14,31,92
39572,61,23,8,17,13,48
39573,429,202,120,14,93,336
39574,189,122,14,12,41,148
39575,418,215,98,24,81,337
39576,112,75,16,3,18,94
39577,410,132,166,17,95,315
39578,8,2,3,0,3,5
39579,284,37,188,4,55,229
39580,105,47,41,1,16,89
39581,40,15,4,11,10,30
39582,11,3,5,0,3,8
39583,50,21,16,3,10,40
39584,74,46,7,8,13,61
39585,139,54,44,9,32,107
39586,24,6,11,1,6,18
39587,46,18,20,0,8,38
39588,185,73,43,29,40,145
39589,59,12,23,19,5,54
39590,362,195,92,15,60,302
39591,85,56,11,3,15,70
39592,41,23,14,0,4,37
39593,127,42,46,7,32,95
39594,38,17,16,0,5,33
39595,17,6,8,0,3,14
39596,7,2,3,0,2,5
39597,301,147,87,4,63,238
39598,21,13,6,2,0,21
39599,82,45,10,17,10,72
39600,57,18,15,8,16,41
39601,85,41,25,2,17,68
39602,21,4,11,0,6,15
39603,72,41,10,4,17,55
39604,47,25,10,3,9,38
39605,3,2,1,0,0,3
39606,93,35,21,18,19,74
39607,348,192,92,0,64,284
39608,278,108,109,15,46,232
39609,525,371,41,1,112,413
39610,246,103,15,81,47,199
39611,71,25,29,0,17,54
39612,80,21,18,29,12,68
39613,179,118,20,1,40,139
39614,36,3,27,1,5,31
39615,637,369,147,16,105,532
39616,34,14,11,1,8,26
39617,265,137,92,0,36,229
39618,19,0,16,0,3,16
39619,61,13,30,0,18,43
39620,250,56,128,5,61,189
39621,8,2,4,0,2,6
39622,26,20,4,0,2,24
39623,26,1,23,0,2,24
39624,183,14,132,0,37,146
39625,112,71,25,0,16,96
39626,44,29,1,0,14,30
39627,17,9,2,0,6,11
39628,4,1,0,3,0,4
39629,81,55,10,0,16,65
39630,78,57,6,0,15,63
39631,32,21,9,0,2,30
39632,201,152,16,1,32,169
39633,84,49,16,2,17,67
39634,80,1,59,0,20,60
39635,461,219,142,13,87,374
39636,80,37,26,2,15,65
39637,62,25,8,12,17,45
39638,296,217,19,2,58,238
39639,5,2,2,0,1,4
39640,41,9,13,7,12,29
39641,140,50,62,4,24,116
39642,13,2,8,0,3,10
39643,71,27,28,2,14,57
39644,86,22,7,37,20,66
39645,37,7,19,0,11,26
39646,157,68,36,16,37,120
39647,33,9,16,0,8,25
39648,94,65,19,0,10,84
39649,110,46,40,2,22,88
39650,196,100,34,26,36,160
39651,50,23,15,0,12,38
39652,49,1,38,0,10,39
39653,48,20,14,5,9,39
39654,220,90,40,38,52,168
39655,73,30,20,1,22,51
39656,14,9,5,0,0,14
39657,22,18,1,0,3,19
39658,30,7,18,0,5,25
39659,61,30,15,1,15,46
39660,201,109,31,22,39,162
39661,85,42,30,1,12,73
39662,43,10,26,1,6,37
39663,46,18,20,0,8,38
39664,25,1,19,0,5,20
39665,81,42,10,8,21,60
39666,56,23,19,5,9,47
39667,66,49,0,0,17,49
39668,84,26,38,2,18,66
39669,8,2,1,0,5,3
39670,78,23,20,16,19,59
39671,27,3,18,0,6,21
39672,23,1,17,0,5,18
39673,59,22,29,0,8,51
39674,12,5,2,1,4,8
39675,204,154,6,2,42,162
39676,456,239,108,12,97,359
39677,29,14,8,3,4,25
39678,76,34,24,0,18,58
39679,6,1,4,0,1,5
39680,44,15,19,4,6,38
39681,83,26,36,5,16,67
39682,3,0,1,0,2,1
39683,177,47,57,38,35,142
39684,22,4,8,0,10,12
39685,21,2,7,8,4,17
39686,14,8,5,0,1,13
39687,32,21,9,0,2,30
39688,32,21,9,0,2,30
39689,44,7,18,9,10,34
39690,23,8,9,1,5,18
39691,22,5,15,0,2,20
39692,77,28,30,3,16,61
39693,41,20,5,7,9,32
39694,94,49,13,17,15,79
39695,15,7,4,0,4,11
39696,35,5,22,1,7,28
39697,70,23,22,8,17,53
39698,13,4,6,1,2,11
39699,103,27,48,0,28,75
39700,119,45,30,24,20,99
39701,46,18,20,0,8,38
39702,7,2,3,0,2,5
39703,334,162,81,25,66,268
39704,69,41,6,8,14,55
39705,36,2,28,1,5,31
39706,59,13,27,2,17,42
39707,23,7,8,1,7,16
39708,32,21,9,0,2,30
39709,60,41,5,0,14,46
39710,34,13,13,0,8,26
39711,181,88,33,27,33,148
39712,329,178,91,0,60,269
39713,93,54,24,1,14,79
39714,436,105,185,44,102,334
39715,56,17,13,14,12,44
39716,11,4,3,1,3,8
39717,37,25,9,3,0,37
39718,108,46,30,12,20,88
39719,149,93,28,3,25,124
39720,115,10,73,9,23,92
39721,6,0,4,0,2,4
39722,49,34,4,4,7,42
39723,5,2,1,0,2,3
39724,22,6,8,4,4,18
39725,19,3,11,0,5,14
39726,83,25,22,18,18,65
39727,40,16,17,0,7,33
39728,117,9,76,9,23,94
39729,348,149,124,5,70,278
39730,18,6,6,1,5,13
39731,13,3,7,0,3,10
39732,30,10,15,0,5,25
39733,49,27,8,4,10,39
39734,32,14,8,6,4,28
39735,22,5,13,3,1,21
39736,180,87,33,29,31,149
39737,33,8,17,0,8,25
39738,32,21,9,0,2,30
39739,67,48,8,0,11,56
39740,47,14,20,4,9,38
39741,120,45,35,14,26,94
39742,65,26,20,4,15,50
39743,140,46,45,22,27,113
39744,103,23,65,0,15,88
39745,59,18,25,7,9,50
39746,30,19,7,4,0,30
39747,98,70,5,1,22,76
39748,200,82,32,40,46,154
39749,303,201,38,6,58,245
39750,67,18,27,5,17,50
39751,84,42,27,1,14,70
39752,16,3,9,2,2,14
39753,32,21,9,0,2,30
39754,21,6,8,1,6,15
39755,34,6,18,2,8,26
39756,28,11,13,0,4,24
39757,208,50,31,90,37,171
39758,21,8,6,0,7,14
39759,47,21,18,0,8,39
39760,32,11,13,0,8,24
39761,26,14,5,2,5,21
39762,3,2,1,0,0,3
39763,45,14,21,1,9,36
39764,103,65,27,0,11,92
39765,44,22,14,0,8,36
39766,11,8,0,0,3,8
39767,65,26,16,5,18,47
39768,159,93,36,1,29,130
39769,36,14,14,0,8,28
39770,91,61,8,0,22,69
39771,25,19,4,2,0,25
39772,40,24,10,4,2,38
39773,58,19,14,17,8,50
39774,68,21,19,8,20,48
39775,420,196,138,11,75,345
39776,37,6,22,1,8,29
39777,29,23,5,1,0,29
39778,57,2,38,12,5,52
39779,193,89,46,20,38,155
39780,29,2,21,1,5,24
39781,8,2,4,0,2,6
39782,21,7,10,2,2,19
39783,46,25,3,10,8,38
39784,96,68,11,1,16,80
39785,29,13,10,0,6,23
39786,43,5,29,0,9,34
39787,142,104,9,0,29,113
39788,24,11,10,0,3,21
39789,47,28,9,0,10,37
39790,20,10,2,1,7,13
39791,111,49,33,2,27,84
39792,47,26,6,2,13,34
39793,19,12,5,1,1,18
39794,45,15,14,3,13,32
39795,104,52,34,1,17,87
39796,419,310,20,0,89,330
39797,276,122,91,12,51,225
39798,45,7,29,5,4,41
39799,74,24,25,14,11,63
39800,32,21,9,0,2,30
39801,21,7,10,0,4,17
39802,12,0,9,0,3,9
39803,59,10,35,4,10,49
39804,36,21,5,2,8,28
39805,18,2,11,0,5,13
39806,61,48,2,0,11,50
39807,36,15,3,7,11,25
39808,85,32,32,3,18,67
39809,35,4,21,2,8,27
39810,49,27,14,0,8,41
39811,119,51,28,13,27,92
39812,129,58,32,11,28,101
39813,2,1,1,0,0,2
39814,11,1,9,0,1,10
39815,49,16,27,0,6,43
39816,190,115,56,4,15,175
39817,54,12,33,0,9,45
39818,76,42,19,6,9,67
39819,99,31,40,10,18,81
39820,64,24,13,12,15,49
39821,37,21,6,0,10,27
39822,92,53,28,7,4,88
39823,30,17,6,2,5,25
39824,23,3,16,0,4,19
39825,18,10,3,2,3,15
39826,10,0,9,0,1,9
39827,130,93,6,3,28,102
39828,47,15,14,2,16,31
39829,69,15,38,1,15,54
39830,62,17,23,0,22,40
39831,211,134,23,3,51,160
39832,57,23,4,20,10,47
39833,33,22,4,0,7,26
39834,34,26,2,0,6,28
39835,49,20,18,1,10,39
39836,46,18,20,0,8,38
39837,44,19,9,6,10,34
39838,47,16,20,4,7,40
39839,127,75,21,3,28,99
39840,62,33,14,3,12,50
39841,45,23,3,11,8,37
39842,14,1,11,0,2,12
39843,11,1,4,0,6,5
39844,119,53,16,17,33,86
39845,23,11,8,1,3,20
39846,82,19,42,1,20,62
39847,56,25,22,0,9,47
39848,223,48,124,6,45,178
39849,46,18,20,0,8,38
39850,43,3,32,0,8,35
39851,45,27,14,0,4,41
39852,18,10,4,1,3,15
39853,159,84,22,21,32,127
39854,432,201,144,12,75,357
39855,524,383,31,1,109,415
39856,36,14,14,0,8,28
39857,24,15,4,1,4,20
39858,127,84,18,1,24,103
39859,55,34,9,1,11,44
39860,185,65,83,0,37,148
39861,8,4,3,0,1,7
39862,291,47,191,1,52,239
39863,28,8,9,3,8,20
39864,100,77,3,0,20,80
39865,40,11,22,1,6,34
39866,74,18,41,2,13,61
39867,26,13,6,0,7,19
39868,172,109,11,13,39,133
39869,73,42,18,0,13,60
39870,6,4,1,0,1,5
39871,3,2,0,0,1,2
39872,304,98,137,5,64,240
39873,16,4,9,1,2,14
39874,115,56,30,0,29,86
39875,110,48,28,13,21,89
39876,174,62,75,3,34,140
39877,7,4,2,0,1,6
39878,58,25,19,1,13,45
39879,90,10,51,6,23,67
39880,32,18,9,0,5,27
39881,43,10,20,0,13,30
39882,22,15,3,1,3,19
39883,43,5,29,0,9,34
39884,47,23,18,1,5,42
39885,37,19,9,0,9,28
39886,8,0,7,0,1,7
39887,102,53,25,4,20,82
39888,103,39,32,8,24,79
39889,7,1,4,0,2,5
39890,209,110,34,21,44,165
39891,31,4,21,0,6,25
39892,172,39,21,83,29,143
39893,71,23,32,3,13,58
39894,86,66,4,4,12,74
39895,74,55,11,7,1,73
39896,675,395,141,21,118,557
39897,56,22,12,8,14,42
39898,21,3,13,0,5,16
39899,224,140,64,3,17,207
39900,62,18,31,1,12,50
39901,46,20,16,2,8,38
39902,123,102,3,3,15,108
39903,124,37,33,29,25,99
39904,36,21,7,0,8,28
39905,140,34,75,1,30,110
39906,653,383,139,17,114,539
39907,34,4,25,1,4,30
39908,64,31,12,0,21,43
39909,47,23,18,0,6,41
39910,14,5,1,3,5,9
39911,58,47,0,1,10,48
39912,87,50,20,0,17,70
39913,50,22,17,1,10,40
39914,16,6,8,1,1,15
39915,56,39,3,0,14,42
39916,18,8,7,0,3,15
39917,62,33,18,0,11,51
39918,43,9,22,5,7,36
39919,64,28,23,0,13,51
39920,20,8,6,1,5,15
39921,168,60,55,24,29,139
39922,90,60,7,4,19,71
39923,81,52,13,8,8,73
39924,151,100,26,0,25,126
39925,97,25,53,0,19,78
39926,56,36,11,0,9,47
39927,57,12,39,0,6,51
39928,20,11,4,1,4,16
39929,37,12,12,1,12,25
39930,16,7,8,0,1,15
39931,67,46,6,2,13,54
39932,293,146,86,12,49,244
39933,14,7,5,0,2,12
39934,263,201,15,0,47,216
39935,537,381,46,1,109,428
39936,409,189,122,11,87,322
39937,98,43,33,4,18,80
39938,42,5,31,1,5,37
39939,39,4,21,7,7,32
39940,91,31,31,14,15,76
39941,144,82,30,0,32,112
39942,27,12,9,1,5,22
39943,98,56,19,2,21,77
39944,153,83,19,21,30,123
39945,90,34,18,9,29,61
39946,135,71,27,10,27,108
39947,19,8,5,2,4,15
39948,403,191,135,7,70,333
39949,18,4,8,0,6,12
39950,37,13,15,0,9,28
39951,94,56,20,4,14,80
39952,25,10,11,0,4,21
39953,104,37,24,24,19,85
39954,152,100,29,0,23,129
39955,88,49,23,3,13,75
39956,116,30,55,4,27,89
39957,56,24,9,14,9,47
39958,159,119,8,4,28,131
39959,31,12,9,3,7,24
39960,267,198,16,0,53,214
39961,20,1,12,0,7,13
39962,41,8,25,4,4,37
39963,12,7,5,0,0,12
39964,59,23,22,5,9,50
39965,204,82,68,19,35,169
39966,11,2,6,0,3,8
39967,10,0,9,0,1,9
39968,140,109,6,0,25,115
39969,56,6,37,1,12,44
39970,76,44,14,1,17,59
39971,33,2,23,1,7,26
39972,13,5,4,0,4,9
39973,404,237,83,16,68,336
39974,135,49,51,0,35,100
39975,46,18,20,0,8,38
39976,36,16,8,3,9,27
39977,56,24,21,1,10,46
39978,109,53,38,1,17,92
39979,110,54,11,20,25,85
39980,62,41,8,0,13,49
39981,38,17,15,0,6,32
39982,80,18,54,2,6,74
39983,449,258,86,12,93,356
39984,174,88,43,0,43,131
39985,234,156,59,4,15,219
39986,47,11,29,0,7,40
39987,350,192,88,15,55,295
39988,57,20,25,0,12,45
39989,40,19,16,1,4,36
39990,75,11,49,0,15,60
39991,20,4,8,0,8,12
39992,38,18,15,0,5,33
39993,146,59,44,9,34,112
39994,57,13,34,1,9,48
39995,20,10,5,3,2,18
39996,37,21,6,2,8,29
39997,72,32,16,14,10,62
39998,32,21,9,0,2,30
39999,32,16,6,1,9,23
40000,46,18,20,0,8,38
40001,76,23,35,4,14,62
40002,127,36,66,0,25,102
40003,40,15,18,1,6,34
40004,85,40,22,1,22,63
40005,23,14,3,1,5,18
40006,46,18,20,0,8,38
40007,40,30,1,0,9,31
40008,23,14,2,0,7,16
40009,55,32,15,2,6,49
40010,28,12,6,5,5,23
40011,46,18,20,0,8,38
40012,36,16,12,2,6,30
40013,49,26,7,8,8,41
40014,149,32,62,22,33,116
40015,1,1,0,0,0,1
40016,62,46,12,0,4,58
40017,143,89,28,6,20,123
40018,60,41,5,1,13,47
40019,64,21,30,0,13,51
40020,27,4,20,0,3,24
40021,419,223,105,20,71,348
40022,211,71,99,4,37,174
40023,40,20,15,0,5,35
40024,220,74,82,15,49,171
40025,108,35,28,18,27,81
40026,40,13,14,3,10,30
40027,97,39,21,16,21,76
40028,11,8,0,0,3,8
40029,15,1,2,10,2,13
40030,448,226,116,12,94,354
40031,62,43,8,4,7,55
40032,46,18,20,0,8,38
40033,81,61,1,0,19,62
40034,122,80,15,6,21,101
40035,410,254,57,7,92,318
40036,93,38,32,5,18,75
40037,114,47,15,18,34,80
40038,2,0,2,0,0,2
40039,14,0,12,0,2,12
40040,668,392,147,18,111,557
40041,81,54,16,0,11,70
40042,46,18,20,0,8,38
40043,64,37,13,2,12,52
40044,71,29,19,3,20,51
40045,110,47,18,21,24,86
40046,210,115,48,0,47,163
40047,28,0,23,0,5,23
40048,21,9,9,0,3,18
40049,24,6,12,0,6,18
40050,36,20,11,0,5,31
40051,57,26,17,4,10,47
40052,7,3,1,0,3,4
40053,43,20,8,6,9,34
40054,49,18,25,0,6,43
40055,95,45,36,2,12,83
40056,112,22,55,0,35,77
40057,92,5,60,8,19,73
40058,94,58,19,2,15,79
40059,63,37,15,0,11,52
40060,57,18,29,2,8,49
40061,1,1,0,0,0,1
40062,8,0,5,0,3,5
40063,317,194,53,0,70,247
40064,14,6,6,0,2,12
40065,25,14,3,0,8,17
40066,24,10,10,2,2,22
40067,11,7,4,0,0,11
40068,82,24,40,1,17,65
40069,411,195,138,7,71,340
40070,41,18,6,7,10,31
40071,220,149,30,0,41,179
40072,68,42,16,0,10,58
40073,136,101,4,2,29,107
40074,56,15,32,0,9,47
40075,41,18,9,1,13,28
40076,15,2,10,0,3,12
40077,207,137,54,1,15,192
40078,255,193,12,0,50,205
40079,656,363,162,24,107,549
40080,46,17,18,3,8,38
40081,426,316,20,0,90,336
40082,4,1,2,0,1,3
40083,594,335,143,17,99,495
40084,80,25,33,8,14,66
40085,6,4,0,2,0,6
40086,46,36,6,1,3,43
40087,361,202,87,0,72,289
40088,55,26,3,16,10,45
40089,22,10,5,2,5,17
40090,41,20,10,4,7,34
40091,81,40,23,4,14,67
40092,86,56,15,0,15,71
40093,25,13,7,1,4,21
40094,8,0,8,0,0,8
40095,78,48,14,8,8,70
40096,102,44,38,1,19,83
40097,184,124,11,11,38,146
40098,23,10,9,1,3,20
40099,42,22,10,0,10,32
40100,30,23,2,2,3,27
40101,17,10,4,0,3,14
40102,28,11,8,2,7,21
40103,18,11,5,0,2,16
40104,275,92,126,14,43,232
40105,140,26,87,1,26,114
40106,12,3,7,1,1,11
40107,397,204,116,3,74,323
40108,13,7,1,3,2,11
40109,68,35,23,2,8,60
40110,121,95,8,0,18,103
40111,46,18,20,0,8,38
40112,121,70,29,0,22,99
40113,3,2,1,0,0,3
40114,128,92,6,2,28,100
40115,226,52,33,102,39,187
40116,28,14,2,4,8,20
40117,34,14,9,0,11,23
40118,670,398,133,20,119,551
40119,41,8,24,0,9,32
40120,422,242,77,15,88,334
40121,55,24,12,3,16,39
40122,4,2,0,1,1,3
40123,63,32,22,1,8,55
40124,258,18,192,0,48,210
40125,48,9,27,4,8,40
40126,87,54,17,4,12,75
40127,202,85,43,24,50,152
40128,11,0,6,0,5,6
40129,89,23,42,17,7,82
40130,176,130,3,2,41,135
40131,27,13,11,0,3,24
40132,46,18,20,0,8,38
40133,34,17,7,0,10,24
40134,274,143,77,0,54,220
40135,266,139,72,0,55,211
40136,55,33,10,0,12,43
40137,77,32,26,2,17,60
40138,20,12,5,0,3,17
40139,45,13,20,4,8,37
40140,40,8,21,0,11,29
40141,110,38,43,10,19,91
40142,75,26,32,5,12,63
40143,126,57,33,12,24,102
40144,6,0,4,0,2,4
40145,58,35,15,0,8,50
40146,90,42,27,7,14,76
40147,19,6,9,1,3,16
40148,148,24,65,21,38,110
40149,36,19,8,0,9,27
40150,38,9,16,3,10,28
40151,32,21,9,0,2,30
40152,107,69,26,0,12,95
40153,613,361,138,15,99,514
40154,60,41,5,1,13,47
40155,32,21,9,0,2,30
40156,60,47,2,0,11,49
40157,37,24,7,0,6,31
40158,156,97,26,3,30,126
40159,94,39,25,13,17,77
40160,19,8,8,1,2,17
40161,50,11,30,0,9,41
40162,262,89,109,9,55,207
40163,38,18,9,1,10,28
40164,280,64,151,4,61,219
40165,54,10,23,9,12,42
40166,563,395,47,1,120,443
40167,128,36,56,8,28,100
40168,410,151,128,42,89,321
40169,429,153,140,45,91,338
40170,76,6,56,1,13,63
40171,89,56,17,0,16,73
40172,127,70,11,20,26,101
40173,156,69,53,5,29,127
40174,63,42,3,0,18,45
40175,53,35,6,5,7,46
40176,30,22,2,0,6,24
40177,70,34,19,0,17,53
40178,2,2,0,0,0,2
40179,22,8,6,2,6,16
40180,109,27,30,21,31,78
40181,43,8,16,8,11,32
40182,208,143,47,2,16,192
40183,63,31,12,8,12,51
40184,201,106,52,0,43,158
40185,48,10,23,4,11,37
40186,360,184,102,1,73,287
40187,36,19,8,0,9,27
40188,44,20,13,3,8,36
40189,37,3,26,0,8,29
40190,161,26,104,1,30,131
40191,61,32,19,0,10,51
40192,51,22,17,2,10,41
40193,45,19,15,2,9,36
40194,13,6,4,1,2,11
40195,33,13,8,7,5,28
40196,14,2,6,1,5,9
40197,44,16,22,2,4,40
40198,34,26,3,5,0,34
40199,4,1,3,0,0,4
40200,129,44,49,11,25,104
40201,43,2,35,0,6,37
40202,102,49,34,1,18,84
40203,32,21,9,0,2,30
40204,61,36,12,2,11,50
40205,4,0,3,0,1,3
40206,176,50,46,44,36,140
40207,78,48,19,0,11,67
40208,6,3,1,0,2,4
40209,32,14,7,1,10,22
40210,18,8,6,1,3,15
40211,127,69,36,12,10,117
40212,73,28,7,22,16,57
40213,71,27,33,1,10,61
40214,195,76,36,33,50,145
40215,79,17,48,0,14,65
40216,181,47,19,86,29,152
40217,94,36,9,25,24,70
40218,66,24,28,4,10,56
40219,138,44,50,18,26,112
40220,46,9,30,0,7,39
40221,35,18,12,0,5,30
40222,40,9,20,0,11,29
40223,15,8,4,0,3,12
40224,77,32,26,2,17,60
40225,141,80,22,2,37,104
40226,39,19,9,0,11,28
40227,73,28,7,22,16,57
40228,286,153,80,0,53,233
40229,72,39,4,13,16,56
40230,35,15,13,0,7,28
40231,55,26,16,3,10,45
40232,221,150,30,0,41,180
40233,51,14,22,1,14,37
40234,309,163,78,16,52,257
40235,19,15,1,0,3,16
40236,143,63,26,17,37,106
40237,51,20,16,3,12,39
40238,19,7,8,3,1,18
40239,53,29,9,3,12,41
40240,184,123,12,11,38,146
40241,29,16,11,0,2,27
40242,46,18,20,0,8,38
40243,9,4,4,0,1,8
40244,18,2,15,0,1,17
40245,75,28,25,7,15,60
40246,54,26,14,3,11,43
40247,161,115,21,0,25,136
40248,42,30,6,0,6,36
40249,51,29,16,0,6,45
40250,483,234,96,55,98,385
40251,40,30,5,5,0,40
40252,80,48,17,0,15,65
40253,23,7,7,0,9,14
40254,280,133,93,4,50,230
40255,44,2,36,0,6,38
40256,42,27,4,0,11,31
40257,50,31,7,8,4,46
40258,101,18,57,1,25,76
40259,127,61,34,5,27,100
40260,100,77,3,0,20,80
40261,116,61,28,0,27,89
40262,68,46,7,0,15,53
40263,38,24,6,0,8,30
40264,10,1,8,1,0,10
40265,194,98,35,27,34,160
40266,50,33,7,0,10,40
40267,70,45,12,1,12,58
40268,15,0,11,0,4,11
40269,48,33,3,4,8,40
40270,32,21,9,0,2,30
40271,44,13,20,4,7,37
40272,121,44,41,12,24,97
40273,104,93,2,9,0,104
40274,25,7,10,0,8,17
40275,25,15,6,0,4,21
40276,143,60,32,18,33,110
40277,12,9,3,0,0,12
40278,30,16,7,2,5,25
40279,22,12,2,4,4,18
40280,61,29,23,2,7,54
40281,26,2,21,0,3,23
40282,37,1,29,0,7,30
40283,55,24,13,6,12,43
40284,227,138,7,30,52,175
40285,51,25,14,2,10,41
40286,243,100,15,83,45,198
40287,46,18,20,0,8,38
40288,42,13,17,3,9,33
40289,67,1,53,0,13,54
40290,177,69,28,50,30,147
40291,51,18,9,7,17,34
40292,224,150,33,0,41,183
40293,57,31,15,1,10,47
40294,47,25,13,0,9,38
40295,104,59,7,19,19,85
40296,32,21,9,0,2,30
40297,4,0,3,1,0,4
40298,18,6,1,6,5,13
40299,214,88,14,75,37,177
40300,475,133,200,38,104,371
40301,197,140,16,2,39,158
40302,18,8,6,1,3,15
40303,11,7,1,0,3,8
40304,55,39,5,1,10,45
40305,38,16,15,0,7,31
40306,509,270,91,44,104,405
40307,9,2,3,0,4,5
40308,14,2,6,0,6,8
40309,214,14,162,0,38,176
40310,57,10,22,13,12,45
40311,99,65,16,0,18,81
40312,53,30,11,0,12,41
40313,50,23,20,0,7,43
40314,171,122,6,5,38,133
40315,199,7,160,0,32,167
40316,41,9,18,5,9,32
40317,50,35,8,0,7,43
40318,46,18,20,0,8,38
40319,474,221,154,11,88,386
40320,31,8,18,0,5,26
40321,35,5,13,10,7,28
40322,7,2,2,2,1,6
40323,50,35,7,1,7,43
40324,42,18,18,1,5,37
40325,42,18,13,5,6,36
40326,91,43,27,2,19,72
40327,37,22,5,4,6,31
40328,38,10,18,0,10,28
40329,208,114,32,23,39,169
40330,175,84,55,7,29,146
40331,10,7,1,0,2,8
40332,11,6,3,0,2,9
40333,85,32,35,1,17,68
40334,2,1,1,0,0,2
40335,113,47,14,18,34,79
40336,28,16,5,2,5,23
40337,61,28,7,11,15,46
40338,4,2,1,0,1,3
40339,191,103,57,0,31,160
40340,36,20,8,0,8,28
40341,27,0,19,0,8,19
40342,26,1,6,14,5,21
40343,66,13,34,0,19,47
40344,36,15,15,0,6,30
40345,82,15,50,0,17,65
40346,63,36,16,0,11,52
40347,332,169,104,3,56,276
40348,4,0,4,0,0,4
40349,51,35,4,0,12,39
40350,89,53,23,1,12,77
40351,171,47,97,4,23,148
40352,80,54,9,0,17,63
40353,30,22,4,0,4,26
40354,12,9,1,0,2,10
40355,81,64,0,4,13,68
40356,32,21,9,0,2,30
40357,392,108,184,9,91,301
40358,13,3,7,0,3,10
40359,70,18,28,10,14,56
40360,89,39,27,3,20,69
40361,69,20,30,10,9,60
40362,135,107,4,1,23,112
40363,79,15,56,2,6,73
40364,87,64,7,0,16,71
40365,228,74,88,12,54,174
40366,116,47,15,18,36,80
40367,12,6,2,1,3,9
40368,137,57,54,2,24,113
40369,376,188,116,2,70,306
40370,81,39,23,1,18,63
40371,682,394,142,21,125,557
40372,102,34,38,7,23,79
40373,36,14,8,3,11,25
40374,614,344,153,21,96,518
40375,368,102,168,12,86,282
40376,17,0,13,0,4,13
40377,32,21,9,0,2,30
40378,36,8,15,6,7,29
40379,180,11,135,0,34,146
40380,234,142,9,31,52,182
40381,36,13,13,2,8,28
40382,190,79,39,28,44,146
40383,27,4,13,1,9,18
40384,55,21,18,1,15,40
40385,44,16,11,3,14,30
40386,51,17,11,17,6,45
40387,109,57,16,12,24,85
40388,249,190,13,0,46,203
40389,15,6,1,3,5,10
40390,32,19,6,0,7,25
40391,15,12,0,0,3,12
40392,342,160,99,18,65,277
40393,90,10,51,6,23,67
40394,127,74,22,3,28,99
40395,220,120,36,23,41,179
40396,32,9,16,1,6,26
40397,21,15,4,0,2,19
40398,111,59,31,0,21,90
40399,73,30,20,1,22,51
40400,83,33,33,5,12,71
40401,104,39,30,14,21,83
40402,57,33,15,0,9,48
40403,12,8,2,0,2,10
40404,235,106,71,16,42,193
40405,55,28,17,0,10,45
40406,49,34,3,5,7,42
40407,35,19,8,1,7,28
40408,454,321,37,1,95,359
40409,14,2,11,0,1,13
40410,65,38,16,0,11,54
40411,35,16,12,2,5,30
40412,87,31,39,1,16,71
40413,366,201,91,15,59,307
40414,333,166,86,13,68,265
40415,146,94,27,0,25,121
40416,98,65,16,0,17,81
40417,33,24,5,0,4,29
40418,32,6,20,1,5,27
40419,13,4,6,0,3,10
40420,79,49,13,0,17,62
40421,126,41,46,15,24,102
40422,290,71,69,90,60,230
40423,119,91,4,2,22,97
40424,34,19,7,0,8,26
40425,31,10,8,9,4,27
40426,257,130,77,0,50,207
40427,30,25,0,1,4,26
40428,38,2,31,0,5,33
40429,453,235,101,13,104,349
40430,38,4,26,0,8,30
40431,42,5,28,0,9,33
40432,177,102,22,18,35,142
40433,176,71,38,23,44,132
40434,27,10,6,0,11,16
40435,439,202,147,9,81,358
40436,10,1,7,1,1,9
40437,352,187,90,15,60,292
40438,171,58,83,0,30,141
40439,34,14,7,4,9,25
40440,17,12,2,0,3,14
40441,93,60,12,3,18,75
40442,92,39,30,10,13,79
40443,28,16,7,0,5,23
40444,43,10,20,0,13,30
40445,45,9,21,0,15,30
40446,25,13,10,1,1,24
40447,97,48,25,9,15,82
40448,77,38,26,0,13,64
40449,113,48,20,17,28,85
40450,17,10,3,0,4,13
40451,33,17,6,8,2,31
40452,79,38,21,0,20,59
40453,79,38,23,2,16,63
40454,184,145,11,0,28,156
40455,115,64,29,0,22,93
40456,13,3,10,0,0,13
40457,114,70,11,11,22,92
40458,119,53,35,2,29,90
40459,38,21,4,4,9,29
40460,36,23,7,1,5,31
40461,79,46,18,0,15,64
40462,116,32,61,0,23,93
40463,107,37,42,11,17,90
40464,94,57,20,5,12,82
40465,211,94,84,0,33,178
40466,30,17,6,2,5,25
40467,58,10,35,4,9,49
40468,127,54,39,5,29,98
40469,47,22,2,13,10,37
40470,56,29,18,0,9,47
40471,233,50,43,99,41,192
40472,51,18,10,12,11,40
40473,72,37,18,0,17,55
40474,136,83,26,0,27,109
40475,18,12,3,0,3,15
40476,63,35,13,2,13,50
40477,42,6,29,0,7,35
40478,75,34,19,6,16,59
40479,69,32,23,2,12,57
40480,46,18,20,0,8,38
40481,34,13,15,2,4,30
40482,53,27,12,0,14,39
40483,13,6,6,0,1,12
40484,70,25,5,30,10,60
40485,36,4,23,0,9,27
40486,123,56,42,4,21,102
40487,6,0,3,0,3,3
40488,55,39,5,1,10,45
40489,139,61,42,14,22,117
40490,13,0,9,0,4,9
40491,33,14,6,1,12,21
40492,174,90,46,0,38,136
40493,41,14,22,0,5,36
40494,222,86,88,4,44,178
40495,582,402,53,1,126,456
40496,216,63,21,97,35,181
40497,171,57,53,25,36,135
40498,18,16,0,0,2,16
40499,10,2,5,0,3,7
40500,32,15,5,6,6,26
40501,23,10,9,0,4,19
40502,479,328,47,1,103,376
40503,8,0,8,0,0,8
40504,42,11,11,14,6,36
40505,242,183,13,0,46,196
40506,14,5,4,3,2,12
40507,26,9,9,3,5,21
40508,7,0,5,0,2,5
40509,86,49,18,1,18,68
40510,60,22,27,2,9,51
40511,31,3,25,0,3,28
40512,52,9,19,19,5,47
40513,34,13,11,2,8,26
40514,69,26,20,12,11,58
40515,51,17,15,6,13,38
40516,121,58,28,14,21,100
40517,10,8,0,0,2,8
40518,112,37,49,3,23,89
40519,32,15,9,3,5,27
40520,51,20,20,1,10,41
40521,36,15,9,3,9,27
40522,434,244,101,0,89,345
40523,21,8,11,0,2,19
40524,27,4,16,1,6,21
40525,227,170,13,0,44,183
40526,12,3,8,0,1,11
40527,77,31,27,2,17,60
40528,15,0,11,0,4,11
40529,57,36,7,0,14,43
40530,71,34,25,1,11,60
40531,63,45,1,0,17,46
40532,626,369,130,16,111,515
40533,43,16,13,4,10,33
40534,77,44,20,0,13,64
40535,37,23,6,0,8,29
40536,33,15,8,6,4,29
40537,220,154,48,2,16,204
40538,182,75,41,21,45,137
40539,90,32,39,9,10,80
40540,26,8,10,0,8,18
40541,110,49,30,11,20,90
40542,74,17,33,8,16,58
40543,24,5,13,0,6,18
40544,97,30,40,10,17,80
40545,397,121,171,23,82,315
40546,84,50,17,3,14,70
40547,89,32,39,1,17,72
40548,32,16,10,6,0,32
40549,67,1,54,0,12,55
40550,30,14,6,2,8,22
40551,33,15,8,3,7,26
40552,114,33,36,21,24,90
40553,72,54,2,0,16,56
40554,37,25,9,3,0,37
40555,94,37,19,8,30,64
40556,72,39,12,3,18,54
40557,93,48,27,1,17,76
40558,181,133,13,1,34,147
40559,44,31,4,0,9,35
40560,88,35,35,0,18,70
40561,63,51,0,1,11,52
40562,33,24,4,0,5,28
40563,17,11,2,0,4,13
40564,49,26,8,4,11,38
40565,39,8,16,5,10,29
40566,43,9,20,5,9,34
40567,116,90,4,0,22,94
40568,171,113,27,1,30,141
40569,77,45,17,0,15,62
40570,63,11,37,0,15,48
40571,43,20,10,5,8,35
40572,623,346,155,23,99,524
40573,229,172,9,0,48,181
40574,57,29,9,6,13,44
40575,457,132,195,34,96,361
40576,61,25,16,4,16,45
40577,63,35,8,5,15,48
40578,43,20,17,0,6,37
40579,76,25,32,2,17,59
40580,107,47,35,3,22,85
40581,48,31,12,0,5,43
40582,40,2,29,1,8,32
40583,63,26,19,6,12,51
40584,14,7,5,0,2,12
40585,59,47,1,0,11,48
40586,88,42,22,0,24,64
40587,32,16,7,2,7,25
40588,65,32,14,7,12,53
40589,277,185,36,3,53,224
40590,53,20,19,1,13,40
40591,83,43,16,3,21,62
40592,212,113,48,0,51,161
40593,12,6,3,1,2,10
40594,125,44,60,0,21,104
40595,89,62,5,0,22,67
40596,152,52,37,30,33,119
40597,23,3,13,4,3,20
40598,64,38,15,0,11,53
40599,48,22,17,0,9,39
40600,46,30,7,0,9,37
40601,24,13,7,2,2,22
40602,50,4,35,7,4,46
40603,148,13,102,2,31,117
40604,40,19,13,1,7,33
40605,82,55,7,1,19,63
40606,119,88,6,0,25,94
40607,46,15,19,1,11,35
40608,33,13,14,0,6,27
40609,79,25,32,6,16,63
40610,21,8,7,2,4,17
40611,101,80,3,0,18,83
40612,437,203,97,42,95,342
40613,105,71,8,5,21,84
40614,51,34,7,0,10,41
40615,183,146,9,0,28,155
40616,109,46,18,21,24,85
40617,59,45,1,0,13,46
40618,40,20,10,0,10,30
40619,119,59,22,16,22,97
40620,80,46,18,2,14,66
40621,52,26,7,9,10,42
40622,52,15,18,8,11,41
40623,638,368,148,17,105,533
40624,65,37,14,1,13,52
40625,60,38,10,0,12,48
40626,141,79,40,12,10,131
40627,49,26,8,4,11,38
40628,81,26,33,5,17,64
40629,50,28,15,0,7,43
40630,219,137,28,3,51,168
40631,66,18,21,10,17,49
40632,115,30,61,0,24,91
40633,90,55,19,4,12,78
40634,39,9,14,10,6,33
40635,92,58,17,5,12,80
40636,409,235,88,16,70,339
40637,136,87,28,0,21,115
40638,9,3,2,0,4,5
40639,183,146,9,0,28,155
40640,71,34,12,7,18,53
40641,89,59,2,9,19,70
40642,117,90,6,0,21,96
40643,46,30,1,10,5,41
40644,121,53,41,0,27,94
40645,30,19,5,0,6,24
40646,19,6,9,2,2,17
40647,36,16,9,4,7,29
40648,47,29,11,1,6,41
40649,347,150,123,6,68,279
40650,55,21,15,5,14,41
40651,138,55,43,9,31,107
40652,48,13,14,15,6,42
40653,42,1,35,0,6,36
40654,145,57,32,26,30,115
40655,29,16,4,4,5,24
40656,71,37,18,3,13,58
40657,18,11,4,0,3,15
40658,33,17,13,0,3,30
40659,121,64,10,23,24,97
40660,8,8,0,0,0,8
40661,42,7,16,10,9,33
40662,37,18,15,0,4,33
40663,49,26,19,0,4,45
40664,32,13,8,6,5,27
40665,37,19,14,0,4,33
40666,263,181,18,4,60,203
40667,11,3,5,0,3,8
40668,22,10,8,0,4,18
40669,32,21,9,0,2,30
40670,70,45,4,10,11,59
40671,471,221,154,13,83,388
40672,55,27,20,0,8,47
40673,49,3,37,0,9,40
40674,87,17,46,3,21,66
40675,71,35,12,6,18,53
40676,59,30,13,1,15,44
40677,199,78,37,33,51,148
40678,8,7,1,0,0,8
40679,60,13,41,0,6,54
40680,71,7,46,5,13,58
40681,331,103,150,6,72,259
40682,60,44,1,0,15,45
40683,45,25,15,0,5,40
40684,9,4,2,0,3,6
40685,12,4,5,0,3,9
40686,48,35,10,3,0,48
40687,153,89,31,0,33,120
40688,41,22,6,3,10,31
40689,23,13,6,1,3,20
40690,152,75,57,4,16,136
40691,1,1,0,0,0,1
40692,280,96,126,14,44,236
40693,58,5,9,27,17,41
40694,55,18,17,3,17,38
40695,27,13,6,2,6,21
40696,46,18,20,0,8,38
40697,345,254,14,2,75,270
40698,213,114,34,21,44,169
40699,101,46,15,25,15,86
40700,15,3,8,0,4,11
40701,37,13,11,6,7,30
40702,38,6,23,4,5,33
40703,61,31,13,4,13,48
40704,166,37,16,85,28,138
40705,14,4,6,0,4,10
40706,201,76,53,29,43,158
40707,129,61,46,1,21,108
40708,17,9,4,0,4,13
40709,80,25,36,5,14,66
40710,46,5,32,0,9,37
40711,14,0,11,0,3,11
40712,190,105,54,0,31,159
40713,60,36,16,0,8,52
40714,36,11,11,6,8,28
40715,80,25,25,9,21,59
40716,70,46,11,1,12,58
40717,292,34,201,2,55,237
40718,13,5,6,0,2,11
40719,30,9,13,0,8,22
40720,32,21,9,0,2,30
40721,65,33,23,0,9,56
40722,52,25,6,4,17,35
40723,73,18,33,2,20,53
40724,94,39,16,19,20,74
40725,43,24,15,0,4,39
40726,17,9,4,1,3,14
40727,62,33,20,0,9,53
40728,37,19,8,1,9,28
40729,16,9,2,1,4,12
40730,115,88,4,2,21,94
40731,169,81,35,22,31,138
40732,142,41,69,1,31,111
40733,110,54,37,1,18,92
40734,28,16,7,0,5,23
40735,7,0,6,0,1,6
40736,66,25,22,8,11,55
40737,90,23,47,0,20,70
40738,73,27,28,4,14,59
40739,11,4,7,0,0,11
40740,108,25,46,11,26,82
40741,343,186,87,15,55,288
40742,58,35,14,0,9,49
40743,108,37,48,10,13,95
40744,21,13,1,3,4,17
40745,660,389,139,17,115,545
40746,65,42,7,1,15,50
40747,17,11,4,0,2,15
40748,349,190,89,15,55,294
40749,32,21,9,0,2,30
40750,66,36,16,0,14,52
40751,15,8,3,0,4,11
40752,52,18,21,4,9,43
40753,89,59,7,2,21,68
40754,60,7,40,1,12,48
40755,78,44,18,2,14,64
40756,62,43,4,0,15,47
40757,35,10,16,1,8,27
40758,165,126,7,0,32,133
40759,10,6,3,0,1,9
40760,9,0,8,0,1,8
40761,399,228,90,0,81,318
40762,40,18,4,13,5,35
40763,239,15,179,0,45,194
40764,28,19,5,0,4,24
40765,62,27,21,4,10,52
40766,432,244,98,0,90,342
40767,48,32,7,1,8,40
40768,116,73,7,11,25,91
40769,46,23,7,2,14,32
40770,19,10,4,0,5,14
40771,327,147,106,6,68,259
40772,47,25,8,2,12,35
40773,60,19,24,4,13,47
40774,14,3,3,2,6,8
40775,121,50,30,18,23,98
40776,673,390,141,20,122,551
40777,140,79,22,2,37,103
40778,125,41,34,27,23,102
40779,27,3,20,0,4,23
40780,32,21,9,0,2,30
40781,69,48,4,6,11,58
40782,18,10,4,0,4,14
40783,207,83,25,61,38,169
40784,259,172,68,2,17,242
40785,24,0,14,1,9,15
40786,43,6,28,0,9,34
40787,36,14,20,0,2,34
40788,109,33,53,0,23,86
40789,93,41,27,1,24,69
40790,63,27,29,0,7,56
40791,39,0,30,0,9,30
40792,86,20,36,11,19,67
40793,99,65,17,0,17,82
40794,20,9,5,1,5,15
40795,10,3,5,0,2,8
40796,92,29,39,8,16,76
40797,48,36,4,0,8,40
40798,49,30,7,0,12,37
40799,561,328,123,15,95,466
40800,52,12,25,3,12,40
40801,34,9,14,1,10,24
40802,10,2,7,0,1,9
40803,348,194,79,7,68,280
40804,93,50,17,7,19,74
40805,194,63,60,26,45,149
40806,27,9,15,0,3,24
40807,52,37,8,0,7,45
40808,65,33,5,16,11,54
40809,12,3,5,0,4,8
40810,63,19,32,1,11,52
40811,47,17,16,4,10,37
40812,18,9,8,0,1,17
40813,377,218,68,14,77,300
40814,52,31,13,0,8,44
40815,156,91,40,1,24,132
40816,7,4,2,0,1,6
40817,25,3,17,1,4,21
40818,37,19,8,3,7,30
40819,58,43,3,2,10,48
40820,23,16,5,0,2,21
40821,171,38,18,86,29,142
40822,12,8,2,1,1,11
40823,127,51,29,15,32,95
40824,54,28,12,4,10,44
40825,190,86,52,13,39,151
40826,468,292,74,3,99,369
40827,94,31,34,8,21,73
40828,32,21,9,0,2,30
40829,9,5,2,0,2,7
40830,191,109,43,9,30,161
40831,43,20,12,2,9,34
40832,33,3,5,17,8,25
40833,64,47,2,0,15,49
40834,100,36,39,10,15,85
40835,76,43,6,6,21,55
40836,28,11,12,0,5,23
40837,200,114,24,22,40,160
40838,93,54,16,1,22,71
40839,179,76,26,30,47,132
40840,83,23,46,2,12,71
40841,63,17,33,1,12,51
40842,22,14,4,1,3,19
40843,31,15,10,0,6,25
40844,28,15,8,0,5,23
40845,224,119,52,13,40,184
40846,3,0,2,0,1,2
40847,49,11,32,0,6,43
40848,12,5,2,1,4,8
40849,46,7,28,0,11,35
40850,22,12,6,0,4,18
40851,102,66,10,2,24,78
40852,19,8,4,2,5,14
40853,293,98,124,11,60,233
40854,446,208,140,12,86,360
40855,166,67,49,6,44,122
40856,94,64,15,0,15,79
40857,5,0,4,0,1,4
40858,10,6,1,0,3,7
40859,103,28,51,2,22,81
40860,60,26,18,5,11,49
40861,52,31,10,0,11,41
40862,639,371,146,16,106,533
40863,500,262,92,45,101,399
40864,53,34,7,0,12,41
40865,10,4,3,0,3,7
40866,54,31,7,0,16,38
40867,46,18,20,0,8,38
40868,105,29,58,0,18,87
40869,300,154,86,0,60,240
40870,212,98,62,13,39,173
40871,88,35,40,0,13,75
40872,256,129,49,28,50,206
40873,21,10,7,0,4,17
40874,15,5,9,0,1,14
40875,45,12,25,1,7,38
40876,97,62,10,9,16,81
40877,83,43,19,1,20,63
40878,278,43,180,3,52,226
40879,11,3,8,0,0,11
40880,4,0,3,0,1,3
40881,53,0,33,3,17,36
40882,299,145,86,4,64,235
40883,172,83,53,3,33,139
40884,143,73,18,22,30,113
40885,74,5,52,1,16,58
40886,30,17,8,0,5,25
40887,101,52,28,0,21,80
40888,386,223,84,0,79,307
40889,42,22,10,0,10,32
40890,156,66,35,22,33,123
40891,44,16,10,4,14,30
40892,26,18,5,3,0,26
40893,194,92,61,0,41,153
40894,422,192,136,12,82,340
40895,89,25,52,2,10,79
40896,30,9,7,4,10,20
40897,124,44,52,3,25,99
40898,19,7,9,1,2,17
40899,24,9,10,1,4,20
40900,32,21,9,0,2,30
40901,44,35,2,0,7,37
40902,48,33,6,1,8,40
40903,96,49,18,12,17,79
40904,672,392,139,20,121,551
40905,50,23,11,1,15,35
40906,11,3,6,1,1,10
40907,10,2,7,0,1,9
40908,38,5,25,0,8,30
40909,60,15,32,1,12,48
40910,25,9,12,0,4,21
40911,54,15,13,19,7,47
40912,101,27,48,8,18,83
40913,46,18,20,0,8,38
40914,92,42,14,12,24,68
40915,134,75,22,3,34,100
40916,199,108,30,21,40,159
40917,63,18,5,27,13,50
40918,44,26,11,1,6,38
40919,18,1,13,0,4,14
40920,46,13,26,0,7,39
40921,193,54,34,70,35,158
40922,46,25,13,0,8,38
40923,178,102,31,0,45,133
40924,125,36,55,7,27,98
40925,7,1,4,2,0,7
40926,108,46,30,12,20,88
40927,58,32,14,3,9,49
40928,80,21,34,1,24,56
40929,46,13,10,13,10,36
40930,55,27,10,0,18,37
40931,91,29,46,0,16,75
40932,15,4,8,0,3,12
40933,35,19,9,0,7,28
40934,59,31,8,7,13,46
40935,82,33,30,0,19,63
40936,107,83,7,0,17,90
40937,32,21,9,0,2,30
40938,20,5,12,0,3,17
40939,27,12,10,0,5,22
40940,17,12,0,0,5,12
40941,137,85,29,1,22,115
40942,197,102,63,0,32,165
40943,158,113,6,3,36,122
40944,79,15,56,2,6,73
40945,166,73,50,9,34,132
40946,102,39,33,13,17,85
40947,64,45,7,1,11,53
40948,46,18,20,0,8,38
40949,19,3,13,0,3,16
40950,118,46,31,12,29,89
40951,242,55,24,122,41,201
40952,46,18,20,0,8,38
40953,211,70,100,4,37,174
40954,59,14,32,2,11,48
40955,337,89,159,6,83,254
40956,10,2,5,1,2,8
40957,31,11,11,0,9,22
40958,29,11,14,0,4,25
40959,46,18,20,0,8,38
40960,14,8,3,0,3,11
40961,35,13,18,0,4,31
40962,32,21,9,0,2,30
40963,100,46,16,19,19,81
40964,11,7,2,0,2,9
40965,52,19,22,2,9,43
40966,175,122,7,4,42,133
40967,35,2,25,0,8,27
40968,48,13,22,5,8,40
40969,277,93,126,14,44,233
40970,94,56,23,1,14,80
40971,90,27,40,2,21,69
40972,116,38,37,13,28,88
40973,26,16,3,0,7,19
40974,258,140,72,0,46,212
40975,33,8,10,4,11,22
40976,19,0,10,0,9,10
40977,53,26,15,1,11,42
40978,279,187,67,3,22,257
40979,129,65,13,23,28,101
40980,215,122,40,12,41,174
40981,47,26,10,3,8,39
40982,13,5,5,0,3,10
40983,51,33,11,7,0,51
40984,20,0,16,1,3,17
40985,10,5,5,0,0,10
40986,39,26,10,0,3,36
40987,11,3,5,0,3,8
40988,50,23,13,4,10,40
40989,68,43,12,0,13,55
40990,68,27,27,1,13,55
40991,39,20,10,1,8,31
40992,38,7,20,4,7,31
40993,36,17,7,2,10,26
40994,478,326,48,1,103,375
40995,11,2,8,0,1,10
40996,153,9,91,23,30,123
40997,72,30,22,3,17,55
40998,46,18,20,0,8,38
40999,62,18,33,1,10,52
41000,12,1,6,0,5,7
41001,214,76,78,10,50,164
41002,531,313,117,14,87,444
41003,61,29,23,2,7,54
41004,10,4,5,0,1,9
41005,39,25,6,1,7,32
41006,163,110,27,0,26,137
41007,239,72,113,15,39,200
41008,244,185,13,0,46,198
41009,67,46,6,0,15,52
41010,212,58,21,101,32,180
41011,80,39,23,2,16,64
41012,46,18,20,0,8,38
41013,74,35,28,0,11,63
41014,177,69,69,1,38,139
41015,64,31,15,0,18,46
41016,55,20,16,5,14,41
41017,106,45,9,27,25,81
41018,76,46,17,0,13,63
41019,234,93,14,83,44,190
41020,140,33,48,30,29,111
41021,50,19,17,3,11,39
41022,326,152,113,1,60,266
41023,353,180,104,4,65,288
41024,149,64,28,20,37,112
41025,19,6,8,1,4,15
41026,50,26,8,4,12,38
41027,31,10,4,7,10,21
41028,116,76,24,3,13,103
41029,74,35,3,14,22,52
41030,38,9,22,0,7,31
41031,76,17,41,7,11,65
41032,358,164,89,30,75,283
41033,129,65,15,19,30,99
41034,25,11,11,0,3,22
41035,60,38,11,1,10,50
41036,108,58,33,4,13,95
41037,177,91,40,9,37,140
41038,13,3,5,0,5,8
41039,4,0,3,0,1,3
41040,379,191,116,1,71,308
41041,20,5,6,3,6,14
41042,44,9,14,7,14,30
41043,84,37,24,0,23,61
41044,63,25,11,16,11,52
41045,37,27,0,0,10,27
41046,202,154,12,0,36,166
41047,300,152,80,16,52,248
41048,162,60,68,12,22,140
41049,61,41,9,0,11,50
41050,324,151,82,25,66,258
41051,55,25,20,2,8,47
41052,299,100,132,11,56,243
41053,32,24,1,0,7,25
41054,46,18,18,0,10,36
41055,87,56,10,2,19,68
41056,162,115,10,7,30,132
41057,32,21,9,0,2,30
41058,17,0,13,0,4,13
41059,25,10,8,0,7,18
41060,32,21,9,0,2,30
41061,44,24,11,0,9,35
41062,6,0,4,0,2,4
41063,133,52,48,11,22,111
41064,412,213,93,13,93,319
41065,23,8,13,0,2,21
41066,7,2,5,0,0,7
41067,45,22,14,1,8,37
41068,150,90,29,0,31,119
41069,96,51,25,3,17,79
41070,41,7,23,2,9,32
41071,59,29,21,0,9,50
41072,321,166,85,15,55,266
41073,220,150,29,0,41,179
41074,78,27,18,15,18,60
41075,29,20,4,0,5,24
41076,99,61,24,12,2,97
41077,468,192,122,51,103,365
41078,13,3,6,0,4,9
41079,41,13,13,6,9,32
41080,135,101,10,0,24,111
41081,4,1,3,0,0,4
41082,105,43,41,3,18,87
41083,60,28,17,3,12,48
41084,99,61,23,0,15,84
41085,33,12,3,9,9,24
41086,49,14,28,1,6,43
41087,15,12,0,0,3,12
41088,9,8,0,0,1,8
41089,14,8,3,0,3,11
41090,37,8,18,0,11,26
41091,34,3,22,0,9,25
41092,34,16,7,3,8,26
41093,147,98,24,0,25,122
41094,6,3,1,1,1,5
41095,26,8,13,1,4,22
41096,9,3,5,0,1,8
41097,83,38,31,0,14,69
41098,213,81,92,3,37,176
41099,13,7,3,0,3,10
41100,359,192,84,9,74,285
41101,221,47,54,77,43,178
41102,60,13,40,1,6,54
41103,10,4,4,1,1,9
41104,277,18,203,2,54,223
41105,97,24,57,2,14,83
41106,32,21,9,0,2,30
41107,169,124,9,5,31,138
41108,396,231,82,16,67,329
41109,88,27,23,20,18,70
41110,67,35,15,1,16,51
41111,366,200,76,15,75,291
41112,30,10,5,8,7,23
41113,25,12,10,0,3,22
41114,154,66,34,21,33,121
41115,63,26,8,12,17,46
41116,21,5,14,1,1,20
41117,16,5,7,0,4,12
41118,468,219,144,12,93,375
41119,13,1,6,0,6,7
41120,435,201,137,9,88,347
41121,36,27,6,3,0,36
41122,39,5,28,0,6,33
41123,46,21,13,3,9,37
41124,50,27,10,4,9,41
41125,25,9,10,2,4,21
41126,81,37,5,16,23,58
41127,34,6,22,0,6,28
41128,35,1,29,0,5,30
41129,43,0,34,0,9,34
41130,32,21,9,0,2,30
41131,56,17,31,1,7,49
41132,156,116,8,4,28,128
41133,40,6,27,4,3,37
41134,201,80,14,69,38,163
41135,212,45,55,72,40,172
41136,53,34,9,0,10,43
41137,96,33,44,5,14,82
41138,24,11,10,0,3,21
41139,51,15,25,4,7,44
41140,35,8,18,0,9,26
41141,12,6,4,0,2,10
41142,141,53,59,5,24,117
41143,29,2,21,1,5,24
41144,97,57,15,5,20,77
41145,134,39,37,23,35,99
41146,92,32,42,8,10,82
41147,34,14,11,0,9,25
41148,111,84,2,0,25,86
41149,17,5,6,0,6,11
41150,48,34,5,1,8,40
41151,104,37,28,12,27,77
41152,27,12,14,0,1,26
41153,29,12,9,0,8,21
41154,74,11,51,0,12,62
41155,142,27,88,1,26,116
41156,272,60,143,7,62,210
41157,51,30,6,2,13,38
41158,220,149,30,0,41,179
41159,98,29,49,5,15,83
41160,67,40,7,8,12,55
41161,89,53,14,3,19,70
41162,33,20,7,1,5,28
41163,2,0,0,0,2,0
41164,53,23,18,0,12,41
41165,10,6,1,0,3,7
41166,39,5,26,0,8,31
41167,33,18,8,0,7,26
41168,46,22,20,0,4,42
41169,76,23,40,0,13,63
41170,239,141,37,16,45,194
41171,8,2,4,2,0,8
41172,92,32,21,20,19,73
41173,42,17,17,0,8,34
41174,8,3,4,0,1,7
41175,200,101,50,0,49,151
41176,44,24,18,0,2,42
41177,7,4,2,0,1,6
41178,20,4,7,1,8,12
41179,63,31,10,6,16,47
41180,42,7,27,4,4,38
41181,49,32,6,2,9,40
41182,32,21,9,0,2,30
41183,80,37,5,16,22,58
41184,53,12,32,0,9,44
41185,96,44,33,1,18,78
41186,59,27,11,6,15,44
41187,62,18,25,5,14,48
41188,50,19,15,8,8,42
41189,19,3,11,0,5,14
41190,28,11,6,6,5,23
41191,45,13,21,4,7,38
41192,165,74,52,6,33,132
41193,55,24,13,6,12,43
41194,92,22,51,0,19,73
41195,486,260,82,42,102,384
41196,55,5,35,1,14,41
41197,117,37,40,14,26,91
41198,24,14,5,1,4,20
41199,41,20,5,7,9,32
41200,41,15,19,0,7,34
41201,19,3,13,0,3,16
41202,296,201,35,1,59,237
41203,67,40,12,0,15,52
41204,41,9,14,6,12,29
41205,231,174,9,0,48,183
41206,22,2,7,9,4,18
41207,9,8,0,0,1,8
41208,105,29,57,0,19,86
41209,22,7,11,0,4,18
41210,348,178,103,3,64,284
41211,1,0,0,0,1,0
41212,18,14,3,0,1,17
41213,25,3,13,0,9,16
41214,193,105,22,22,44,149
41215,46,3,36,0,7,39
41216,37,9,13,6,9,28
41217,38,7,23,1,7,31
41218,54,31,15,0,8,46
41219,88,45,24,2,17,71
41220,674,392,136,21,125,549
41221,427,198,140,11,78,349
41222,32,21,9,0,2,30
41223,76,3,55,0,18,58
41224,60,33,15,1,11,49
41225,243,184,13,0,46,197
41226,48,14,24,0,10,38
41227,32,21,9,0,2,30
41228,51,29,7,3,12,39
41229,149,109,6,0,34,115
41230,238,138,45,7,48,190
41231,64,25,20,5,14,50
41232,43,25,8,2,8,35
41233,23,7,9,0,7,16
41234,207,41,129,2,35,172
41235,74,53,8,0,13,61
41236,207,115,30,23,39,168
41237,101,66,1,12,22,79
41238,22,8,9,3,2,20
41239,45,25,17,0,3,42
41240,31,4,19,0,8,23
41241,13,4,2,1,6,7
41242,98,59,17,3,19,79
41243,133,34,69,1,29,104
41244,90,47,17,7,19,71
41245,71,5,50,1,15,56
41246,88,43,5,27,13,75
41247,130,37,64,1,28,102
41248,48,17,18,4,9,39
41249,22,4,12,2,4,18
41250,235,178,18,2,37,198
41251,166,121,4,1,40,126
41252,117,95,3,0,19,98
41253,12,0,8,0,4,8
41254,84,22,38,7,17,67
41255,15,4,6,0,5,10
41256,84,32,34,5,13,71
41257,55,32,15,2,6,49
41258,26,17,0,0,9,17
41259,52,33,12,7,0,52
41260,138,103,6,0,29,109
41261,59,34,16,0,9,50
41262,20,3,11,0,6,14
41263,15,6,6,0,3,12
41264,110,80,11,9,10,100
41265,85,49,19,0,17,68
41266,87,54,18,0,15,72
41267,53,21,21,1,10,43
41268,30,16,8,0,6,24
41269,284,153,77,0,54,230
41270,8,3,4,0,1,7
41271,98,61,17,12,8,90
41272,34,15,4,6,9,25
41273,11,3,6,1,1,10
41274,62,45,1,0,16,46
41275,60,14,40,0,6,54
41276,152,66,51,14,21,131
41277,195,76,35,33,51,144
41278,14,6,8,0,0,14
41279,294,147,86,12,49,245
41280,100,22,33,19,26,74
41281,60,43,12,0,5,55
41282,273,111,106,8,48,225
41283,77,12,51,0,14,63
41284,12,7,4,0,1,11
41285,36,15,16,1,4,32
41286,262,167,70,4,21,241
41287,78,46,17,2,13,65
41288,523,344,73,4,102,421
41289,233,62,122,7,42,191
41290,14,0,11,0,3,11
41291,52,36,2,0,14,38
41292,141,79,34,1,27,114
41293,44,28,4,3,9,35
41294,62,43,8,4,7,55
41295,41,23,14,0,4,37
41296,39,23,5,6,5,34
41297,14,4,7,0,3,11
41298,73,40,18,0,15,58
41299,38,29,6,3,0,38
41300,180,119,23,4,34,146
41301,83,45,18,0,20,63
41302,44,15,18,3,8,36
41303,94,53,19,7,15,79
41304,51,31,10,0,10,41
41305,48,11,33,0,4,44
41306,197,130,22,0,45,152
41307,37,18,8,1,10,27
41308,94,54,15,1,24,70
41309,77,33,19,3,22,55
41310,102,67,1,12,22,80
41311,47,26,16,0,5,42
41312,64,35,14,0,15,49
41313,31,22,6,3,0,31
41314,67,37,17,0,13,54
41315,44,35,2,0,7,37
41316,240,176,12,1,51,189
41317,119,50,46,2,21,98
41318,43,18,18,1,6,37
41319,116,27,54,15,20,96
41320,38,26,5,0,7,31
41321,32,21,9,0,2,30
41322,104,35,39,6,24,80
41323,291,162,78,0,51,240
41324,50,29,13,0,8,42
41325,82,49,18,2,13,69
41326,65,26,18,5,16,49
41327,159,30,97,1,31,128
41328,3,0,1,0,2,1
41329,55,33,10,0,12,43
41330,195,75,36,34,50,145
41331,117,88,3,0,26,91
41332,128,45,48,8,27,101
41333,30,12,9,3,6,24
41334,86,50,18,1,17,69
41335,52,14,28,0,10,42
41336,64,19,32,1,12,52
41337,54,22,14,1,17,37
41338,40,23,5,7,5,35
41339,29,7,4,14,4,25
41340,72,38,18,4,12,60
41341,89,24,37,17,11,78
41342,13,5,5,2,1,12
41343,57,32,10,0,15,42
41344,116,58,20,16,22,94
41345,49,32,6,2,9,40
41346,42,22,10,0,10,32
41347,42,11,20,0,11,31
41348,106,81,7,0,18,88
41349,556,396,45,1,114,442
41350,44,20,15,1,8,36
41351,35,5,20,4,6,29
41352,29,9,11,0,9,20
41353,28,12,13,0,3,25
41354,24,4,17,0,3,21
41355,57,16,23,4,14,43
41356,75,9,42,5,19,56
41357,198,131,22,0,45,153
41358,10,1,8,0,1,9
41359,12,0,9,0,3,9
41360,32,21,9,0,2,30
41361,103,66,11,2,24,79
41362,63,31,22,2,8,55
41363,40,0,32,2,6,34
41364,11,5,0,2,4,7
41365,9,1,6,0,2,7
41366,73,49,7,0,17,56
41367,46,19,18,0,9,37
41368,64,36,17,0,11,53
41369,164,115,13,1,35,129
41370,58,23,17,0,18,40
41371,96,87,0,9,0,96
41372,141,108,9,0,24,117
41373,28,10,11,0,7,21
41374,29,11,2,13,3,26
41375,26,15,7,0,4,22
41376,12,6,3,0,3,9
41377,46,18,20,0,8,38
41378,27,11,8,4,4,23
41379,14,3,10,1,0,14
41380,108,49,39,0,20,88
41381,39,14,14,3,8,31
41382,16,4,8,2,2,14
41383,215,127,37,4,47,168
41384,6,0,3,1,2,4
41385,9,0,4,2,3,6
41386,36,12,12,2,10,26
41387,269,137,93,0,39,230
41388,162,63,39,23,37,125
41389,158,64,36,19,39,119
41390,149,43,66,4,36,113
41391,112,57,30,4,21,91
41392,60,36,9,0,15,45
41393,22,10,7,0,5,17
41394,5,1,3,0,1,4
41395,32,6,12,7,7,25
41396,58,26,12,8,12,46
41397,23,11,10,0,2,21
41398,85,24,36,9,16,69
41399,68,33,25,0,10,58
41400,14,9,4,0,1,13
41401,29,16,6,0,7,22
41402,32,12,12,0,8,24
41403,71,39,25,2,5,66
41404,50,27,14,1,8,42
41405,56,41,2,0,13,43
41406,50,34,9,0,7,43
41407,285,35,197,2,51,234
41408,49,34,8,0,7,42
41409,36,21,9,1,5,31
41410,56,38,11,0,7,49
41411,10,0,9,0,1,9
41412,76,38,17,2,19,57
41413,96,25,36,13,22,74
41414,37,28,7,2,0,37
41415,246,175,23,6,42,204
41416,9,1,6,0,2,7
41417,45,11,24,0,10,35
41418,151,24,98,1,28,123
41419,136,48,34,19,35,101
41420,14,2,7,3,2,12
41421,183,146,9,0,28,155
41422,17,6,8,0,3,14
41423,174,47,56,36,35,139
41424,145,94,27,0,24,121
41425,84,34,34,5,11,73
41426,55,34,11,0,10,45
41427,43,16,8,7,12,31
41428,32,21,9,0,2,30
41429,85,28,42,2,13,72
41430,88,60,15,0,13,75
41431,13,2,5,0,6,7
41432,54,0,34,3,17,37
41433,494,343,41,1,109,385
41434,18,6,6,1,5,13
41435,26,20,2,1,3,23
41436,57,13,6,26,12,45
41437,231,100,74,16,41,190
41438,46,9,29,2,6,40
41439,28,9,14,0,5,23
41440,75,58,1,0,16,59
41441,31,11,11,0,9,22
41442,106,63,15,8,20,86
41443,47,24,14,0,9,38
41444,95,76,3,0,16,79
41445,32,18,12,0,2,30
41446,51,22,23,1,5,46
41447,28,7,15,2,4,24
41448,31,10,17,0,4,27
41449,32,21,9,0,2,30
41450,95,24,51,3,17,78
41451,103,67,18,0,18,85
41452,13,6,7,0,0,13
41453,41,11,25,0,5,36
41454,51,27,8,6,10,41
41455,192,138,7,3,44,148
41456,37,16,10,0,11,26
41457,135,91,19,1,24,111
41458,6,0,4,0,2,4
41459,74,38,25,0,11,63
41460,101,51,24,5,21,80
41461,27,10,12,1,4,23
41462,665,391,141,17,116,549
41463,109,37,39,7,26,83
41464,15,11,1,0,3,12
41465,32,18,10,0,4,28
41466,15,3,11,0,1,14
41467,6,1,4,0,1,5
41468,451,257,89,12,93,358
41469,351,188,83,9,71,280
41470,9,0,6,0,3,6
41471,32,21,9,0,2,30
41472,12,4,5,0,3,9
41473,111,43,38,3,27,84
41474,124,68,24,5,27,97
41475,167,46,90,4,27,140
41476,60,21,31,0,8,52
41477,67,24,11,20,12,55
41478,151,48,77,4,22,129
41479,7,4,1,0,2,5
41480,138,73,34,0,31,107
41481,33,16,9,2,6,27
41482,15,3,10,0,2,13
41483,117,61,35,1,20,97
41484,90,37,38,2,13,77
41485,25,12,4,3,6,19
41486,88,47,30,2,9,79
41487,64,14,34,1,15,49
41488,45,33,2,0,10,35
41489,11,7,2,0,2,9
41490,129,40,48,17,24,105
41491,89,64,6,0,19,70
41492,29,4,21,2,2,27
41493,8,4,3,0,1,7
41494,48,34,7,0,7,41
41495,8,0,8,0,0,8
41496,579,346,111,16,106,473
41497,40,30,1,2,7,33
41498,22,0,18,2,2,20
41499,23,7,12,1,3,20
41500,31,3,21,1,6,25
41501,26,7,14,0,5,21
41502,234,176,13,0,45,189
41503,34,2,24,0,8,26
41504,85,49,19,0,17,68
41505,91,51,20,4,16,75
41506,33,21,3,1,8,25
41507,87,56,20,0,11,76
41508,36,9,19,0,8,28
41509,67,32,23,1,11,56
41510,72,26,18,19,9,63
41511,66,45,5,0,16,50
41512,15,4,8,0,3,12
41513,37,14,14,0,9,28
41514,414,309,20,0,85,329
41515,186,58,77,14,37,149
41516,39,6,22,0,11,28
41517,32,21,9,0,2,30
41518,52,15,26,2,9,43
41519,55,32,15,2,6,49
41520,15,3,10,0,2,13
41521,18,5,8,0,5,13
41522,109,34,54,0,21,88
41523,46,18,20,0,8,38
41524,55,39,11,4,1,54
41525,28,9,11,0,8,20
41526,44,33,4,2,5,39
41527,164,130,5,0,29,135
41528,84,37,25,10,12,72
41529,45,10,23,5,7,38
41530,27,13,13,0,1,26
41531,108,62,25,3,18,90
41532,155,101,30,0,24,131
41533,90,70,0,4,16,74
41534,144,66,59,3,16,128
41535,136,48,66,0,22,114
41536,98,60,23,0,15,83
41537,53,37,1,0,15,38
41538,179,70,42,29,38,141
41539,247,187,18,2,40,207
41540,32,9,20,0,3,29
41541,38,3,21,3,11,27
41542,113,46,15,18,34,79
41543,73,33,13,6,21,52
41544,27,8,14,0,5,22
41545,260,134,91,0,35,225
41546,29,14,12,2,1,28
41547,60,27,23,0,10,50
41548,229,160,49,2,18,211
41549,22,0,19,1,2,20
41550,172,46,55,36,35,137
41551,85,50,23,0,12,73
41552,40,17,19,0,4,36
41553,8,5,0,2,1,7
41554,59,36,11,0,12,47
41555,30,14,11,0,5,25
41556,109,57,23,4,25,84
41557,301,160,79,13,49,252
41558,517,252,102,56,107,410
41559,39,17,6,7,9,30
41560,69,37,14,0,18,51
41561,78,48,8,8,14,64
41562,43,26,8,2,7,36
41563,27,1,17,0,9,18
41564,108,51,17,23,17,91
41565,430,206,142,6,76,354
41566,209,138,22,0,49,160
41567,55,16,28,1,10,45
41568,22,2,14,0,6,16
41569,68,25,33,0,10,58
41570,6,1,2,0,3,3
41571,70,52,2,0,16,54
41572,182,70,46,27,39,143
41573,95,43,7,20,25,70
41574,579,418,41,1,119,460
41575,176,96,34,17,29,147
41576,63,15,8,26,14,49
41577,391,201,115,2,73,318
41578,40,1,33,0,6,34
41579,43,26,5,6,6,37
41580,11,3,5,0,3,8
41581,486,225,111,50,100,386
41582,119,27,57,5,30,89
41583,8,0,5,1,2,6
41584,18,8,7,0,3,15
41585,159,108,26,0,25,134
41586,74,44,14,3,13,61
41587,46,15,19,0,12,34
41588,158,55,39,31,33,125
41589,38,23,5,0,10,28
41590,19,8,9,0,2,17
41591,140,52,30,23,35,105
41592,11,1,7,0,3,8
41593,54,32,16,0,6,48
41594,192,57,104,4,27,165
41595,47,19,16,3,9,38
41596,212,117,32,23,40,172
41597,9,7,2,0,0,9
41598,33,12,10,1,10,23
41599,1075,391,437,46,201,874
41600,9,1,6,1,1,8
41601,10,6,1,0,3,7
41602,55,39,5,1,10,45
41603,47,8,32,0,7,40
41604,48,8,28,3,9,39
41605,117,50,29,13,25,92
41606,79,36,30,1,12,67
41607,56,1,43,0,12,44
41608,90,26,51,0,13,77
41609,20,18,0,0,2,18
41610,64,48,12,0,4,60
41611,653,360,166,22,105,548
41612,64,41,5,0,18,46
41613,37,13,17,2,5,32
41614,164,49,51,26,38,126
41615,95,32,33,12,18,77
41616,67,46,5,1,15,52
41617,138,56,42,17,23,115
41618,24,5,14,0,5,19
41619,56,1,43,0,12,44
41620,8,1,7,0,0,8
41621,206,128,61,4,13,193
41622,51,10,31,2,8,43
41623,244,127,69,0,48,196
41624,1,1,0,0,0,1
41625,139,76,24,7,32,107
41626,64,8,49,0,7,57
41627,27,11,5,8,3,24
41628,44,27,11,6,0,44
41629,349,182,93,15,59,290
41630,55,21,25,0,9,46
41631,33,15,10,0,8,25
41632,154,79,44,1,30,124
41633,61,31,9,8,13,48
41634,140,100,10,2,28,112
41635,459,167,153,42,97,362
41636,36,24,8,0,4,32
41637,76,60,2,1,13,63
41638,150,104,7,5,34,116
41639,40,33,0,0,7,33
41640,172,63,50,26,33,139
41641,87,41,27,4,15,72
41642,38,19,9,1,9,29
41643,27,9,13,1,4,23
41644,46,19,13,0,14,32
41645,13,6,4,1,2,11
41646,37,19,8,1,9,28
41647,89,48,17,8,16,73
41648,137,50,52,3,32,105
41649,74,43,20,0,11,63
41650,138,78,21,2,37,101
41651,13,13,0,0,0,13
41652,427,241,99,0,87,340
41653,91,42,29,3,17,74
41654,138,75,34,15,14,124
41655,81,25,37,5,14,67
41656,31,24,2,0,5,26
41657,62,18,33,3,8,54
41658,14,6,5,0,3,11
41659,33,4,14,6,9,24
41660,75,60,2,1,12,63
41661,17,10,6,0,1,16
41662,138,81,21,2,34,104
41663,77,27,27,5,18,59
41664,221,90,41,38,52,169
41665,56,28,6,4,18,38
41666,24,3,18,0,3,21
41667,8,0,7,0,1,7
41668,9,1,3,4,1,8
41669,20,14,3,0,3,17
41670,45,29,5,6,5,40
41671,46,18,20,0,8,38
41672,74,29,33,5,7,67
41673,94,61,15,0,18,76
41674,88,44,25,4,15,73
41675,20,10,5,1,4,16
41676,6,3,0,1,2,4
41677,85,56,12,0,17,68
41678,29,1,22,0,6,23
41679,34,26,2,3,3,31
41680,113,74,23,0,16,97
41681,249,165,65,2,17,232
41682,68,52,2,0,14,54
41683,47,32,6,1,8,39
41684,37,24,4,3,6,31
41685,11,5,4,0,2,9
41686,7,1,3,0,3,4
41687,127,57,48,1,21,106
41688,28,16,6,0,6,22
41689,32,21,9,0,2,30
41690,252,165,68,2,17,235
41691,3,0,3,0,0,3
41692,195,62,13,81,39,156
41693,76,23,37,2,14,62
41694,109,54,35,0,20,89
41695,109,54,32,5,18,91
41696,446,218,119,14,95,351
41697,7,2,3,1,1,6
41698,36,8,24,0,4,32
41699,24,14,5,2,3,21
41700,83,16,44,7,16,67
41701,111,104,0,7,0,111
41702,44,33,0,0,11,33
41703,178,89,49,4,36,142
41704,32,21,8,2,1,31
41705,10,2,6,0,2,8
41706,16,3,10,0,3,13
41707,20,11,4,1,4,16
41708,1,1,0,0,0,1
41709,12,4,6,0,2,10
41710,52,36,4,1,11,41
41711,75,18,42,0,15,60
41712,423,248,99,8,68,355
41713,502,243,104,56,99,403
41714,50,24,17,4,5,45
41715,78,9,43,8,18,60
41716,151,66,28,20,37,114
41717,166,128,2,2,34,132
41718,15,6,7,0,2,13
41719,32,30,0,0,2,30
41720,17,6,7,1,3,14
41721,32,21,9,0,2,30
41722,46,25,3,10,8,38
41723,202,68,13,82,39,163
41724,22,10,9,1,2,20
41725,588,331,114,13,130,458
41726,24,8,10,0,6,18
41727,63,29,21,0,13,50
41728,44,7,16,8,13,31
41729,40,30,1,2,7,33
41730,33,24,5,0,4,29
41731,44,9,23,5,7,37
41732,15,4,10,0,1,14
41733,45,23,11,0,11,34
41734,64,19,32,1,12,52
41735,43,10,27,1,5,38
41736,36,25,4,0,7,29
41737,107,22,49,12,24,83
41738,91,58,11,2,20,71
41739,129,56,47,5,21,108
41740,83,24,22,19,18,65
41741,110,50,25,17,18,92
41742,48,21,5,15,7,41
41743,92,39,9,25,19,73
41744,197,109,28,23,37,160
41745,23,3,5,7,8,15
41746,11,7,3,0,1,10
41747,10,3,4,0,3,7
41748,20,10,6,0,4,16
41749,69,10,44,0,15,54
41750,93,40,37,0,16,77
41751,72,34,17,2,19,53
41752,71,40,19,0,12,59
41753,30,10,11,0,9,21
41754,668,391,142,17,118,550
41755,469,174,154,43,98,371
41756,23,8,10,0,5,18
41757,116,64,41,0,11,105
41758,47,2,28,7,10,37
41759,63,38,14,0,11,52
41760,511,245,106,57,103,408
41761,153,101,29,0,23,130
41762,410,186,97,39,88,322
41763,129,76,12,21,20,109
41764,14,5,5,0,4,10
41765,585,428,38,1,118,467
41766,73,58,1,0,14,59
41767,149,55,36,25,33,116
41768,284,142,55,30,57,227
41769,171,113,27,1,30,141
41770,28,9,7,5,7,21
41771,46,18,20,0,8,38
41772,61,42,10,0,9,52
41773,213,86,36,41,50,163
41774,128,75,9,15,29,99
41775,351,140,117,23,71,280
41776,71,36,18,0,17,54
41777,54,5,34,1,14,40
41778,12,1,10,0,1,11
41779,12,0,10,0,2,10
41780,59,23,22,2,12,47
41781,223,122,52,0,49,174
41782,24,13,9,0,2,22
41783,19,2,12,0,5,14
41784,46,18,20,0,8,38
41785,12,9,2,0,1,11
41786,9,7,2,0,0,9
41787,70,43,13,3,11,59
41788,30,16,6,0,8,22
41789,65,7,47,0,11,54
41790,54,19,20,1,14,40
41791,49,32,8,1,8,41
41792,81,45,19,2,15,66
41793,76,42,18,0,16,60
41794,143,88,30,0,25,118
41795,34,14,11,0,9,25
41796,28,15,9,1,3,25
41797,144,85,21,2,36,108
41798,62,26,23,3,10,52
41799,86,57,19,1,9,77
41800,123,27,37,23,36,87
41801,147,69,43,11,24,123
41802,91,50,17,5,19,72
41803,61,17,32,3,9,52
41804,407,239,73,7,88,319
41805,123,47,4,51,21,102
41806,119,47,36,11,25,94
41807,339,157,97,14,71,268
41808,32,21,9,0,2,30
41809,184,105,22,23,34,150
41810,31,6,15,2,8,23
41811,28,10,15,0,3,25
41812,6,4,1,0,1,5
41813,83,44,10,9,20,63
41814,115,65,35,7,8,107
41815,24,12,8,2,2,22
41816,44,31,3,0,10,34
41817,348,178,98,5,67,281
41818,683,381,165,23,114,569
41819,36,16,8,0,12,24
41820,11,3,6,1,1,10
41821,68,46,12,10,0,68
41822,683,380,166,23,114,569
41823,27,8,14,0,5,22
41824,30,17,5,3,5,25
41825,102,67,1,12,22,80
41826,24,13,0,6,5,19
41827,155,110,21,0,24,131
41828,139,99,5,3,32,107
41829,132,66,35,6,25,107
41830,46,18,20,0,8,38
41831,194,76,34,34,50,144
41832,47,28,13,0,6,41
41833,90,45,33,2,10,80
41834,653,379,141,17,116,537
41835,86,68,4,1,13,73
41836,164,38,16,84,26,138
41837,13,7,3,0,3,10
41838,102,69,6,0,27,75
41839,298,162,89,0,47,251
41840,100,46,4,33,17,83
41841,65,45,8,0,12,53
41842,34,6,19,2,7,27
41843,458,229,123,12,94,364
41844,58,20,23,1,14,44
41845,200,102,49,0,49,151
41846,53,12,29,0,12,41
41847,105,71,11,2,21,84
41848,253,178,16,4,55,198
41849,34,9,18,0,7,27
41850,276,138,88,3,47,229
41851,260,83,124,12,41,219
41852,29,13,12,0,4,25
41853,54,30,7,7,10,44
41854,9,3,4,0,2,7
41855,46,18,24,0,4,42
41856,267,103,101,16,47,220
41857,30,19,3,0,8,22
41858,117,50,32,14,21,96
41859,49,33,5,2,9,40
41860,360,188,91,20,61,299
41861,97,47,30,5,15,82
41862,41,19,9,2,11,30
41863,142,35,76,1,30,112
41864,7,1,5,0,1,6
41865,111,55,36,0,20,91
41866,7,1,4,2,0,7
41867,33,13,17,0,3,30
41868,19,4,10,0,5,14
41869,17,4,8,1,4,13
41870,53,35,5,2,11,42
41871,19,11,3,0,5,14
41872,667,390,143,17,117,550
41873,63,35,8,9,11,52
41874,33,24,5,0,4,29
41875,3,2,0,0,1,2
41876,16,12,2,0,2,14
41877,15,1,13,0,1,14
41878,284,97,127,16,44,240
41879,10,4,3,0,3,7
41880,540,388,44,1,107,433
41881,32,21,9,0,2,30
41882,421,199,144,6,72,349
41883,435,321,20,0,94,341
41884,42,15,5,12,10,32
41885,90,30,36,6,18,72
41886,75,46,10,6,13,62
41887,129,43,46,8,32,97
41888,47,19,13,1,14,33
41889,54,30,11,2,11,43
41890,30,9,15,0,6,24
41891,241,100,14,83,44,197
41892,41,15,8,8,10,31
41893,117,70,24,0,23,94
41894,55,31,11,1,12,43
41895,196,94,62,0,40,156
41896,57,9,31,2,15,42
41897,337,140,122,6,69,268
41898,37,4,4,17,12,25
41899,108,56,23,7,22,86
41900,321,229,19,4,69,252
41901,63,33,17,1,12,51
41902,279,175,41,0,63,216
41903,81,42,9,19,11,70
41904,17,4,13,0,0,17
41905,246,168,57,3,18,228
41906,14,2,10,0,2,12
41907,15,1,12,0,2,13
41908,20,10,9,0,1,19
41909,20,7,9,1,3,17
41910,291,152,79,14,46,245
41911,41,4,16,11,10,31
41912,109,59,24,4,22,87
41913,334,154,112,2,66,268
41914,94,30,24,21,19,75
41915,152,62,35,20,35,117
41916,164,48,52,26,38,126
41917,18,8,9,0,1,17
41918,94,28,25,22,19,75
41919,484,247,88,45,104,380
41920,81,21,39,8,13,68
41921,104,21,51,14,18,86
41922,110,51,30,4,25,85
41923,78,53,10,0,15,63
41924,103,56,21,1,25,78
41925,101,23,55,2,21,80
41926,85,22,43,3,17,68
41927,39,18,15,0,6,33
41928,14,6,3,2,3,11
41929,59,36,3,10,10,49
41930,16,4,9,2,1,15
41931,46,18,20,0,8,38
41932,57,19,14,8,16,41
41933,58,19,29,3,7,51
41934,231,14,176,0,41,190
41935,67,44,11,1,11,56
41936,106,48,19,15,24,82
41937,68,24,22,9,13,55
41938,67,23,25,5,14,53
41939,104,45,40,2,17,87
41940,37,31,3,0,3,34
41941,44,6,20,12,6,38
41942,137,51,49,14,23,114
41943,59,32,17,0,10,49
41944,56,25,9,8,14,42
41945,64,48,12,0,4,60
41946,33,24,4,0,5,28
41947,89,39,24,3,23,66
41948,29,15,3,5,6,23
41949,68,44,11,2,11,57
41950,31,16,6,3,6,25
41951,21,9,6,2,4,17
41952,80,20,32,0,28,52
41953,60,45,3,3,9,51
41954,33,21,5,0,7,26
41955,24,9,11,0,4,20
41956,42,25,8,0,9,33
41957,32,27,0,1,4,28
41958,76,17,46,0,13,63
41959,31,21,0,0,10,21
41960,30,11,3,13,3,27
41961,114,47,27,15,25,89
41962,8,2,4,0,2,6
41963,62,31,13,2,16,46
41964,102,53,21,0,28,74
41965,19,3,13,0,3,16
41966,23,9,9,1,4,19
41967,4,2,2,0,0,4
41968,76,51,11,5,9,67
41969,7,1,6,0,0,7
41970,196,109,26,23,38,158
41971,73,20,22,13,18,55
41972,100,46,31,5,18,82
41973,9,6,2,0,1,8
41974,86,28,30,12,16,70
41975,185,86,33,22,44,141
41976,6,0,4,1,1,5
41977,162,81,48,1,32,130
41978,58,24,5,15,14,44
41979,161,124,9,1,27,134
41980,46,18,20,0,8,38
41981,41,14,22,0,5,36
41982,32,21,9,0,2,30
41983,94,54,16,3,21,73
41984,286,114,111,9,52,234
41985,9,2,5,0,2,7
41986,148,68,52,5,23,125
41987,34,8,16,0,10,24
41988,45,25,8,4,8,37
41989,414,305,20,0,89,325
41990,172,39,20,83,30,142
41991,196,127,25,7,37,159
41992,74,17,41,1,15,59
41993,33,15,8,0,10,23
41994,84,32,16,15,21,63
41995,6,0,6,0,0,6
41996,50,35,0,0,15,35
41997,158,45,12,71,30,128
41998,192,61,80,12,39,153
41999,363,163,104,23,73,290
42000,204,97,61,1,45,159
42001,232,53,33,106,40,192
42002,35,12,14,2,7,28
42003,43,15,15,4,9,34
42004,40,0,32,2,6,34
42005,101,37,37,5,22,79
42006,20,11,4,0,5,15
42007,170,123,21,0,26,144
42008,140,65,46,5,24,116
42009,69,58,0,1,10,59
42010,20,4,9,0,7,13
42011,202,96,60,1,45,157
42012,17,7,4,1,5,12
42013,25,3,12,2,8,17
42014,6,3,1,2,0,6
42015,40,30,1,0,9,31
42016,95,65,8,0,22,73
42017,226,159,25,3,39,187
42018,63,31,16,4,12,51
42019,65,37,14,0,14,51
42020,135,74,22,7,32,103
42021,32,21,9,0,2,30
42022,61,24,20,7,10,51
42023,65,21,27,3,14,51
42024,287,71,41,127,48,239
42025,24,9,5,1,9,15
42026,70,38,10,12,10,60
42027,255,51,155,2,47,208
42028,33,8,17,0,8,25
42029,41,3,30,2,6,35
42030,160,114,11,0,35,125
42031,191,49,20,92,30,161
42032,155,55,37,30,33,122
42033,52,23,18,0,11,41
42034,105,57,22,7,19,86
42035,39,18,13,0,8,31
42036,36,15,10,2,9,27
42037,50,29,13,0,8,42
42038,37,21,8,0,8,29
42039,116,49,40,2,25,91
42040,33,0,30,1,2,31
42041,61,43,3,0,15,46
42042,98,60,8,8,22,76
42043,47,22,13,3,9,38
42044,37,14,14,1,8,29
42045,83,51,17,0,15,68
42046,158,54,76,0,28,130
42047,370,214,80,17,59,311
42048,159,47,56,21,35,124
42049,165,98,37,1,29,136
42050,45,25,11,3,6,39
42051,5,1,3,0,1,4
42052,7,6,0,0,1,6
42053,228,173,16,2,37,191
42054,63,16,25,8,14,49
42055,434,206,141,12,75,359
42056,207,156,8,0,43,164
42057,21,0,15,0,6,15
42058,27,14,6,3,4,23
42059,96,51,18,5,22,74
42060,95,62,16,0,17,78
42061,134,57,29,22,26,108
42062,6,4,2,0,0,6
42063,199,70,58,28,43,156
42064,102,32,41,7,22,80
42065,17,4,6,0,7,10
42066,58,10,33,5,10,48
42067,69,8,54,0,7,62
42068,30,6,13,1,10,20
42069,299,215,16,4,64,235
42070,33,8,20,0,5,28
42071,141,64,43,7,27,114
42072,588,329,144,21,94,494
42073,31,14,8,0,9,22
42074,51,7,27,5,12,39
42075,46,17,19,0,10,36
42076,6,4,2,0,0,6
42077,221,150,30,0,41,180
42078,36,12,21,0,3,33
42079,57,28,17,3,9,48
42080,66,36,13,1,16,50
42081,19,12,3,0,4,15
42082,123,59,17,17,30,93
42083,434,133,192,12,97,337
42084,220,94,80,4,42,178
42085,427,219,102,13,93,334
42086,14,9,1,0,4,10
42087,6,1,2,0,3,3
42088,29,12,12,0,5,24
42089,61,46,3,2,10,51
42090,30,22,3,1,4,26
42091,22,9,9,0,4,18
42092,105,74,12,11,8,97
42093,15,2,9,0,4,11
42094,11,7,2,0,2,9
42095,125,54,44,1,26,99
42096,47,2,28,7,10,37
42097,1,1,0,0,0,1
42098,5,5,0,0,0,5
42099,32,21,9,0,2,30
42100,331,186,72,6,67,264
42101,36,3,24,0,9,27
42102,29,1,25,0,3,26
42103,35,14,14,0,7,28
42104,33,9,19,0,5,28
42105,20,14,5,1,0,20
42106,14,6,4,0,4,10
42107,43,29,1,2,11,32
42108,38,23,4,3,8,30
42109,53,17,28,1,7,46
42110,4,3,0,0,1,3
42111,313,142,101,12,58,255
42112,153,82,31,7,33,120
42113,90,32,40,8,10,80
42114,94,45,35,2,12,82
42115,31,14,9,0,8,23
42116,45,26,9,4,6,39
42117,128,38,54,8,28,100
42118,229,149,60,4,16,213
42119,64,22,4,29,9,55
42120,50,19,17,1,13,37
42121,30,14,13,2,1,29
42122,3,1,2,0,0,3
42123,61,43,3,0,15,46
42124,76,48,5,10,13,63
42125,4,1,2,1,0,4
42126,422,104,182,45,91,331
42127,73,33,30,0,10,63
42128,488,278,72,39,99,389
42129,160,71,52,5,32,128
42130,147,53,45,21,28,119
42131,120,31,53,7,29,91
42132,15,3,9,1,2,13
42133,116,58,20,16,22,94
42134,201,87,62,17,35,166
42135,155,68,32,24,31,124
42136,27,6,15,0,6,21
42137,31,15,7,0,9,22
42138,44,23,2,11,8,36
42139,19,4,8,1,6,13
42140,104,45,34,6,19,85
42141,19,8,8,1,2,17
42142,52,32,2,2,16,36
42143,115,64,21,3,27,88
42144,63,20,15,15,13,50
42145,16,8,0,5,3,13
42146,150,57,39,21,33,117
42147,22,8,8,1,5,17
42148,68,48,4,0,16,52
42149,79,36,5,16,22,57
42150,366,122,122,42,80,286
42151,62,26,13,8,15,47
42152,50,27,14,2,7,43
42153,76,34,26,0,16,60
42154,111,58,16,15,22,89
42155,34,4,26,0,4,30
42156,667,391,142,17,117,550
42157,24,12,8,1,3,21
42158,94,24,54,1,15,79
42159,372,218,76,0,78,294
42160,52,25,18,0,9,43
42161,99,53,19,3,24,75
42162,43,17,15,0,11,32
42163,144,42,62,3,37,107
42164,212,93,53,23,43,169
42165,136,87,23,0,26,110
42166,0,0,0,0,0,0
42167,126,96,4,2,24,102
42168,33,1,25,1,6,27
42169,157,75,48,1,33,124
42170,33,17,6,1,9,24
42171,40,1,23,12,4,36
42172,68,35,3,17,13,55
42173,507,246,117,34,110,397
42174,35,7,20,0,8,27
42175,42,18,14,2,8,34
42176,22,5,15,0,2,20
42177,37,5,24,0,8,29
42178,40,13,14,3,10,30
42179,49,24,11,3,11,38
42180,432,207,141,6,78,354
42181,9,4,2,0,3,6
42182,146,80,28,1,37,109
42183,32,21,9,0,2,30
42184,346,148,121,6,71,275
42185,35,9,18,0,8,27
42186,18,0,14,0,4,14
42187,56,23,19,1,13,43
42188,655,384,131,21,119,536
42189,14,6,3,1,4,10
42190,46,18,20,0,8,38
42191,4,1,3,0,0,4
42192,86,42,24,1,19,67
42193,140,66,43,11,20,120
42194,320,139,107,6,68,252
42195,15,3,4,4,4,11
42196,302,223,19,2,58,244
42197,23,13,4,0,6,17
42198,28,13,8,0,7,21
42199,40,6,5,19,10,30
42200,218,105,70,2,41,177
42201,46,18,20,0,8,38
42202,175,111,12,13,39,136
42203,32,21,9,0,2,30
42204,7,1,5,0,1,6
42205,46,18,20,0,8,38
42206,88,39,31,5,13,75
42207,170,112,27,1,30,140
42208,193,88,47,20,38,155
42209,570,326,118,16,110,460
42210,92,30,20,23,19,73
42211,118,70,26,0,22,96
42212,588,339,120,19,110,478
42213,23,9,7,2,5,18
42214,33,2,22,0,9,24
42215,133,41,35,22,35,98
42216,43,30,3,0,10,33
42217,32,19,5,1,7,25
42218,155,68,35,15,37,118
42219,527,361,49,1,116,411
42220,37,17,9,2,9,28
42221,79,49,14,8,8,71
42222,140,56,46,14,24,116
42223,254,191,11,1,51,203
42224,67,19,32,1,15,52
42225,15,11,4,0,0,15
42226,351,192,88,15,56,295
42227,74,28,28,1,17,57
42228,26,2,20,0,4,22
42229,37,20,10,0,7,30
42230,139,75,33,0,31,108
42231,35,20,7,0,8,27
42232,101,42,19,14,26,75
42233,87,47,12,14,14,73
42234,22,19,0,0,3,19
42235,108,65,10,9,24,84
42236,258,52,155,4,47,211
42237,13,0,11,0,2,11
42238,2,1,0,0,1,1
42239,16,4,9,2,1,15
42240,71,31,23,2,15,56
42241,101,59,27,1,14,87
42242,200,73,54,28,45,155
42243,332,141,116,6,69,263
42244,196,56,100,4,36,160
42245,18,14,1,0,3,15
42246,69,25,26,4,14,55
42247,29,10,10,2,7,22
42248,72,54,6,0,12,60
42249,16,5,9,0,2,14
42250,38,19,8,1,10,28
42251,46,18,20,0,8,38
42252,50,33,10,1,6,44
42253,14,7,6,0,1,13
42254,139,40,54,18,27,112
42255,39,13,19,0,7,32
42256,100,35,26,20,19,81
42257,91,56,16,3,16,75
42258,197,126,32,3,36,161
42259,28,19,2,4,3,25
42260,74,18,33,2,21,53
42261,198,106,34,21,37,161
42262,104,43,21,17,23,81
42263,38,5,25,0,8,30
42264,297,145,80,12,60,237
42265,74,30,28,0,16,58
42266,232,79,90,14,49,183
42267,665,389,142,17,117,548
42268,108,67,20,2,19,89
42269,109,54,35,0,20,89
42270,41,10,15,9,7,34
42271,61,18,25,3,15,46
42272,68,47,6,2,13,55
42273,65,31,17,2,15,50
42274,165,52,87,4,22,143
42275,101,48,23,4,26,75
42276,42,18,13,4,7,35
42277,44,35,2,0,7,37
42278,64,15,34,0,15,49
42279,37,12,13,1,11,26
42280,65,41,8,1,15,50
42281,182,119,12,11,40,142
42282,188,126,44,2,16,172
42283,48,19,23,0,6,42
42284,50,29,13,0,8,42
42285,35,22,8,1,4,31
42286,59,19,15,13,12,47
42287,94,25,54,2,13,81
42288,109,59,24,4,22,87
42289,36,3,24,0,9,27
42290,6,4,1,0,1,5
42291,10,2,6,0,2,8
42292,38,23,5,1,9,29
42293,224,127,44,14,39,185
42294,29,19,5,0,5,24
42295,178,88,68,3,19,159
42296,47,18,17,0,12,35
42297,128,59,45,3,21,107
42298,146,48,42,24,32,114
42299,185,131,40,2,12,173
42300,55,17,25,0,13,42
42301,56,40,4,0,12,44
42302,44,7,20,9,8,36
42303,38,4,30,0,4,34
42304,231,148,65,2,16,215
42305,111,104,0,7,0,111
42306,31,12,12,0,7,24
42307,18,6,7,0,5,13
42308,14,3,8,0,3,11
42309,45,7,17,11,10,35
42310,53,34,11,8,0,53
42311,89,48,28,7,6,83
42312,60,45,2,0,13,47
42313,31,15,8,3,5,26
42314,63,16,40,0,7,56
42315,70,43,13,0,14,56
42316,261,16,195,1,49,212
42317,14,7,5,0,2,12
42318,13,2,8,0,3,10
42319,14,8,0,2,4,10
42320,40,6,28,1,5,35
42321,32,21,9,0,2,30
42322,56,3,41,0,12,44
42323,73,56,0,0,17,56
42324,33,25,4,0,4,29
42325,31,20,5,0,6,25
42326,160,84,44,2,30,130
42327,155,66,55,8,26,129
42328,136,36,44,21,35,101
42329,9,5,2,0,2,7
42330,25,9,8,1,7,18
42331,82,18,8,36,20,62
42332,46,18,20,0,8,38
42333,79,21,32,6,20,59
42334,192,70,78,4,40,152
42335,87,38,26,5,18,69
42336,218,80,61,30,47,171
42337,171,39,20,82,30,141
42338,59,30,8,9,12,47
42339,128,36,56,8,28,100
42340,158,102,3,16,37,121
42341,71,6,46,1,18,53
42342,445,202,149,11,83,362
42343,41,5,26,0,10,31
42344,73,44,15,0,14,59
42345,97,30,40,10,17,80
42346,69,36,18,0,15,54
42347,22,13,4,0,5,17
42348,222,119,34,25,44,178
42349,71,32,15,14,10,61
42350,102,32,22,13,35,67
42351,120,37,53,7,23,97
42352,103,25,55,3,20,83
42353,89,54,19,4,12,77
42354,39,11,15,3,10,29
42355,59,38,11,0,10,49
42356,359,160,124,6,69,290
42357,128,61,39,3,25,103
42358,182,118,28,5,31,151
42359,137,53,39,13,32,105
42360,88,27,40,2,19,69
42361,19,5,11,0,3,16
42362,8,6,0,0,2,6
42363,401,201,100,12,88,313
42364,34,4,22,4,4,30
42365,73,34,16,7,16,57
42366,41,12,16,7,6,35
42367,28,7,15,0,6,22
42368,162,10,88,30,34,128
42369,34,4,19,3,8,26
42370,150,99,10,8,33,117
42371,148,96,30,0,22,126
42372,93,45,24,5,19,74
42373,40,20,13,2,5,35
42374,53,36,4,1,12,41
42375,28,23,0,0,5,23
42376,101,36,43,4,18,83
42377,103,58,8,18,19,84
42378,33,12,15,0,6,27
42379,82,9,45,10,18,64
42380,100,57,19,7,17,83
42381,77,35,5,15,22,55
42382,64,41,5,0,18,46
42383,52,8,27,5,12,40
42384,63,43,8,2,10,53
42385,8,1,5,0,2,6
42386,37,19,9,0,9,28
42387,113,66,26,3,18,95
42388,104,47,27,12,18,86
42389,70,43,15,0,12,58
42390,94,54,24,1,15,79
42391,67,26,32,0,9,58
42392,132,99,4,2,27,105
42393,27,14,2,4,7,20
42394,56,42,1,0,13,43
42395,128,69,34,13,12,116
42396,21,7,10,0,4,17
42397,80,24,32,6,18,62
42398,347,188,89,15,55,292
42399,90,27,46,3,14,76
42400,46,18,20,0,8,38
42401,42,6,26,3,7,35
42402,113,41,34,8,30,83
42403,90,60,7,4,19,71
42404,50,28,14,1,7,43
42405,37,13,14,3,7,30
42406,7,3,3,0,1,6
42407,14,4,7,0,3,11
42408,144,93,29,0,22,122
42409,102,27,55,0,20,82
42410,22,9,2,7,4,18
42411,7,4,2,0,1,6
42412,2,0,1,1,0,2
42413,444,254,85,12,93,351
42414,39,27,5,2,5,34
42415,151,26,63,21,41,110
42416,34,13,11,3,7,27
42417,7,0,4,0,3,4
42418,99,29,40,3,27,72
42419,46,18,20,0,8,38
42420,288,150,70,16,52,236
42421,12,5,4,0,3,9
42422,75,28,24,6,17,58
42423,268,200,15,0,53,215
42424,27,10,11,0,6,21
42425,10,8,0,0,2,8
42426,106,56,28,5,17,89
42427,76,39,16,2,19,57
42428,47,10,5,23,9,38
42429,31,17,10,2,2,29
42430,85,49,13,0,23,62
42431,102,46,14,21,21,81
42432,265,145,75,0,45,220
42433,84,36,15,14,19,65
42434,345,186,89,15,55,290
42435,17,9,0,3,5,12
42436,156,79,45,1,31,125
42437,62,44,7,4,7,55
42438,104,66,21,4,13,91
42439,372,157,108,31,76,296
42440,103,35,51,0,17,86
42441,38,8,19,4,7,31
42442,136,54,52,3,27,109
42443,87,20,36,12,19,68
42444,69,46,8,0,15,54
42445,83,46,21,4,12,71
42446,15,9,3,1,2,13
42447,58,47,0,1,10,48
42448,334,163,110,2,59,275
42449,22,11,4,0,7,15
42450,66,27,19,3,17,49
42451,127,53,31,19,24,103
42452,24,23,0,0,1,23
42453,201,134,22,0,45,156
42454,25,14,6,0,5,20
42455,47,29,5,0,13,34
42456,29,14,4,5,6,23
42457,140,43,72,3,22,118
42458,24,10,7,2,5,19
42459,280,190,67,3,20,260
42460,11,5,0,3,3,8
42461,46,18,20,0,8,38
42462,288,126,106,2,54,234
42463,86,69,2,0,15,71
42464,63,38,7,1,17,46
42465,35,2,24,0,9,26
42466,107,59,23,0,25,82
42467,53,20,20,5,8,45
42468,51,21,17,1,12,39
42469,116,32,33,27,24,92
42470,31,11,16,0,4,27
42471,16,2,11,0,3,13
42472,348,190,88,15,55,293
42473,133,101,1,1,30,103
42474,7,2,5,0,0,7
42475,21,8,7,2,4,17
42476,353,184,105,5,59,294
42477,48,14,18,4,12,36
42478,122,57,37,3,25,97
42479,4,0,4,0,0,4
42480,29,9,14,0,6,23
42481,584,340,119,18,107,477
42482,31,1,22,2,6,25
42483,77,75,0,2,0,77
42484,308,85,152,5,66,242
42485,27,11,8,0,8,19
42486,192,111,60,4,17,175
42487,81,52,11,0,18,63
42488,566,405,44,1,116,450
42489,46,18,20,0,8,38
42490,68,42,12,0,14,54
42491,32,21,9,0,2,30
42492,6,3,2,0,1,5
42493,73,24,34,5,10,63
42494,79,23,41,2,13,66
42495,317,158,91,5,63,254
42496,61,20,29,2,10,51
42497,200,91,55,12,42,158
42498,173,83,51,0,39,134
42499,31,4,21,0,6,25
42500,83,37,25,3,18,65
42501,49,35,3,4,7,42
42502,330,86,162,5,77,253
42503,25,23,0,0,2,23
42504,73,41,10,9,13,60
42505,183,146,9,0,28,155
42506,22,15,3,1,3,19
42507,56,24,19,1,12,44
42508,82,40,31,2,9,73
42509,102,65,26,0,11,91
42510,50,30,7,2,11,39
42511,187,102,55,0,30,157
42512,61,18,22,7,14,47
42513,32,21,9,0,2,30
42514,639,371,139,17,112,527
42515,63,43,1,4,15,48
42516,221,151,29,0,41,180
42517,65,41,6,2,16,49
42518,283,205,13,2,63,220
42519,47,17,23,0,7,40
42520,142,68,27,23,24,118
42521,87,24,45,7,11,76
42522,85,46,23,0,16,69
42523,553,303,119,13,118,435
42524,179,127,14,1,37,142
42525,165,107,23,5,30,135
42526,32,21,9,0,2,30
42527,438,137,191,11,99,339
42528,131,56,46,3,26,105
42529,11,1,6,0,4,7
42530,60,38,5,4,13,47
42531,33,16,7,3,7,26
42532,59,28,18,0,13,46
42533,85,18,43,3,21,64
42534,79,31,32,1,15,64
42535,204,88,58,20,38,166
42536,671,397,131,23,120,551
42537,31,13,11,1,6,25
42538,39,15,13,0,11,28
42539,13,6,3,1,3,10
42540,66,34,15,4,13,53
42541,76,46,14,8,8,68
42542,29,13,13,0,3,26
42543,346,186,89,15,56,290
42544,25,21,1,3,0,25
42545,53,29,12,0,12,41
42546,3,2,1,0,0,3
42547,40,27,3,3,7,33
42548,59,33,17,0,9,50
42549,148,58,63,3,24,124
42550,178,100,33,0,45,133
42551,67,42,8,2,15,52
42552,89,33,35,1,20,69
42553,179,114,24,9,32,147
42554,19,7,4,2,6,13
42555,71,44,13,0,14,57
42556,100,56,29,1,14,86
42557,71,27,6,22,16,55
42558,217,86,25,67,39,178
42559,61,21,28,2,10,51
42560,33,15,7,0,11,22
42561,24,15,6,1,2,22
42562,32,21,9,0,2,30
42563,68,37,15,0,16,52
42564,17,5,7,1,4,13
42565,8,1,3,2,2,6
42566,13,4,3,0,6,7
42567,148,50,39,32,27,121
42568,12,6,2,2,2,10
42569,23,12,7,0,4,19
42570,41,17,16,0,8,33
42571,236,156,34,0,46,190
42572,77,42,19,0,16,61
42573,82,28,38,3,13,69
42574,54,36,10,0,8,46
42575,376,161,133,11,71,305
42576,4,2,2,0,0,4
42577,92,43,33,3,13,79
42578,30,14,8,2,6,24
42579,10,7,1,0,2,8
42580,72,25,20,17,10,62
42581,36,2,29,0,5,31
42582,72,32,24,0,16,56
42583,55,33,10,0,12,43
42584,64,31,19,0,14,50
42585,24,9,8,2,5,19
42586,192,89,53,11,39,153
42587,9,6,0,1,2,7
42588,84,30,32,4,18,66
42589,10,3,5,0,2,8
42590,145,36,77,1,31,114
42591,60,21,24,8,7,53
42592,55,1,20,26,8,47
42593,90,56,19,0,15,75
42594,35,8,15,1,11,24
42595,167,55,82,0,30,137
42596,82,42,25,3,12,70
42597,238,163,30,3,42,196
42598,49,23,12,2,12,37
42599,49,25,12,0,12,37
42600,21,8,7,0,6,15
42601,79,40,14,5,20,59
42602,63,17,21,11,14,49
42603,90,34,35,8,13,77
42604,73,30,20,1,22,51
42605,86,55,16,0,15,71
42606,45,38,2,0,5,40
42607,21,14,2,0,5,16
42608,140,72,40,0,28,112
42609,119,63,23,7,26,93
42610,30,10,16,0,4,26
42611,3,0,2,0,1,2
42612,5,0,4,1,0,5
42613,214,153,16,4,41,173
42614,59,37,7,0,15,44
42615,9,2,6,0,1,8
42616,40,21,10,1,8,32
42617,59,31,20,0,8,51
42618,28,10,10,0,8,20
42619,64,13,39,1,11,53
42620,1,1,0,0,0,1
42621,75,50,8,0,17,58
42622,74,23,24,10,17,57
42623,97,53,25,4,15,82
42624,26,6,9,7,4,22
42625,119,57,37,4,21,98
42626,42,11,20,0,11,31
42627,99,31,40,11,17,82
42628,1027,387,402,46,192,835
42629,96,60,17,0,19,77
42630,103,67,1,13,22,81
42631,39,23,9,4,3,36
42632,229,79,85,15,50,179
42633,62,38,8,3,13,49
42634,68,26,23,1,18,50
42635,373,209,85,0,79,294
42636,430,211,104,29,86,344
42637,65,44,5,0,16,49
42638,2,0,2,0,0,2
42639,89,55,13,4,17,72
42640,84,40,27,0,17,67
42641,17,11,1,0,5,12
42642,53,22,6,14,11,42
42643,75,42,10,10,13,62
42644,29,2,21,1,5,24
42645,57,43,6,0,8,49
42646,51,15,23,3,10,41
42647,107,50,37,0,20,87
42648,31,5,19,0,7,24
42649,61,9,34,2,16,45
42650,46,18,20,0,8,38
42651,234,68,113,15,38,196
42652,11,4,4,0,3,8
42653,44,29,6,3,6,38
42654,71,59,2,0,10,61
42655,200,133,20,0,47,153
42656,51,38,5,3,5,46
42657,140,28,88,0,24,116
42658,54,8,26,5,15,39
42659,102,37,25,21,19,83
42660,165,97,38,1,29,136
42661,70,35,23,1,11,59
42662,42,19,19,1,3,39
42663,545,309,125,21,90,455
42664,111,2,90,0,19,92
42665,124,33,56,5,30,94
42666,100,49,14,10,27,73
42667,58,32,16,0,10,48
42668,49,22,10,3,14,35
42669,41,6,6,19,10,31
42670,18,6,8,1,3,15
42671,81,54,13,0,14,67
42672,98,64,11,12,11,87
42673,18,8,5,5,0,18
42674,122,24,43,21,34,88
42675,173,71,55,5,42,131
42676,171,113,27,1,30,141
42677,60,44,1,0,15,45
42678,31,8,18,0,5,26
42679,14,2,3,1,8,6
42680,64,24,29,1,10,54
42681,66,32,19,3,12,54
42682,286,149,95,0,42,244
42683,29,10,10,0,9,20
42684,602,351,111,12,128,474
42685,18,4,11,0,3,15
42686,36,9,17,3,7,29
42687,8,1,4,0,3,5
42688,77,39,26,4,8,69
42689,107,45,31,8,23,84
42690,36,7,21,0,8,28
42691,32,21,9,0,2,30
42692,80,18,41,2,19,61
42693,47,20,19,0,8,39
42694,53,33,10,0,10,43
42695,0,0,0,0,0,0
42696,70,17,28,11,14,56
42697,32,14,7,6,5,27
42698,349,183,93,14,59,290
42699,65,44,7,0,14,51
42700,32,21,9,0,2,30
42701,70,36,23,3,8,62
42702,375,220,77,9,69,306
42703,90,29,32,11,18,72
42704,432,209,106,31,86,346
42705,192,135,38,2,17,175
42706,36,18,9,1,8,28
42707,26,22,2,0,2,24
42708,118,80,11,3,24,94
42709,134,38,70,0,26,108
42710,145,69,33,16,27,118
42711,221,91,41,37,52,169
42712,419,220,107,20,72,347
42713,32,21,9,0,2,30
42714,115,65,20,5,25,90
42715,160,79,29,20,32,128
42716,657,383,143,17,114,543
42717,5,1,2,1,1,4
42718,208,110,48,0,50,158
42719,54,28,12,3,11,43
42720,32,21,9,0,2,30
42721,43,20,17,1,5,38
42722,55,15,25,1,14,41
42723,68,32,26,0,10,58
42724,43,10,23,0,10,33
42725,32,13,11,2,6,26
42726,174,90,47,0,37,137
42727,36,19,12,0,5,31
42728,16,12,1,0,3,13
42729,67,53,0,2,12,55
42730,387,223,85,0,79,308
42731,101,66,8,2,25,76
42732,32,21,9,0,2,30
42733,27,20,4,0,3,24
42734,15,6,3,4,2,13
42735,87,41,19,7,20,67
42736,0,0,0,0,0,0
42737,64,10,43,1,10,54
42738,32,21,9,0,2,30
42739,53,22,20,1,10,43
42740,53,32,5,0,16,37
42741,45,24,11,0,10,35
42742,25,4,15,0,6,19
42743,109,33,39,13,24,85
42744,47,10,29,0,8,39
42745,26,5,15,0,6,20
42746,106,60,19,1,26,80
42747,44,18,20,0,6,38
42748,75,9,42,5,19,56
42749,46,18,20,0,8,38
42750,176,138,11,1,26,150
42751,25,5,1,15,4,21
42752,8,3,3,2,0,8
42753,53,32,5,0,16,37
42754,103,22,48,12,21,82
42755,53,10,34,0,9,44
42756,58,16,32,1,9,49
42757,16,11,2,0,3,13
42758,6,1,3,0,2,4
42759,219,148,30,0,41,178
42760,99,32,39,10,18,81
42761,416,217,107,20,72,344
42762,10,4,5,0,1,9
42763,69,62,1,6,0,69
42764,60,29,13,2,16,44
42765,64,32,17,0,15,49
42766,54,35,8,0,11,43
42767,13,0,11,1,1,12
42768,476,221,156,11,88,388
42769,90,21,55,2,12,78
42770,205,155,9,1,40,165
42771,7,1,4,0,2,5
42772,223,167,9,0,47,176
42773,90,25,43,9,13,77
42774,177,100,32,0,45,132
42775,10,3,5,0,2,8
42776,138,10,78,19,31,107
42777,100,19,50,12,19,81
42778,55,25,19,1,10,45
42779,61,35,7,6,13,48
42780,100,35,26,20,19,81
42781,173,80,49,8,36,137
42782,421,216,72,41,92,329
42783,28,4,15,2,7,21
42784,219,131,62,7,19,200
42785,10,2,5,0,3,7
42786,3,0,3,0,0,3
42787,125,31,68,0,26,99
42788,65,31,18,2,14,51
42789,101,33,35,5,28,73
42790,58,19,24,1,14,44
42791,47,30,9,2,6,41
42792,35,19,7,1,8,27
42793,83,38,32,1,12,71
42794,1,1,0,0,0,1
42795,498,233,128,34,103,395
42796,63,38,14,1,10,53
42797,18,10,4,0,4,14
42798,39,13,19,0,7,32
42799,39,23,8,0,8,31
42800,101,36,38,5,22,79
42801,46,18,20,0,8,38
42802,98,66,11,0,21,77
42803,56,28,13,5,10,46
42804,28,7,15,2,4,24
42805,82,55,7,1,19,63
42806,134,97,6,0,31,103
42807,15,9,1,4,1,14
42808,83,30,36,0,17,66
42809,44,22,14,0,8,36
42810,41,12,20,1,8,33
42811,69,11,39,4,15,54
42812,87,21,44,7,15,72
42813,49,27,15,0,7,42
42814,81,43,29,2,7,74
42815,79,47,20,2,10,69
42816,25,13,9,0,3,22
42817,20,7,7,1,5,15
42818,109,90,3,3,13,96
42819,30,10,6,10,4,26
42820,70,15,43,0,12,58
42821,49,29,12,0,8,41
42822,40,21,5,7,7,33
42823,56,34,8,1,13,43
42824,33,12,12,2,7,26
42825,13,6,1,0,6,7
42826,52,32,5,0,15,37
42827,10,3,2,0,5,5
42828,15,2,2,9,2,13
42829,46,18,20,0,8,38
42830,61,40,5,0,16,45
42831,24,11,9,0,4,20
42832,207,50,40,80,37,170
42833,146,62,32,17,35,111
42834,81,55,11,0,15,66
42835,14,6,1,2,5,9
42836,141,27,49,24,41,100
42837,40,28,4,2,6,34
42838,37,5,24,0,8,29
42839,365,197,92,15,61,304
42840,71,27,17,6,21,50
42841,39,5,27,1,6,33
42842,49,32,6,2,9,40
42843,158,90,20,20,28,130
42844,249,187,13,0,49,200
42845,27,19,1,2,5,22
42846,339,189,65,15,70,269
42847,161,54,8,70,29,132
42848,28,18,6,4,0,28
42849,95,55,24,0,16,79
42850,20,5,8,2,5,15
42851,170,9,129,0,32,138
42852,22,11,2,2,7,15
42853,50,31,9,2,8,42
42854,255,166,70,2,17,238
42855,2,1,0,0,1,1
42856,19,5,9,0,5,14
42857,23,11,10,0,2,21
42858,348,237,36,1,74,274
42859,65,28,16,5,16,49
42860,28,14,4,5,5,23
42861,561,408,39,1,113,448
42862,49,30,7,0,12,37
42863,56,21,24,1,10,46
42864,71,7,46,5,13,58
42865,138,39,67,1,31,107
42866,84,26,37,5,16,68
42867,193,129,20,0,44,149
42868,90,28,19,23,20,70
42869,439,320,27,0,92,347
42870,37,18,9,1,9,28
42871,80,33,22,11,14,66
42872,25,16,6,0,3,22
42873,110,51,28,7,24,86
42874,11,8,0,0,3,8
42875,396,230,81,18,67,329
42876,140,47,62,6,25,115
42877,26,13,8,0,5,21
42878,547,390,43,1,113,434
42879,11,3,6,1,1,10
42880,87,21,36,11,19,68
42881,92,36,23,14,19,73
42882,117,41,38,9,29,88
42883,27,4,21,0,2,25
42884,42,17,20,0,5,37
42885,30,11,14,0,5,25
42886,696,406,144,21,125,571
42887,61,26,21,4,10,51
42888,32,21,9,0,2,30
42889,46,18,20,0,8,38
42890,307,230,18,1,58,249
42891,38,11,16,0,11,27
42892,39,6,24,0,9,30
42893,22,9,6,4,3,19
42894,36,19,13,0,4,32
42895,32,21,9,0,2,30
42896,90,37,27,15,11,79
42897,165,99,36,1,29,136
42898,50,28,14,0,8,42
42899,540,320,118,14,88,452
42900,240,102,79,16,43,197
42901,207,85,62,20,40,167
42902,84,55,8,0,21,63
42903,36,13,16,0,7,29
42904,405,225,110,0,70,335
42905,78,31,23,12,12,66
42906,7,3,2,0,2,5
42907,111,84,7,13,7,104
42908,344,187,87,15,55,289
42909,25,9,4,8,4,21
42910,38,9,18,4,7,31
42911,15,4,9,0,2,13
42912,375,177,84,36,78,297
42913,100,92,0,8,0,100
42914,192,140,11,2,39,153
42915,112,43,39,7,23,89
42916,8,1,6,0,1,7
42917,55,39,7,3,6,49
42918,45,28,8,0,9,36
42919,88,45,24,2,17,71
42920,245,102,15,82,46,199
42921,33,13,16,0,4,29
42922,220,105,79,3,33,187
42923,66,44,7,1,14,52
42924,87,49,19,0,19,68
42925,702,400,161,23,118,584
42926,39,23,9,4,3,36
42927,43,11,17,2,13,30
42928,41,13,18,4,6,35
42929,25,16,3,1,5,20
42930,107,84,3,0,20,87
42931,79,38,29,1,11,68
42932,47,15,21,1,10,37
42933,88,54,19,0,15,73
42934,61,22,31,0,8,53
42935,304,231,17,0,56,248
42936,44,26,7,0,11,33
42937,38,13,19,1,5,33
42938,118,66,21,7,24,94
42939,127,28,44,30,25,102
42940,54,17,23,2,12,42
42941,29,10,13,0,6,23
42942,86,22,40,16,8,78
42943,183,86,73,4,20,163
42944,74,32,24,3,15,59
42945,32,21,9,0,2,30
42946,21,8,4,5,4,17
42947,33,19,6,1,7,26
42948,32,9,18,0,5,27
42949,96,38,8,25,25,71
42950,56,24,19,0,13,43
42951,12,4,6,0,2,10
42952,17,12,2,0,3,14
42953,47,34,4,3,6,41
42954,5,2,2,0,1,4
42955,55,25,13,5,12,43
42956,159,82,37,0,40,119
42957,37,14,15,0,8,29
42958,11,1,5,1,4,7
42959,135,51,45,14,25,110
42960,126,87,16,0,23,103
42961,23,11,5,0,7,16
42962,151,38,77,1,35,116
42963,90,73,3,2,12,78
42964,60,20,30,3,7,53
42965,67,30,23,0,14,53
42966,11,6,3,0,2,9
42967,151,47,57,19,28,123
42968,116,66,30,9,11,105
42969,60,41,5,1,13,47
42970,191,105,36,14,36,155
42971,144,63,30,19,32,112
42972,70,33,12,8,17,53
42973,37,1,28,0,8,29
42974,24,4,10,1,9,15
42975,50,31,1,6,12,38
42976,107,49,34,5,19,88
42977,5,1,1,0,3,2
42978,94,54,17,6,17,77
42979,155,25,100,1,29,126
42980,160,11,94,22,33,127
42981,33,6,20,0,7,26
42982,65,41,15,0,9,56
42983,429,226,109,20,74,355
42984,28,12,8,4,4,24
42985,111,87,3,0,21,90
42986,376,195,100,18,63,313
42987,12,7,4,0,1,11
42988,86,55,17,0,14,72
42989,85,26,24,16,19,66
42990,21,12,5,1,3,18
42991,73,33,23,0,17,56
42992,53,29,16,0,8,45
42993,645,376,141,16,112,533
42994,48,30,12,0,6,42
42995,77,28,24,9,16,61
42996,93,54,24,1,14,79
42997,61,31,14,4,12,49
42998,16,11,2,0,3,13
42999,253,190,15,0,48,205
43000,465,136,196,33,100,365
43001,448,232,113,12,91,357
43002,21,14,3,0,4,17
43003,90,56,12,2,20,70
43004,56,19,20,4,13,43
43005,75,9,42,5,19,56
43006,38,29,6,3,0,38
43007,82,37,23,3,19,63
43008,3,2,1,0,0,3
43009,175,82,54,4,35,140
43010,26,11,8,1,6,20
43011,62,16,8,25,13,49
43012,72,41,16,3,12,60
43013,46,18,20,0,8,38
43014,77,55,7,3,12,65
43015,50,36,3,3,8,42
43016,64,48,2,0,14,50
43017,39,9,13,11,6,33
43018,142,90,14,10,28,114
43019,62,14,42,0,6,56
43020,90,65,6,0,19,71
43021,110,56,30,4,20,90
43022,20,2,10,0,8,12
43023,35,17,10,0,8,27
43024,76,25,30,8,13,63
43025,32,4,12,5,11,21
43026,110,71,21,0,18,92
43027,205,53,45,65,42,163
43028,220,149,30,0,41,179
43029,140,103,5,2,30,110
43030,15,4,7,2,2,13
43031,271,81,130,17,43,228
43032,18,7,8,0,3,15
43033,2,0,2,0,0,2
43034,14,2,10,0,2,12
43035,43,16,17,2,8,35
43036,284,136,93,4,51,233
43037,178,144,11,0,23,155
43038,109,54,25,7,23,86
43039,42,17,15,0,10,32
43040,30,12,14,0,4,26
43041,100,39,45,2,14,86
43042,76,50,9,0,17,59
43043,46,18,20,0,8,38
43044,11,0,7,0,4,7
43045,86,32,34,1,19,67
43046,124,32,66,0,26,98
43047,21,9,6,1,5,16
43048,103,46,37,1,19,84
43049,152,63,32,23,34,118
43050,38,15,5,8,10,28
43051,105,28,50,4,23,82
43052,591,431,40,1,119,472
43053,27,8,14,0,5,22
43054,34,12,16,1,5,29
43055,73,33,24,2,14,59
43056,20,7,7,0,6,14
43057,136,40,66,1,29,107
43058,81,38,23,1,19,62
43059,178,109,37,19,13,165
43060,223,154,25,6,38,185
43061,30,2,23,0,5,25
43062,294,150,83,12,49,245
43063,148,52,34,30,32,116
43064,45,24,13,1,7,38
43065,92,27,25,21,19,73
43066,38,6,24,0,8,30
43067,55,14,27,0,14,41
43068,54,31,7,0,16,38
43069,132,102,8,2,20,112
43070,68,31,28,0,9,59
43071,77,26,30,2,19,58
43072,40,15,20,0,5,35
43073,69,17,35,4,13,56
43074,84,47,16,1,20,64
43075,51,23,19,0,9,42
43076,108,42,29,14,23,85
43077,311,137,102,6,66,245
43078,46,28,12,0,6,40
43079,338,200,66,0,72,266
43080,132,102,10,0,20,112
43081,33,16,10,1,6,27
43082,54,31,12,2,9,45
43083,86,35,25,0,26,60
43084,65,45,9,1,10,55
43085,38,19,14,0,5,33
43086,208,160,9,0,39,169
43087,22,2,17,0,3,19
43088,172,119,10,10,33,139
43089,79,21,37,6,15,64
43090,44,15,18,1,10,34
43091,45,27,8,2,8,37
43092,35,19,14,0,2,33
43093,38,12,21,1,4,34
43094,19,4,10,0,5,14
43095,32,21,9,0,2,30
43096,21,5,10,1,5,16
43097,98,28,42,6,22,76
43098,480,227,153,11,89,391
43099,73,45,12,2,14,59
43100,53,34,8,0,11,42
43101,105,56,21,6,22,83
43102,78,48,13,1,16,62
43103,144,88,30,3,23,121
43104,198,96,58,1,43,155
43105,22,8,13,0,1,21
43106,41,20,6,0,15,26
43107,215,89,14,75,37,178
43108,67,5,45,4,13,54
43109,101,36,41,9,15,86
43110,116,46,42,3,25,91
43111,95,42,25,12,16,79
43112,32,21,9,0,2,30
43113,115,77,18,10,10,105
43114,26,6,11,4,5,21
43115,2,1,0,0,1,1
43116,108,87,3,0,18,90
43117,40,9,21,3,7,33
43118,61,49,2,0,10,51
43119,15,0,11,0,4,11
43120,119,54,38,4,23,96
43121,176,86,50,4,36,140
43122,34,13,15,1,5,29
43123,39,14,20,0,5,34
43124,11,6,1,1,3,8
43125,19,3,10,0,6,13
43126,16,7,3,1,5,11
43127,43,30,1,0,12,31
43128,38,19,10,0,9,29
43129,96,60,20,2,14,82
43130,220,167,5,2,46,174
43131,12,0,11,0,1,11
43132,41,8,12,9,12,29
43133,58,31,15,1,11,47
43134,244,102,14,83,45,199
43135,32,9,18,0,5,27
43136,71,27,5,24,15,56
43137,157,81,38,0,38,119
43138,77,47,15,0,15,62
43139,53,18,22,0,13,40
43140,41,18,14,2,7,34
43141,44,9,21,2,12,32
43142,11,6,3,0,2,9
43143,49,22,15,3,9,40
43144,496,362,29,1,104,392
43145,109,57,21,10,21,88
43146,103,54,15,12,22,81
43147,273,149,74,0,50,223
43148,528,288,87,47,106,422
43149,15,5,8,0,2,13
43150,64,30,13,5,16,48
43151,57,34,13,0,10,47
43152,26,15,5,0,6,20
43153,626,350,156,22,98,528
43154,95,36,22,18,19,76
43155,20,10,4,1,5,15
43156,34,12,15,0,7,27
43157,293,201,22,2,68,225
43158,71,35,16,5,15,56
43159,33,17,11,0,5,28
43160,39,9,22,0,8,31
43161,1,0,1,0,0,1
43162,40,6,28,0,6,34
43163,46,18,20,0,8,38
43164,22,8,7,4,3,19
43165,161,72,53,5,31,130
43166,55,16,30,0,9,46
43167,409,102,173,44,90,319
43168,140,56,46,14,24,116
43169,16,3,9,0,4,12
43170,114,50,19,21,24,90
43171,101,40,27,11,23,78
43172,27,10,12,1,4,23
43173,71,17,44,0,10,61
43174,329,197,62,0,70,259
43175,21,1,14,0,6,15
43176,32,16,3,5,8,24
43177,139,96,11,5,27,112
43178,127,76,26,0,25,102
43179,42,15,21,0,6,36
43180,40,18,15,0,7,33
43181,39,16,10,4,9,30
43182,389,220,78,15,76,313
43183,65,21,28,2,14,51
43184,103,51,40,2,10,93
43185,39,17,17,0,5,34
43186,66,44,9,2,11,55
43187,160,67,32,21,40,120
43188,11,6,2,0,3,8
43189,34,20,6,1,7,27
43190,78,44,18,2,14,64
43191,34,9,16,0,9,25
43192,418,196,136,11,75,343
43193,166,74,53,6,33,133
43194,39,18,4,8,9,30
43195,373,279,21,2,71,302
43196,42,15,23,0,4,38
43197,6,2,1,1,2,4
43198,19,4,0,8,7,12
43199,128,33,69,0,26,102
43200,27,14,2,4,7,20
43201,7,5,1,0,1,6
43202,75,51,10,3,11,64
43203,31,19,6,0,6,25
43204,42,23,9,1,9,33
43205,44,18,18,1,7,37
43206,9,4,3,1,1,8
43207,98,55,19,5,19,79
43208,42,13,22,0,7,35
43209,36,18,15,1,2,34
43210,7,5,1,0,1,6
43211,119,57,23,16,23,96
43212,4,0,1,0,3,1
43213,57,30,16,1,10,47
43214,27,15,10,2,0,27
43215,55,31,13,2,9,46
43216,63,37,9,3,14,49
43217,46,9,22,0,15,31
43218,84,42,30,0,12,72
43219,335,140,119,6,70,265
43220,44,26,4,0,14,30
43221,69,32,24,2,11,58
43222,31,22,0,0,9,22
43223,414,109,165,48,92,322
43224,9,0,8,0,1,8
43225,34,13,15,2,4,30
43226,135,90,18,1,26,109
43227,424,133,157,47,87,337
43228,206,87,43,27,49,157
43229,50,24,17,4,5,45
43230,52,19,18,3,12,40
43231,15,12,0,0,3,12
43232,43,20,16,1,6,37
43233,19,7,7,0,5,14
43234,202,162,10,1,29,173
43235,137,93,19,1,24,113
43236,46,8,32,0,6,40
43237,57,25,7,8,17,40
43238,165,90,21,21,33,132
43239,66,12,41,0,13,53
43240,29,2,21,1,5,24
43241,200,119,45,0,36,164
43242,66,48,11,6,1,65
43243,416,220,106,20,70,346
43244,15,5,7,0,3,12
43245,75,6,51,1,17,58
43246,24,7,7,0,10,14
43247,31,12,7,6,6,25
43248,120,50,30,18,22,98
43249,101,11,50,20,20,81
43250,472,229,94,49,100,372
43251,56,23,19,1,13,43
43252,39,28,7,0,4,35
43253,177,113,22,9,33,144
43254,56,28,17,1,10,46
43255,121,63,39,8,11,110
43256,85,50,19,0,16,69
43257,127,74,22,3,28,99
43258,76,10,42,5,19,57
43259,352,120,114,40,78,274
43260,32,6,15,1,10,22
43261,48,16,19,6,7,41
43262,20,10,4,2,4,16
43263,43,14,19,2,8,35
43264,32,21,9,0,2,30
43265,15,0,13,0,2,13
43266,66,28,16,13,9,57
43267,51,39,2,0,10,41
43268,43,31,3,2,7,36
43269,76,5,53,1,17,59
43270,24,4,14,1,5,19
43271,15,7,0,3,5,10
43272,45,31,3,0,11,34
43273,233,155,32,0,46,187
43274,166,89,42,4,31,135
43275,157,118,2,1,36,121
43276,121,73,27,0,21,100
43277,241,130,55,14,42,199
43278,445,240,102,11,92,353
43279,67,51,6,0,10,57
43280,122,90,3,0,29,93
43281,126,74,21,3,28,98
43282,173,88,43,0,42,131
43283,37,14,22,0,1,36
43284,415,164,115,45,91,324
43285,106,33,36,15,22,84
43286,68,44,12,0,12,56
43287,142,108,7,2,25,117
43288,30,10,10,7,3,27
43289,649,359,164,21,105,544
43290,356,194,88,15,59,297
43291,46,18,20,0,8,38
43292,4,0,2,1,1,3
43293,48,31,10,1,6,42
43294,4,2,2,0,0,4
43295,61,20,28,2,11,50
43296,30,11,11,2,6,24
43297,18,14,1,0,3,15
43298,3,0,2,1,0,3
43299,28,26,0,0,2,26
43300,14,8,3,0,3,11
43301,422,141,144,48,89,333
43302,146,79,30,1,36,110
43303,64,33,14,0,17,47
43304,551,329,116,14,92,459
43305,418,229,92,12,85,333
43306,6,3,0,0,3,3
43307,55,15,21,9,10,45
43308,225,74,86,15,50,175
43309,402,176,124,23,79,323
43310,90,65,6,0,19,71
43311,67,25,23,3,16,51
43312,511,249,102,56,104,407
43313,44,26,12,5,1,43
43314,34,0,28,0,6,28
43315,1,0,1,0,0,1
43316,47,6,35,1,5,42
43317,127,75,22,2,28,99
43318,140,102,6,2,30,110
43319,169,31,105,1,32,137
43320,63,47,12,0,4,59
43321,44,18,10,5,11,33
43322,193,134,45,2,12,181
43323,366,166,124,5,71,295
43324,38,22,5,3,8,30
43325,109,27,30,21,31,78
43326,48,40,2,0,6,42
43327,168,52,12,75,29,139
43328,66,28,24,0,14,52
43329,128,85,18,1,24,104
43330,69,4,51,0,14,55
43331,34,26,1,0,7,27
43332,57,45,2,0,10,47
43333,47,17,15,1,14,33
43334,354,200,52,30,72,282
43335,75,53,7,3,12,63
43336,53,23,19,1,10,43
43337,29,12,11,0,6,23
43338,195,95,38,28,34,161
43339,123,39,68,0,16,107
43340,13,1,7,0,5,8
43341,52,22,15,1,14,38
43342,92,29,39,5,19,73
43343,118,62,22,11,23,95
43344,24,10,8,0,6,18
43345,138,52,37,15,34,104
43346,46,18,20,0,8,38
43347,222,119,67,0,36,186
43348,64,48,10,5,1,63
43349,4,2,0,1,1,3
43350,47,29,8,3,7,40
43351,59,36,10,1,12,47
43352,197,63,93,3,38,159
43353,78,46,10,5,17,61
43354,109,19,55,15,20,89
43355,144,47,74,3,20,124
43356,78,10,52,0,16,62
43357,68,45,5,3,15,53
43358,45,15,14,4,12,33
43359,30,16,4,4,6,24
43360,178,109,5,21,43,135
43361,46,18,20,0,8,38
43362,171,82,68,4,17,154
43363,80,34,17,9,20,60
43364,94,48,28,1,17,77
43365,7,3,2,0,2,5
43366,175,134,7,0,34,141
43367,71,44,13,2,12,59
43368,55,23,15,2,15,40
43369,83,44,16,8,15,68
43370,210,57,53,59,41,169
43371,83,44,19,1,19,64
43372,26,14,9,0,3,23
43373,114,61,32,1,20,94
43374,60,31,20,2,7,53
43375,64,5,43,4,12,52
43376,40,16,17,3,4,36
43377,40,18,11,0,11,29
43378,46,18,20,0,8,38
43379,94,49,13,17,15,79
43380,20,15,1,0,4,16
43381,369,117,161,8,83,286
43382,63,21,31,0,11,52
43383,29,11,12,0,6,23
43384,9,7,1,1,0,9
43385,8,4,4,0,0,8
43386,81,40,18,2,21,60
43387,426,202,140,11,73,353
43388,23,10,8,0,5,18
43389,45,15,15,3,12,33
43390,32,21,9,0,2,30
43391,3,1,2,0,0,3
43392,43,24,6,3,10,33
43393,32,21,9,0,2,30
43394,14,3,6,1,4,10
43395,14,4,5,3,2,12
43396,16,7,2,1,6,10
43397,4,3,0,0,1,3
43398,28,6,16,0,6,22
43399,39,26,5,4,4,35
43400,22,15,2,0,5,17
43401,10,3,4,1,2,8
43402,56,38,11,0,7,49
43403,86,39,33,2,12,74
43404,57,10,8,27,12,45
43405,32,21,9,0,2,30
43406,668,381,141,20,126,542
43407,12,7,3,1,1,11
43408,67,5,46,3,13,54
43409,24,7,7,0,10,14
43410,127,74,22,3,28,99
43411,74,11,48,0,15,59
43412,429,243,96,0,90,339
43413,66,35,15,1,15,51
43414,30,9,15,0,6,24
43415,66,33,13,3,17,49
43416,115,57,29,6,23,92
43417,587,430,38,1,118,469
43418,35,11,18,0,6,29
43419,72,37,18,3,14,58
43420,155,74,49,1,31,124
43421,66,41,10,0,15,51
43422,46,18,20,0,8,38
43423,48,16,20,1,11,37
43424,73,41,17,1,14,59
43425,88,61,5,9,13,75
43426,26,8,10,2,6,20
43427,76,58,2,0,16,60
43428,77,46,12,4,15,62
43429,30,22,0,0,8,22
43430,111,54,26,12,19,92
43431,22,1,16,0,5,17
43432,47,21,17,0,9,38
43433,13,3,5,1,4,9
43434,5,1,1,0,3,2
43435,225,153,31,0,41,184
43436,7,4,0,0,3,4
43437,134,55,47,5,27,107
43438,102,25,50,4,23,79
43439,68,21,30,8,9,59
43440,41,8,24,1,8,33
43441,141,81,22,1,37,104
43442,181,128,40,2,11,170
43443,139,58,28,22,31,108
43444,47,24,11,2,10,37
43445,659,377,139,19,124,535
43446,145,50,48,17,30,115
43447,8,1,4,1,2,6
43448,18,12,3,0,3,15
43449,147,36,76,1,34,113
43450,147,91,30,0,26,121
43451,57,37,3,6,11,46
43452,406,277,40,1,88,318
43453,46,26,10,0,10,36
43454,120,29,55,3,33,87
43455,134,41,48,15,30,104
43456,502,342,47,1,112,390
43457,38,18,12,2,6,32
43458,56,35,13,0,8,48
43459,84,42,27,0,15,69
43460,92,49,17,7,19,73
43461,200,139,27,2,32,168
43462,39,21,14,0,4,35
43463,179,83,58,3,35,144
43464,23,9,10,1,3,20
43465,289,130,82,25,52,237
43466,61,15,29,2,15,46
43467,41,35,3,0,3,38
43468,61,18,22,8,13,48
43469,17,3,12,0,2,15
43470,34,13,15,1,5,29
43471,222,75,83,15,49,173
43472,42,13,19,3,7,35
43473,78,31,32,0,15,63
43474,37,26,4,0,7,30
43475,95,59,20,2,14,81
43476,3,0,3,0,0,3
43477,52,16,22,4,10,42
43478,31,6,16,2,7,24
43479,154,54,39,29,32,122
43480,65,26,27,1,11,54
43481,55,32,15,2,6,49
43482,125,76,20,0,29,96
43483,74,50,7,0,17,57
43484,11,10,0,0,1,10
43485,59,41,6,3,9,50
43486,125,60,35,6,24,101
43487,338,146,121,4,67,271
43488,140,57,31,23,29,111
43489,205,136,29,4,36,169
43490,83,57,5,7,14,69
43491,57,32,15,0,10,47
43492,19,8,9,0,2,17
43493,107,47,30,18,12,95
43494,64,14,24,3,23,41
43495,45,27,10,0,8,37
43496,22,10,7,1,4,18
43497,46,18,20,0,8,38
43498,18,9,6,1,2,16
43499,176,106,26,4,40,136
43500,68,36,15,1,16,52
43501,124,83,27,1,13,111
43502,84,44,25,0,15,69
43503,153,66,55,1,31,122
43504,64,21,34,0,9,55
43505,150,11,93,17,29,121
43506,95,91,0,4,0,95
43507,125,56,39,0,30,95
43508,53,22,17,4,10,43
43509,55,20,21,1,13,42
43510,279,95,125,14,45,234
43511,75,17,40,2,16,59
43512,21,1,4,12,4,17
43513,1259,502,171,336,250,1009
43514,117,46,27,21,23,94
43515,38,7,22,2,7,31
43516,357,195,87,15,60,297
43517,86,10,50,7,19,67
43518,98,42,34,4,18,80
43519,5,2,2,0,1,4
43520,115,24,56,15,20,95
43521,51,30,12,2,7,44
43522,134,29,69,1,35,99
43523,127,74,22,3,28,99
43524,43,21,6,5,11,32
43525,208,46,107,2,53,155
43526,111,67,21,6,17,94
43527,20,11,5,1,3,17
43528,43,20,10,5,8,35
43529,90,79,2,9,0,90
43530,139,47,42,22,28,111
43531,153,88,36,1,28,125
43532,142,50,26,44,22,120
43533,6,2,1,3,0,6
43534,38,23,4,3,8,30
43535,112,72,24,0,16,96
43536,36,5,14,9,8,28
43537,24,10,6,2,6,18
43538,75,48,17,1,9,66
43539,64,22,29,2,11,53
43540,40,24,9,4,3,37
43541,471,344,28,0,99,372
43542,23,11,2,3,7,16
43543,58,31,10,1,16,42
43544,75,29,33,3,10,65
43545,49,28,12,2,7,42
43546,26,8,12,0,6,20
43547,73,15,46,0,12,61
43548,149,44,81,4,20,129
43549,336,140,119,6,71,265
43550,10,4,2,2,2,8
43551,2,0,1,0,1,1
43552,46,19,13,0,14,32
43553,37,14,11,1,11,26
43554,109,49,35,3,22,87
43555,27,9,8,3,7,20
43556,201,89,54,20,38,163
43557,106,43,22,18,23,83
43558,86,40,22,1,23,63
43559,94,58,19,2,15,79
43560,112,44,39,8,21,91
43561,97,44,33,4,16,81
43562,27,9,6,8,4,23
43563,17,17,0,0,0,17
43564,18,2,12,0,4,14
43565,18,9,8,0,1,17
43566,94,43,15,16,20,74
43567,204,85,66,19,34,170
43568,24,12,8,2,2,22
43569,35,6,22,1,6,29
43570,93,74,3,0,16,77
43571,7,3,3,0,1,6
43572,176,115,39,13,9,167
43573,18,7,5,2,4,14
43574,33,19,6,2,6,27
43575,32,21,9,0,2,30
43576,36,16,2,5,13,23
43577,51,26,17,0,8,43
43578,59,13,40,0,6,53
43579,75,46,13,0,16,59
43580,43,34,1,0,8,35
43581,146,101,22,0,23,123
43582,77,36,16,6,19,58
43583,357,193,74,16,74,283
43584,89,46,18,9,16,73
43585,50,20,20,0,10,40
43586,10,1,5,0,4,6
43587,86,36,37,3,10,76
43588,29,4,17,0,8,21
43589,157,68,37,15,37,120
43590,343,145,121,6,71,272
43591,92,62,10,0,20,72
43592,104,97,0,7,0,104
43593,87,67,0,4,16,71
43594,341,144,120,6,71,270
43595,146,59,54,3,30,116
43596,23,3,17,0,3,20
43597,20,14,4,0,2,18
43598,32,8,11,6,7,25
43599,36,6,21,0,9,27
43600,45,6,29,0,10,35
43601,38,9,15,4,10,28
43602,74,34,20,0,20,54
43603,2,0,1,0,1,1
43604,40,9,21,3,7,33
43605,127,47,39,14,27,100
43606,46,18,20,0,8,38
43607,179,49,54,40,36,143
43608,150,87,36,0,27,123
43609,106,44,12,16,34,72
43610,90,64,5,1,20,70
43611,34,15,10,1,8,26
43612,89,32,34,4,19,70
43613,171,127,6,1,37,134
43614,46,18,20,0,8,38
43615,17,8,6,0,3,14
43616,41,16,17,0,8,33
43617,73,36,23,0,14,59
43618,22,3,13,2,4,18
43619,185,92,55,0,38,147
43620,73,52,7,3,11,62
43621,121,25,44,30,22,99
43622,32,17,12,2,1,31
43623,661,390,140,17,114,547
43624,21,5,1,8,7,14
43625,109,52,14,16,27,82
43626,56,12,38,0,6,50
43627,0,0,0,0,0,0
43628,95,50,23,4,18,77
43629,80,38,23,1,18,62
43630,44,14,14,3,13,31
43631,4,1,2,1,0,4
43632,77,5,54,1,17,60
43633,85,18,40,11,16,69
43634,198,109,27,23,39,159
43635,85,46,22,1,16,69
43636,31,20,5,0,6,25
43637,74,44,14,3,13,61
43638,5,0,3,0,2,3
43639,117,45,32,13,27,90
43640,485,265,79,41,100,385
43641,129,95,5,1,28,101
43642,65,24,30,1,10,55
43643,219,92,14,76,37,182
43644,22,12,7,0,3,19
43645,38,17,16,0,5,33
43646,41,17,16,0,8,33
43647,57,16,16,16,9,48
43648,194,48,99,5,42,152
43649,141,25,89,1,26,115
43650,61,33,8,4,16,45
43651,46,18,20,0,8,38
43652,121,71,19,10,21,100
43653,113,64,30,1,18,95
43654,63,32,6,5,20,43
43655,432,120,171,47,94,338
43656,154,70,31,17,36,118
43657,376,271,31,0,74,302
43658,128,43,33,28,24,104
43659,468,216,105,51,96,372
43660,53,32,1,3,17,36
43661,52,18,20,2,12,40
43662,18,11,3,0,4,14
43663,32,21,9,0,2,30
43664,68,48,9,0,11,57
43665,99,52,33,7,7,92
43666,473,280,61,40,92,381
43667,13,3,7,0,3,10
43668,162,31,90,0,41,121
43669,24,1,14,0,9,15
43670,18,14,1,0,3,15
43671,1329,543,187,339,260,1069
43672,37,18,14,2,3,34
43673,10,6,2,1,1,9
43674,65,25,18,8,14,51
43675,59,38,13,0,8,51
43676,39,7,12,9,11,28
43677,19,2,11,3,3,16
43678,92,57,8,7,20,72
43679,4,1,2,0,1,3
43680,76,26,22,10,18,58
43681,164,55,80,0,29,135
43682,149,57,37,22,33,116
43683,55,13,27,10,5,50
43684,38,13,20,1,4,34
43685,378,173,121,10,74,304
43686,17,6,5,0,6,11
43687,75,22,29,8,16,59
43688,343,147,121,6,69,274
43689,65,29,12,14,10,55
43690,22,0,19,0,3,19
43691,7,4,0,0,3,4
43692,24,4,16,0,4,20
43693,217,14,164,0,39,178
43694,42,22,9,3,8,34
43695,426,203,122,11,90,336
43696,18,10,4,0,4,14
43697,62,46,5,4,7,55
43698,21,11,6,2,2,19
43699,492,264,82,43,103,389
43700,39,24,7,0,8,31
43701,3,0,3,0,0,3
43702,78,45,14,3,16,62
43703,79,9,51,3,16,63
43704,64,48,12,0,4,60
43705,275,186,67,2,20,255
43706,31,15,2,6,8,23
43707,125,33,69,0,23,102
43708,651,384,138,19,110,541
43709,46,18,20,0,8,38
43710,4,1,1,0,2,2
43711,160,47,58,22,33,127
43712,203,146,10,10,37,166
43713,43,22,14,0,7,36
43714,152,63,32,23,34,118
43715,28,2,16,5,5,23
43716,24,17,3,0,4,20
43717,48,23,20,0,5,43
43718,15,1,12,0,2,13
43719,7,3,4,0,0,7
43720,76,5,54,1,16,60
43721,32,21,9,0,2,30
43722,138,105,4,3,26,112
43723,62,25,24,2,11,51
43724,111,44,39,10,18,93
43725,46,17,17,3,9,37
43726,32,21,9,0,2,30
43727,244,106,78,17,43,201
43728,211,86,81,13,31,180
43729,45,11,24,0,10,35
43730,100,81,3,2,14,86
43731,21,7,9,3,2,19
43732,82,52,14,0,16,66
43733,95,41,28,1,25,70
43734,186,95,54,5,32,154
43735,451,140,188,26,97,354
43736,125,54,20,18,33,92
43737,10,4,4,0,2,8
43738,426,119,194,11,102,324
43739,32,21,9,0,2,30
43740,21,2,15,0,4,17
43741,29,7,15,0,7,22
43742,124,62,22,13,27,97
43743,148,63,46,9,30,118
43744,64,46,7,0,11,53
43745,78,22,40,0,16,62
43746,155,68,33,18,36,119
43747,159,40,93,2,24,135
43748,43,11,17,9,6,37
43749,53,3,39,3,8,45
43750,49,21,5,16,7,42
43751,139,48,60,6,25,114
43752,15,7,7,1,0,15
43753,124,35,40,23,26,98
43754,101,29,49,7,16,85
43755,122,60,27,14,21,101
43756,7,5,2,0,0,7
43757,5,1,2,1,1,4
43758,38,9,16,6,7,31
43759,18,11,6,1,0,18
43760,46,18,20,0,8,38
43761,72,30,21,3,18,54
43762,128,60,22,16,30,98
43763,27,7,15,0,5,22
43764,436,200,147,9,80,356
43765,44,22,14,0,8,36
43766,100,47,14,24,15,85
43767,24,16,3,4,1,23
43768,32,7,15,5,5,27
43769,135,56,41,16,22,113
43770,156,79,45,1,31,125
43771,73,31,19,1,22,51
43772,12,3,6,1,2,10
43773,220,118,63,5,34,186
43774,82,46,24,1,11,71
43775,97,46,27,2,22,75
43776,55,24,13,6,12,43
43777,312,154,89,4,65,247
43778,102,56,13,15,18,84
43779,19,7,8,3,1,18
43780,3,1,0,0,2,1
43781,63,34,10,6,13,50
43782,121,54,29,14,24,97
43783,55,44,0,1,10,45
43784,7,3,2,0,2,5
43785,23,8,10,0,5,18
43786,83,8,57,0,18,65
43787,53,22,18,2,11,42
43788,102,62,25,7,8,94
43789,1,1,0,0,0,1
43790,48,33,6,1,8,40
43791,302,80,43,130,49,253
43792,75,36,22,0,17,58
43793,98,39,42,0,17,81
43794,32,21,9,0,2,30
43795,38,26,5,0,7,31
43796,364,187,94,19,64,300
43797,57,22,19,5,11,46
43798,60,33,17,0,10,50
43799,210,107,33,33,37,173
43800,87,36,19,8,24,63
43801,221,120,34,23,44,177
43802,209,58,113,4,34,175
43803,99,45,12,21,21,78
43804,42,5,28,0,9,33
43805,16,6,6,1,3,13
43806,44,20,6,7,11,33
43807,38,18,11,1,8,30
43808,11,5,5,0,1,10
43809,63,19,28,10,6,57
43810,240,129,58,13,40,200
43811,86,19,36,12,19,67
43812,149,8,92,19,30,119
43813,22,7,12,0,3,19
43814,94,18,48,11,17,77
43815,100,53,28,1,18,82
43816,14,4,2,5,3,11
43817,80,26,37,3,14,66
43818,39,23,11,0,5,34
43819,335,134,95,33,73,262
43820,24,4,12,0,8,16
43821,178,126,15,2,35,143
43822,33,21,3,3,6,27
43823,38,16,12,0,10,28
43824,16,4,8,0,4,12
43825,86,41,11,11,23,63
43826,9,5,3,0,1,8
43827,75,28,25,1,21,54
43828,32,21,9,0,2,30
43829,413,219,107,18,69,344
43830,55,39,9,7,0,55
43831,46,18,20,0,8,38
43832,1,0,0,1,0,1
43833,3,1,2,0,0,3
43834,36,15,18,0,3,33
43835,126,39,45,16,26,100
43836,78,25,39,4,10,68
43837,172,112,27,5,28,144
43838,79,22,45,1,11,68
43839,14,8,3,0,3,11
43840,30,22,3,1,4,26
43841,33,27,1,0,5,28
43842,50,30,7,1,12,38
43843,36,4,23,1,8,28
43844,49,20,18,1,10,39
43845,38,29,7,2,0,38
43846,268,122,79,12,55,213
43847,81,41,19,10,11,70
43848,28,23,0,0,5,23
43849,53,10,30,2,11,42
43850,34,17,10,0,7,27
43851,43,26,8,2,7,36
43852,493,251,88,47,107,386
43853,13,1,8,0,4,9
43854,126,62,22,14,28,98
43855,36,0,32,1,3,33
43856,79,39,21,8,11,68
43857,17,5,7,1,4,13
43858,35,12,11,2,10,25
43859,62,18,25,5,14,48
43860,28,9,14,0,5,23
43861,225,171,8,0,46,179
43862,56,23,14,4,15,41
43863,449,244,120,13,72,377
43864,159,101,3,17,38,121
43865,67,41,17,0,9,58
43866,97,54,25,0,18,79
43867,26,10,8,2,6,20
43868,92,67,6,0,19,73
43869,63,15,32,4,12,51
43870,66,29,23,4,10,56
43871,122,66,36,1,19,103
43872,32,21,9,0,2,30
43873,47,25,13,0,9,38
43874,4,3,0,0,1,3
43875,35,16,12,0,7,28
43876,28,6,17,0,5,23
43877,154,99,3,17,35,119
43878,429,238,109,0,82,347
43879,352,170,114,1,67,285
43880,632,390,101,8,133,499
43881,30,10,13,1,6,24
43882,54,36,6,1,11,43
43883,111,54,37,0,20,91
43884,92,38,25,13,16,76
43885,167,81,50,3,33,134
43886,6,2,2,0,2,4
43887,47,36,1,0,10,37
43888,8,1,3,2,2,6
43889,141,80,21,3,37,104
43890,89,21,40,17,11,78
43891,52,22,17,5,8,44
43892,70,13,43,0,14,56
43893,24,8,14,0,2,22
43894,60,41,5,1,13,47
43895,354,189,91,15,59,295
43896,37,26,0,1,10,27
43897,10,4,5,0,1,9
43898,32,21,9,0,2,30
43899,28,18,6,4,0,28
43900,147,44,35,39,29,118
43901,128,42,45,7,34,94
43902,46,28,5,7,6,40
43903,108,75,19,2,12,96
43904,72,55,0,0,17,55
43905,24,12,3,3,6,18
43906,68,36,10,9,13,55
43907,19,7,9,1,2,17
43908,81,40,9,19,13,68
43909,278,97,126,14,41,237
43910,17,4,13,0,0,17
43911,90,33,38,0,19,71
43912,20,18,0,0,2,18
43913,27,9,15,0,3,24
43914,46,18,20,0,8,38
43915,9,1,6,0,2,7
43916,77,54,12,1,10,67
43917,269,107,105,7,50,219
43918,8,2,5,0,1,7
43919,138,96,14,2,26,112
43920,67,27,18,5,17,50
43921,347,189,88,15,55,292
43922,70,42,14,3,11,59
43923,358,160,123,6,69,289
43924,14,2,12,0,0,14
43925,170,112,27,1,30,140
43926,48,28,12,0,8,40
43927,58,14,27,1,16,42
43928,403,227,94,0,82,321
43929,87,38,27,2,20,67
43930,59,22,12,16,9,50
43931,56,39,3,0,14,42
43932,589,340,120,19,110,479
43933,62,19,32,1,10,52
43934,203,111,30,21,41,162
43935,196,76,36,34,50,146
43936,39,13,21,1,4,35
43937,37,7,16,4,10,27
43938,23,1,17,0,5,18
43939,318,161,89,15,53,265
43940,39,12,19,1,7,32
43941,315,164,75,19,57,258
43942,44,34,1,0,9,35
43943,13,2,7,0,4,9
43944,288,71,43,126,48,240
43945,27,1,22,0,4,23
43946,681,382,165,23,111,570
43947,21,10,4,3,4,17
43948,69,21,31,4,13,56
43949,34,12,10,3,9,25
43950,130,28,61,18,23,107
43951,18,13,2,0,3,15
43952,32,2,24,1,5,27
43953,168,130,7,0,31,137
43954,25,11,11,0,3,22
43955,37,27,1,2,7,30
43956,32,21,9,0,2,30
43957,25,5,1,15,4,21
43958,23,0,17,1,5,18
43959,81,17,8,34,22,59
43960,49,8,29,0,12,37
43961,181,53,28,69,31,150
43962,60,37,13,0,10,50
43963,59,18,15,14,12,47
43964,60,27,9,10,14,46
43965,78,32,28,4,14,64
43966,79,45,11,0,23,56
43967,35,25,4,0,6,29
43968,322,142,119,5,56,266
43969,94,68,4,2,20,74
43970,1070,390,433,46,201,869
43971,178,131,13,1,33,145
43972,54,33,12,0,9,45
43973,6,2,4,0,0,6
43974,112,51,41,2,18,94
43975,47,20,19,0,8,39
43976,59,36,10,0,13,46
43977,81,47,12,5,17,64
43978,85,40,30,1,14,71
43979,38,7,23,1,7,31
43980,142,103,4,2,33,109
43981,127,59,18,19,31,96
43982,46,18,20,0,8,38
43983,46,18,20,0,8,38
43984,329,165,94,5,65,264
43985,4,2,2,0,0,4
43986,135,87,28,0,20,115
43987,38,9,18,1,10,28
43988,341,142,122,6,71,270
43989,32,6,20,0,6,26
43990,116,57,20,16,23,93
43991,21,2,11,1,7,14
43992,146,88,24,6,28,118
43993,20,3,13,0,4,16
43994,24,15,5,1,3,21
43995,105,58,8,19,20,85
43996,214,151,47,3,13,201
43997,396,187,122,13,74,322
43998,25,7,11,1,6,19
43999,457,219,140,12,86,371
44000,173,116,26,0,31,142
44001,143,59,55,2,27,116
44002,4,3,1,0,0,4
44003,528,373,44,1,110,418
44004,38,14,17,3,4,34
44005,39,9,23,0,7,32
44006,23,14,5,0,4,19
44007,211,110,47,0,54,157
44008,7,6,0,0,1,6
44009,205,111,61,0,33,172
44010,170,82,25,22,41,129
44011,155,46,82,0,27,128
44012,555,319,118,17,101,454
44013,168,44,88,4,32,136
44014,214,97,84,0,33,181
44015,347,207,60,11,69,278
44016,237,101,15,79,42,195
44017,88,55,16,2,15,73
44018,285,67,63,99,56,229
44019,37,16,14,0,7,30
44020,86,66,8,0,12,74
44021,10,6,4,0,0,10
44022,85,57,8,0,20,65
44023,2,0,2,0,0,2
44024,77,47,8,8,14,63
44025,244,155,44,4,41,203
44026,443,139,190,14,100,343
44027,67,25,25,0,17,50
44028,452,138,191,28,95,357
44029,83,57,10,5,11,72
44030,46,17,21,2,6,40
44031,133,40,46,19,28,105
44032,95,61,9,4,21,74
44033,72,22,29,5,16,56
44034,75,23,24,9,19,56
44035,21,2,14,0,5,16
44036,158,64,31,31,32,126
44037,17,3,12,0,2,15
44038,150,99,28,1,22,128
44039,46,15,21,0,10,36
44040,38,7,22,2,7,31
44041,386,120,154,31,81,305
44042,69,36,11,6,16,53
44043,26,10,10,0,6,20
44044,14,5,4,0,5,9
44045,14,6,5,2,1,13
44046,35,21,3,3,8,27
44047,44,28,8,0,8,36
44048,59,30,11,2,16,43
44049,448,141,184,21,102,346
44050,23,13,4,0,6,17
44051,48,19,15,3,11,37
44052,64,32,7,5,20,44
44053,23,12,8,0,3,20
44054,24,7,11,0,6,18
44055,128,28,45,29,26,102
44056,117,46,30,14,27,90
44057,79,52,5,10,12,67
44058,17,11,1,2,3,14
44059,89,37,37,0,15,74
44060,19,7,8,0,4,15
44061,94,41,36,0,17,77
44062,14,4,5,0,5,9
44063,353,195,88,15,55,298
44064,80,46,20,0,14,66
44065,92,36,34,4,18,74
44066,219,73,83,14,49,170
44067,36,13,11,3,9,27
44068,64,30,19,0,15,49
44069,157,54,39,31,33,124
44070,32,21,9,0,2,30
44071,53,21,5,18,9,44
44072,81,31,34,2,14,67
44073,55,11,38,0,6,49
44074,129,27,46,30,26,103
44075,186,52,97,2,35,151
44076,35,15,10,4,6,29
44077,25,5,13,2,5,20
44078,192,101,58,4,29,163
44079,113,39,52,4,18,95
44080,15,9,2,0,4,11
44081,16,9,5,1,1,15
44082,36,15,13,0,8,28
44083,175,90,47,0,38,137
44084,73,29,7,21,16,57
44085,17,1,13,0,3,14
44086,348,149,122,6,71,277
44087,19,7,8,0,4,15
44088,47,14,19,2,12,35
44089,32,21,9,0,2,30
44090,47,23,12,1,11,36
44091,49,32,6,2,9,40
44092,128,98,3,0,27,101
44093,46,18,20,0,8,38
44094,62,40,10,0,12,50
44095,64,48,12,0,4,60
44096,15,2,8,3,2,13
44097,37,26,0,1,10,27
44098,40,8,17,0,15,25
44099,86,26,19,21,20,66
44100,146,59,55,8,24,122
44101,61,29,23,2,7,54
44102,168,118,11,9,30,138
44103,139,49,62,4,24,115
44104,132,5,73,26,28,104
44105,310,162,82,15,51,259
44106,560,320,118,18,104,456
44107,75,5,53,1,16,59
44108,74,42,8,5,19,55
44109,422,196,121,13,92,330
44110,173,84,23,25,41,132
44111,153,78,48,2,25,128
44112,8,5,3,0,0,8
44113,52,36,3,1,12,40
44114,73,23,24,14,12,61
44115,101,37,37,5,22,79
44116,37,13,16,0,8,29
44117,77,36,26,0,15,62
44118,100,25,43,16,16,84
44119,49,31,5,2,11,38
44120,26,7,5,5,9,17
44121,4,0,2,0,2,2
44122,62,36,14,10,2,60
44123,246,188,13,0,45,201
44124,52,27,17,0,8,44
44125,130,28,61,18,23,107
44126,72,46,5,10,11,61
44127,46,9,23,4,10,36
44128,46,18,20,0,8,38
44129,22,9,5,2,6,16
44130,67,15,36,1,15,52
44131,13,4,3,1,5,8
44132,52,0,41,2,9,43
44133,78,19,18,30,11,67
44134,418,215,101,13,89,329
44135,14,3,8,0,3,11
44136,16,5,9,1,1,15
44137,33,5,20,0,8,25
44138,5,2,2,0,1,4
44139,22,4,12,0,6,16
44140,25,9,9,4,3,22
44141,6,2,2,1,1,5
44142,159,101,28,0,30,129
44143,16,3,9,0,4,12
44144,111,86,2,2,21,90
44145,19,4,5,8,2,17
44146,101,53,33,0,15,86
44147,38,10,22,4,2,36
44148,27,15,1,4,7,20
44149,12,4,3,0,5,7
44150,91,51,17,1,22,69
44151,59,15,35,1,8,51
44152,187,73,33,34,47,140
44153,65,38,11,2,14,51
44154,55,29,10,4,12,43
44155,83,18,48,2,15,68
44156,160,76,51,1,32,128
44157,459,338,20,0,101,358
44158,53,16,26,0,11,42
44159,30,14,10,2,4,26
44160,165,97,38,1,29,136
44161,199,108,40,14,37,162
44162,571,348,85,9,129,442
44163,140,74,29,1,36,104
44164,5,3,1,0,1,4
44165,35,9,21,0,5,30
44166,195,48,103,12,32,163
44167,220,149,30,0,41,179
44168,48,20,15,4,9,39
44169,67,25,16,7,19,48
44170,131,42,36,29,24,107
44171,203,89,56,20,38,165
44172,62,37,11,0,14,48
44173,124,55,23,17,29,95
44174,158,38,14,80,26,132
44175,684,404,140,20,120,564
44176,126,44,46,11,25,101
44177,76,42,19,0,15,61
44178,77,21,41,2,13,64
44179,14,1,9,0,4,10
44180,10,2,5,0,3,7
44181,37,17,12,0,8,29
44182,12,3,7,0,2,10
44183,38,25,7,0,6,32
44184,136,83,14,10,29,107
44185,33,14,8,0,11,22
44186,40,9,23,0,8,32
44187,20,9,9,0,2,18
44188,57,19,26,0,12,45
44189,160,97,41,13,9,151
44190,148,36,80,1,31,117
44191,73,40,22,3,8,65
44192,201,103,49,0,49,152
44193,4,1,1,1,1,3
44194,131,45,24,38,24,107
44195,66,35,17,5,9,57
44196,59,22,25,0,12,47
44197,156,114,7,5,30,126
44198,181,50,99,4,28,153
44199,269,148,74,0,47,222
44200,47,21,13,3,10,37
44201,213,107,35,34,37,176
44202,64,48,5,4,7,57
44203,12,7,3,1,1,11
44204,160,55,33,35,37,123
44205,159,121,10,1,27,132
44206,147,59,58,8,22,125
44207,5,2,2,0,1,4
44208,43,7,21,0,15,28
44209,138,92,19,1,26,112
44210,119,67,30,0,22,97
44211,590,406,54,1,129,461
44212,77,22,28,9,18,59
44213,54,33,14,0,7,47
44214,58,21,15,5,17,41
44215,102,27,25,28,22,80
44216,34,15,9,0,10,24
44217,110,105,0,5,0,110
44218,81,52,16,0,13,68
44219,48,22,15,2,9,39
44220,204,51,104,14,35,169
44221,59,30,18,1,10,49
44222,155,80,44,1,30,125
44223,42,11,16,6,9,33
44224,29,22,3,0,4,25
44225,83,38,16,9,20,63
44226,54,12,17,13,12,42
44227,44,19,15,0,10,34
44228,666,391,141,17,117,549
44229,95,51,28,1,15,80
44230,96,55,23,1,17,79
44231,63,18,33,1,11,52
44232,60,19,28,1,12,48
44233,37,22,6,1,8,29
44234,171,113,27,1,30,141
44235,70,42,6,8,14,56
44236,181,21,93,27,40,141
44237,122,95,2,1,24,98
44238,33,21,6,1,5,28
44239,46,18,20,0,8,38
44240,65,5,47,3,10,55
44241,46,18,20,0,8,38
44242,118,88,6,0,24,94
44243,117,79,8,6,24,93
44244,12,6,2,1,3,9
44245,318,136,108,6,68,250
44246,179,127,15,2,35,144
44247,192,54,50,50,38,154
44248,19,14,0,0,5,14
44249,334,109,145,8,72,262
44250,119,37,43,10,29,90
44251,120,67,22,3,28,92
44252,6,2,3,0,1,5
44253,100,37,37,2,24,76
44254,51,32,1,4,14,37
44255,419,237,98,0,84,335
44256,73,39,11,7,16,57
44257,74,19,41,4,10,64
44258,521,252,108,56,105,416
44259,93,60,14,11,8,85
44260,8,1,5,0,2,6
44261,69,38,19,1,11,58
44262,30,10,12,3,5,25
44263,70,18,39,0,13,57
44264,36,19,13,0,4,32
44265,2,0,1,0,1,1
44266,32,21,9,0,2,30
44267,126,29,57,18,22,104
44268,17,9,2,0,6,11
44269,653,382,144,15,112,541
44270,211,126,38,6,41,170
44271,58,45,2,0,11,47
44272,2,0,1,0,1,1
44273,46,18,20,0,8,38
44274,202,87,41,26,48,154
44275,42,18,11,0,13,29
44276,276,89,127,15,45,231
44277,132,96,6,0,30,102
44278,32,21,9,0,2,30
44279,344,150,120,6,68,276
44280,188,105,25,23,35,153
44281,81,61,1,0,19,62
44282,54,22,21,1,10,44
44283,100,27,47,8,18,82
44284,363,164,118,9,72,291
44285,19,6,1,7,5,14
44286,72,45,10,3,14,58
44287,9,5,3,0,1,8
44288,46,18,20,0,8,38
44289,31,12,14,0,5,26
44290,56,38,11,0,7,49
44291,59,44,5,3,7,52
44292,60,25,17,2,16,44
44293,214,149,48,2,15,199
44294,71,21,26,1,23,48
44295,55,14,26,8,7,48
44296,5,3,2,0,0,5
44297,31,16,10,0,5,26
44298,170,112,27,1,30,140
44299,202,104,34,30,34,168
44300,104,9,62,10,23,81
44301,32,10,14,3,5,27
44302,56,23,24,0,9,47
44303,73,31,28,0,14,59
44304,198,84,50,22,42,156
44305,517,280,115,12,110,407
44306,87,30,30,5,22,65
44307,187,128,43,2,14,173
44308,184,79,67,0,38,146
44309,36,21,7,0,8,28
44310,17,3,4,0,10,7
44311,35,17,13,0,5,30
44312,14,10,2,0,2,12
44313,57,23,8,10,16,41
44314,53,29,7,7,10,43
44315,383,283,20,2,78,305
44316,149,67,47,6,29,120
44317,93,47,13,2,31,62
44318,54,31,10,0,13,41
44319,87,22,41,17,7,80
44320,12,0,9,0,3,9
44321,46,18,20,0,8,38
44322,135,61,43,5,26,109
44323,46,18,20,0,8,38
44324,124,47,34,16,27,97
44325,251,120,71,0,60,191
44326,39,24,7,0,8,31
44327,30,9,18,0,3,27
44328,6,0,4,0,2,4
44329,117,81,10,2,24,93
44330,132,49,43,16,24,108
44331,48,27,10,0,11,37
44332,25,16,3,1,5,20
44333,46,18,20,0,8,38
44334,33,6,14,4,9,24
44335,107,46,30,12,19,88
44336,88,59,9,4,16,72
44337,27,14,7,1,5,22
44338,25,9,13,0,3,22
44339,31,16,6,3,6,25
44340,46,17,13,5,11,35
44341,20,3,10,0,7,13
44342,70,52,6,1,11,59
44343,192,74,35,33,50,142
44344,669,390,143,17,119,550
44345,5,2,2,1,0,5
44346,76,42,19,0,15,61
44347,12,9,2,0,1,11
44348,63,41,4,0,18,45
44349,157,102,3,15,37,120
44350,62,26,27,0,9,53
44351,10,0,8,0,2,8
44352,5,0,3,0,2,3
44353,78,44,20,0,14,64
44354,438,169,127,46,96,342
44355,69,47,14,0,8,61
44356,26,13,6,0,7,19
44357,211,113,48,0,50,161
44358,94,43,9,18,24,70
44359,45,9,21,0,15,30
44360,323,139,110,6,68,255
44361,233,126,55,14,38,195
44362,110,46,38,7,19,91
44363,112,43,41,3,25,87
44364,352,187,90,15,60,292
44365,58,39,13,3,3,55
44366,77,28,30,1,18,59
44367,40,5,17,9,9,31
44368,82,44,19,0,19,63
44369,32,21,9,0,2,30
44370,48,24,11,4,9,39
44371,63,34,19,0,10,53
44372,669,387,137,20,125,544
44373,51,28,7,1,15,36
44374,487,290,97,11,89,398
44375,532,250,122,44,116,416
44376,62,31,24,1,6,56
44377,128,49,48,0,31,97
44378,6,4,0,2,0,6
44379,190,145,17,1,27,163
44380,153,24,100,1,28,125
44381,118,80,11,2,25,93
44382,79,46,10,0,23,56
44383,138,105,4,2,27,111
44384,180,50,52,41,37,143
44385,20,10,5,0,5,15
44386,48,11,28,1,8,40
44387,531,297,115,17,102,429
44388,99,33,42,11,13,86
44389,35,19,7,0,9,26
44390,12,1,6,1,4,8
44391,53,34,8,0,11,42
44392,26,14,0,6,6,20
44393,164,125,3,1,35,129
44394,42,27,9,0,6,36
44395,174,66,44,30,34,140
44396,59,46,2,0,11,48
44397,114,29,62,0,23,91
44398,21,14,5,0,2,19
44399,116,27,57,2,30,86
44400,0,0,0,0,0,0
44401,301,207,21,3,70,231
44402,67,6,7,34,20,47
44403,8,0,5,0,3,5
44404,123,63,22,12,26,97
44405,620,371,118,18,113,507
44406,13,0,7,0,6,7
44407,72,62,2,0,8,64
44408,99,31,42,6,20,79
44409,451,236,112,14,89,362
44410,67,45,6,0,16,51
44411,74,21,37,4,12,62
44412,27,4,16,0,7,20
44413,181,72,41,21,47,134
44414,39,15,14,2,8,31
44415,131,66,40,0,25,106
44416,169,39,63,26,41,128
44417,61,35,16,0,10,51
44418,89,35,35,0,19,70
44419,93,34,37,0,22,71
44420,134,75,22,3,34,100
44421,45,28,3,6,8,37
44422,53,24,11,7,11,42
44423,42,10,12,9,11,31
44424,55,20,25,2,8,47
44425,103,67,1,13,22,81
44426,51,37,5,1,8,43
44427,59,41,7,0,11,48
44428,40,8,17,0,15,25
44429,83,56,5,9,13,70
44430,40,17,15,0,8,32
44431,71,32,15,14,10,61
44432,30,13,12,0,5,25
44433,45,15,16,5,9,36
44434,70,24,20,17,9,61
44435,47,35,8,4,0,47
44436,102,69,6,0,27,75
44437,94,37,35,4,18,76
44438,379,197,107,17,58,321
44439,39,24,7,0,8,31
44440,62,36,13,3,10,52
44441,46,18,20,0,8,38
44442,32,21,9,0,2,30
44443,14,8,4,0,2,12
44444,98,62,10,10,16,82
44445,53,38,2,0,13,40
44446,105,54,29,4,18,87
44447,68,53,2,0,13,55
44448,106,28,23,39,16,90
44449,73,30,24,3,16,57
44450,134,50,48,13,23,111
44451,23,12,2,2,7,16
44452,48,22,15,0,11,37
44453,99,43,34,0,22,77
44454,98,55,22,3,18,80
44455,50,21,8,11,10,40
44456,32,20,6,0,6,26
44457,46,26,9,4,7,39
44458,45,15,18,3,9,36
44459,14,3,8,0,3,11
44460,86,40,28,4,14,72
44461,0,0,0,0,0,0
44462,56,24,3,19,10,46
44463,18,10,5,0,3,15
44464,82,42,20,1,19,63
44465,68,28,14,15,11,57
44466,13,5,8,0,0,13
44467,66,33,13,3,17,49
44468,116,50,22,17,27,89
44469,28,17,3,2,6,22
44470,65,27,20,1,17,48
44471,127,50,34,17,26,101
44472,183,79,30,28,46,137
44473,52,31,5,0,16,36
44474,38,15,15,0,8,30
44475,30,14,11,0,5,25
44476,147,36,76,1,34,113
44477,24,2,18,0,4,20
44478,153,81,47,0,25,128
44479,51,36,8,0,7,44
44480,89,36,17,14,22,67
44481,135,46,47,19,23,112
44482,8,2,1,3,2,6
44483,520,251,107,57,105,415
44484,32,21,9,0,2,30
44485,50,19,19,1,11,39
44486,32,21,9,0,2,30
44487,23,2,19,0,2,21
44488,95,30,22,24,19,76
44489,56,17,25,0,14,42
44490,75,11,49,0,15,60
44491,38,25,5,7,1,37
44492,647,380,141,15,111,536
44493,42,24,7,2,9,33
44494,31,15,8,0,8,23
44495,104,36,25,24,19,85
44496,164,73,54,6,31,133
44497,15,2,9,1,3,12
44498,27,5,17,0,5,22
44499,9,3,2,0,4,5
44500,6,2,3,0,1,5
44501,275,89,126,15,45,230
44502,102,48,16,22,16,86
44503,38,12,21,1,4,34
44504,59,33,17,1,8,51
44505,94,23,52,2,17,77
44506,36,22,5,1,8,28
44507,3,0,1,0,2,1
44508,163,124,9,3,27,136
44509,6,4,0,1,1,5
44510,134,69,41,0,24,110
44511,175,64,49,21,41,134
44512,8,0,6,1,1,7
44513,134,32,72,1,29,105
44514,8,3,1,3,1,7
44515,112,60,20,10,22,90
44516,65,28,23,0,14,51
44517,53,35,5,2,11,42
44518,86,39,29,0,18,68
44519,43,15,17,3,8,35
44520,56,3,40,1,12,44
44521,71,28,27,0,16,55
44522,23,10,10,1,2,21
44523,53,31,7,2,13,40
44524,328,108,136,15,69,259
44525,32,21,9,0,2,30
44526,56,25,21,0,10,46
44527,34,16,7,3,8,26
44528,41,25,9,0,7,34
44529,65,8,46,0,11,54
44530,72,8,41,5,18,54
44531,18,1,13,0,4,14
44532,181,97,63,4,17,164
44533,16,10,2,0,4,12
44534,54,6,45,0,3,51
44535,211,45,127,0,39,172
44536,49,19,24,0,6,43
44537,124,47,47,0,30,94
44538,120,91,4,2,23,97
44539,56,33,9,2,12,44
44540,23,12,7,0,4,19
44541,8,6,0,1,1,7
44542,69,20,37,0,12,57
44543,120,44,30,14,32,88
44544,94,60,16,0,18,76
44545,82,13,40,8,21,61
44546,83,67,2,0,14,69
44547,46,18,18,0,10,36
44548,79,25,32,9,13,66
44549,188,63,85,0,40,148
44550,55,17,12,7,19,36
44551,48,23,20,0,5,43
44552,96,40,26,11,19,77
44553,9,2,3,0,4,5
44554,85,52,18,2,13,72
44555,95,25,55,1,14,81
44556,32,18,9,0,5,27
44557,517,230,126,45,116,401
44558,12,5,6,0,1,11
44559,155,55,39,29,32,123
44560,64,5,44,0,15,49
44561,15,5,5,3,2,13
44562,87,63,5,6,13,74
44563,58,17,15,14,12,46
44564,271,80,131,17,43,228
44565,26,8,13,1,4,22
44566,53,29,14,0,10,43
44567,477,232,95,49,101,376
44568,53,12,34,0,7,46
44569,11,6,2,1,2,9
44570,13,0,11,0,2,11
44571,32,12,14,0,6,26
44572,18,9,7,0,2,16
44573,73,34,29,0,10,63
44574,17,12,1,0,4,13
44575,68,23,19,16,10,58
44576,32,21,9,0,2,30
44577,21,14,1,1,5,16
44578,87,21,42,2,22,65
44579,198,78,37,32,51,147
44580,32,5,21,0,6,26
44581,36,11,15,0,10,26
44582,9,4,2,0,3,6
44583,136,11,76,18,31,105
44584,120,85,6,4,25,95
44585,413,192,120,12,89,324
44586,26,19,3,1,3,23
44587,38,22,8,0,8,30
44588,12,5,2,1,4,8
44589,284,69,46,121,48,236
44590,62,43,8,4,7,55
44591,164,10,90,30,34,130
44592,20,9,6,1,4,16
44593,11,8,2,0,1,10
44594,69,33,19,2,15,54
44595,83,35,25,3,20,63
44596,23,14,4,0,5,18
44597,45,21,15,1,8,37
44598,66,44,5,6,11,55
44599,32,21,9,0,2,30
44600,55,33,15,1,6,49
44601,49,33,6,4,6,43
44602,13,1,6,0,6,7
44603,14,3,8,0,3,11
44604,149,50,76,4,19,130
44605,203,88,57,20,38,165
44606,178,95,30,21,32,146
44607,132,49,54,12,17,115
44608,139,59,38,15,27,112
44609,25,8,13,0,4,21
44610,83,36,35,1,11,72
44611,43,22,2,11,8,35
44612,46,26,11,0,9,37
44613,146,116,1,2,27,119
44614,20,1,10,0,9,11
44615,638,354,160,22,102,536
44616,467,282,78,5,102,365
44617,157,90,32,0,35,122
44618,59,35,10,4,10,49
44619,545,377,50,1,117,428
44620,30,15,8,1,6,24
44621,16,8,4,0,4,12
44622,34,18,5,2,9,25
44623,102,28,48,8,18,84
44624,47,28,9,0,10,37
44625,17,13,0,0,4,13
44626,220,86,26,68,40,180
44627,294,111,127,2,54,240
44628,444,138,178,31,97,347
44629,341,145,120,6,70,271
44630,50,11,30,0,9,41
44631,59,38,12,0,9,50
44632,54,25,9,8,12,42
44633,266,116,89,17,44,222
44634,63,39,5,3,16,47
44635,200,88,54,20,38,162
44636,88,33,33,9,13,75
44637,36,7,24,0,5,31
44638,55,23,20,0,12,43
44639,198,138,45,2,13,185
44640,143,90,26,1,26,117
44641,177,73,41,20,43,134
44642,78,31,5,22,20,58
44643,40,1,23,12,4,36
44644,151,91,31,6,23,128
44645,106,45,43,1,17,89
44646,372,117,158,21,76,296
44647,80,54,12,0,14,66
44648,441,140,187,14,100,341
44649,5,1,1,1,2,3
44650,155,114,12,0,29,126
44651,62,12,30,3,17,45
44652,134,82,19,4,29,105
44653,84,36,37,1,10,74
44654,444,187,110,47,100,344
44655,45,14,21,0,10,35
44656,29,11,12,0,6,23
44657,22,13,3,3,3,19
44658,85,52,19,0,14,71
44659,104,71,12,1,20,84
44660,100,51,27,5,17,83
44661,53,28,10,1,14,39
44662,37,25,9,3,0,37
44663,241,130,56,14,41,200
44664,59,13,40,0,6,53
44665,70,46,7,1,16,54
44666,608,401,68,6,133,475
44667,142,106,7,0,29,113
44668,6,1,3,0,2,4
44669,61,19,24,5,13,48
44670,62,28,10,14,10,52
44671,90,48,27,1,14,76
44672,17,4,10,0,3,14
44673,33,11,13,0,9,24
44674,11,4,4,0,3,8
44675,346,181,92,14,59,287
44676,69,20,34,2,13,56
44677,57,14,31,0,12,45
44678,70,48,9,1,12,58
44679,20,6,0,7,7,13
44680,134,5,74,26,29,105
44681,23,9,10,0,4,19
44682,53,10,28,5,10,43
44683,70,29,5,21,15,55
44684,13,13,0,0,0,13
44685,92,71,7,1,13,79
44686,3,1,1,0,1,2
44687,22,4,13,0,5,17
44688,39,4,28,2,5,34
44689,172,48,40,47,37,135
44690,79,5,64,0,10,69
44691,68,42,13,3,10,58
44692,2,2,0,0,0,2
44693,52,21,3,19,9,43
44694,187,61,59,24,43,144
44695,53,32,5,0,16,37
44696,61,25,20,3,13,48
44697,106,25,38,25,18,88
44698,46,18,20,0,8,38
44699,4,3,1,0,0,4
44700,24,4,14,1,5,19
44701,588,406,54,1,127,461
44702,99,28,45,6,20,79
44703,22,5,13,0,4,18
44704,10,0,6,0,4,6
44705,193,48,19,95,31,162
44706,51,23,17,1,10,41
44707,336,172,111,0,53,283
44708,36,15,14,1,6,30
44709,27,14,2,4,7,20
44710,49,25,13,3,8,41
44711,18,9,3,0,6,12
44712,13,4,5,2,2,11
44713,193,88,47,20,38,155
44714,74,35,20,8,11,63
44715,16,6,7,0,3,13
44716,63,41,14,5,3,60
44717,384,182,75,49,78,306
44718,47,21,9,3,14,33
44719,14,7,4,0,3,11
44720,123,27,56,17,23,100
44721,33,9,16,0,8,25
44722,58,34,3,11,10,48
44723,285,28,201,2,54,231
44724,46,18,20,0,8,38
44725,27,15,2,3,7,20
44726,65,48,12,0,5,60
44727,22,10,8,0,4,18
44728,32,12,2,14,4,28
44729,42,13,15,7,7,35
44730,58,33,11,2,12,46
44731,115,46,27,18,24,91
44732,174,123,15,2,34,140
44733,76,30,36,1,9,67
44734,71,38,23,2,8,63
44735,123,43,54,5,21,102
44736,82,36,24,0,22,60
44737,47,27,10,0,10,37
44738,100,48,14,23,15,85
44739,25,3,17,1,4,21
44740,50,33,5,1,11,39
44741,179,92,53,0,34,145
44742,50,8,35,0,7,43
44743,38,7,24,1,6,32
44744,45,8,26,2,9,36
44745,133,79,30,0,24,109
44746,105,54,26,3,22,83
44747,40,6,23,3,8,32
44748,252,103,90,16,43,209
44749,16,5,8,1,2,14
44750,208,127,13,25,43,165
44751,111,46,14,17,34,77
44752,36,13,15,0,8,28
44753,256,119,89,4,44,212
44754,399,192,110,13,84,315
44755,15,3,6,1,5,10
44756,190,59,100,4,27,163
44757,31,0,11,15,5,26
44758,173,118,16,0,39,134
44759,100,37,42,8,13,87
44760,663,381,136,20,126,537
44761,37,25,7,2,3,34
44762,35,12,13,0,10,25
44763,15,2,9,0,4,11
44764,60,27,23,0,10,50
44765,153,55,37,29,32,121
44766,273,115,104,2,52,221
44767,46,18,20,0,8,38
44768,71,40,17,0,14,57
44769,37,6,10,16,5,32
44770,37,23,5,1,8,29
44771,15,8,1,5,1,14
44772,271,17,201,0,53,218
44773,59,10,22,16,11,48
44774,32,15,13,1,3,29
44775,43,15,18,2,8,35
44776,136,61,40,11,24,112
44777,77,31,27,2,17,60
44778,45,11,20,4,10,35
44779,34,15,12,1,6,28
44780,135,31,64,4,36,99
44781,64,34,11,0,19,45
44782,26,11,7,4,4,22
44783,24,10,10,0,4,20
44784,37,14,21,0,2,35
44785,26,8,12,0,6,20
44786,10,2,5,0,3,7
44787,41,19,10,3,9,32
44788,63,38,14,1,10,53
44789,78,37,22,3,16,62
44790,8,4,1,1,2,6
44791,46,8,30,0,8,38
44792,180,80,60,4,36,144
44793,17,0,12,0,5,12
44794,142,105,9,0,28,114
44795,62,33,15,0,14,48
44796,44,14,19,4,7,37
44797,3,0,3,0,0,3
44798,162,118,9,4,31,131
44799,103,93,1,9,0,103
44800,86,36,35,2,13,73
44801,54,23,20,1,10,44
44802,60,30,11,2,17,43
44803,57,40,3,0,14,43
44804,46,19,10,8,9,37
44805,51,30,11,0,10,41
44806,18,3,7,0,8,10
44807,25,14,7,2,2,23
44808,31,14,8,0,9,22
44809,22,7,4,4,7,15
44810,48,11,19,6,12,36
44811,51,29,14,0,8,43
44812,3,2,1,0,0,3
44813,32,21,9,0,2,30
44814,177,45,83,5,44,133
44815,99,64,23,0,12,87
44816,80,16,56,2,6,74
44817,320,141,119,5,55,265
44818,123,74,27,1,21,102
44819,71,41,15,1,14,57
44820,205,54,23,95,33,172
44821,204,113,29,23,39,165
44822,84,35,5,31,13,71
44823,64,37,18,0,9,55
44824,440,151,149,47,93,347
44825,548,306,117,13,112,436
44826,14,6,4,0,4,10
44827,65,44,2,2,17,48
44828,19,9,5,1,4,15
44829,30,13,10,3,4,26
44830,35,10,16,1,8,27
44831,281,135,92,4,50,231
44832,63,34,7,9,13,50
44833,26,8,9,3,6,20
44834,66,48,2,0,16,50
44835,41,14,20,0,7,34
44836,83,37,26,2,18,65
44837,42,34,2,0,6,36
44838,369,101,172,8,88,281
44839,50,11,30,0,9,41
44840,78,49,14,0,15,63
44841,21,13,4,0,4,17
44842,268,113,106,4,45,223
44843,227,52,33,103,39,188
44844,42,14,18,4,6,36
44845,175,116,11,10,38,137
44846,297,61,158,6,72,225
44847,88,46,11,2,29,59
44848,254,193,15,0,46,208
44849,99,68,11,2,18,81
44850,49,23,17,2,7,42
44851,92,63,13,0,16,76
44852,39,28,6,0,5,34
44853,77,17,41,1,18,59
44854,35,18,10,0,7,28
44855,319,243,18,0,58,261
44856,53,42,1,0,10,43
44857,30,16,6,3,5,25
44858,491,247,90,51,103,388
44859,47,23,15,0,9,38
44860,65,23,3,27,12,53
44861,32,21,9,0,2,30
44862,80,41,30,2,7,73
44863,25,0,18,0,7,18
44864,470,328,41,1,100,370
44865,27,19,0,0,8,19
44866,37,18,9,1,9,28
44867,95,59,12,2,22,73
44868,173,52,57,26,38,135
44869,93,49,28,3,13,80
44870,27,7,10,2,8,19
44871,5,1,2,1,1,4
44872,93,50,25,4,14,79
44873,97,61,23,8,5,92
44874,36,9,20,0,7,29
44875,51,3,40,0,8,43
44876,165,54,56,24,31,134
44877,50,23,16,3,8,42
44878,297,154,98,0,45,252
44879,146,62,33,18,33,113
44880,12,3,5,0,4,8
44881,55,23,18,5,9,46
44882,142,87,27,0,28,114
44883,207,71,90,2,44,163
44884,60,21,24,8,7,53
44885,65,24,18,12,11,54
44886,71,7,46,5,13,58
44887,332,138,119,6,69,263
44888,39,12,3,16,8,31
44889,56,38,11,0,7,49
44890,46,18,20,0,8,38
44891,33,3,6,16,8,25
44892,421,217,98,24,82,339
44893,32,21,9,0,2,30
44894,9,5,1,0,3,6
44895,167,71,37,25,34,133
44896,75,42,4,12,17,58
44897,35,6,22,1,6,29
44898,79,60,4,1,14,65
44899,7,3,2,1,1,6
44900,122,90,5,1,26,96
44901,10,2,6,0,2,8
44902,23,13,5,0,5,18
44903,458,313,46,1,98,360
44904,37,22,6,1,8,29
44905,32,21,9,0,2,30
44906,101,24,41,13,23,78
44907,192,77,43,29,43,149
44908,12,5,3,0,4,8
44909,115,9,76,8,22,93
44910,56,2,41,1,12,44
44911,128,100,8,2,18,110
44912,163,96,33,4,30,133
44913,94,52,15,0,27,67
44914,3,3,0,0,0,3
44915,502,350,43,1,108,394
44916,54,20,19,3,12,42
44917,131,82,36,0,13,118
44918,256,62,28,124,42,214
44919,36,14,12,1,9,27
44920,69,46,9,2,12,57
44921,18,7,6,0,5,13
44922,359,268,19,2,70,289
44923,14,3,4,1,6,8
44924,183,17,129,2,35,148
44925,496,268,112,17,99,397
44926,86,31,32,7,16,70
44927,25,14,7,0,4,21
44928,50,29,11,0,10,40
44929,59,36,13,3,7,52
44930,1,0,1,0,0,1
44931,21,0,14,0,7,14
44932,151,46,46,23,36,115
44933,156,119,7,0,30,126
44934,302,59,185,1,57,245
44935,110,42,33,4,31,79
44936,441,147,153,48,93,348
44937,71,38,7,9,17,54
44938,82,65,5,1,11,71
44939,59,41,9,0,9,50
44940,209,138,23,0,48,161
44941,196,38,54,64,40,156
44942,46,35,6,0,5,41
44943,35,17,13,0,5,30
44944,66,52,0,0,14,52
44945,88,40,32,0,16,72
44946,309,159,82,15,53,256
44947,178,101,32,0,45,133
44948,119,45,41,13,20,99
44949,39,6,12,10,11,28
44950,25,15,6,0,4,21
44951,228,56,32,102,38,190
44952,11,7,1,2,1,10
44953,32,21,9,0,2,30
44954,116,66,29,10,11,105
44955,66,43,7,1,15,51
44956,34,13,17,1,3,31
44957,108,75,8,6,19,89
44958,111,89,7,2,13,98
44959,12,0,10,0,2,10
44960,15,5,6,2,2,13
44961,46,18,20,0,8,38
44962,25,13,7,0,5,20
44963,54,12,29,3,10,44
44964,11,8,2,0,1,10
44965,74,37,20,9,8,66
44966,49,18,25,0,6,43
44967,11,6,3,0,2,9
44968,64,41,5,0,18,46
44969,78,13,41,7,17,61
44970,58,35,3,10,10,48
44971,23,12,7,0,4,19
44972,344,147,120,6,71,273
44973,49,26,8,8,7,42
44974,186,146,6,0,34,152
44975,8,4,1,1,2,6
44976,112,49,33,0,30,82
44977,8,5,2,1,0,8
44978,15,8,1,6,0,15
44979,26,19,3,1,3,23
44980,48,20,16,0,12,36
44981,69,18,34,4,13,56
44982,33,20,5,1,7,26
44983,60,28,21,4,7,53
44984,39,5,26,0,8,31
44985,62,11,37,0,14,48
44986,194,48,103,11,32,162
44987,122,45,17,38,22,100
44988,59,14,27,2,16,43
44989,56,38,9,0,9,47
44990,77,39,19,0,19,58
44991,228,141,5,31,51,177
44992,213,52,31,93,37,176
44993,23,10,5,2,6,17
44994,26,12,11,1,2,24
44995,59,34,7,0,18,41
44996,53,36,3,1,13,40
44997,45,15,15,3,12,33
44998,42,19,9,6,8,34
44999,110,65,22,0,23,87
45000,240,128,70,0,42,198
45001,95,48,14,2,31,64
45002,276,145,95,0,36,240
45003,638,382,125,18,113,525
45004,23,5,10,0,8,15
45005,7,3,0,0,4,3
45006,51,33,4,6,8,43
45007,126,38,68,1,19,107
45008,58,32,10,4,12,46
45009,28,6,19,0,3,25
45010,6,0,5,0,1,5
45011,404,229,93,0,82,322
45012,102,35,41,8,18,84
45013,22,7,8,0,7,15
45014,40,25,7,3,5,35
45015,103,50,13,11,29,74
45016,46,18,20,0,8,38
45017,14,2,10,0,2,12
45018,34,15,14,1,4,30
45019,29,6,17,2,4,25
45020,45,8,28,0,9,36
45021,32,21,9,0,2,30
45022,69,26,5,22,16,53
45023,24,4,17,0,3,21
45024,28,7,16,0,5,23
45025,37,26,5,0,6,31
45026,98,76,2,0,20,78
45027,121,79,29,0,13,108
45028,347,148,122,6,71,276
45029,237,56,72,56,53,184
45030,54,16,30,0,8,46
45031,5,4,1,0,0,5
45032,149,88,27,0,34,115
45033,32,21,9,0,2,30
45034,63,32,7,5,19,44
45035,75,12,48,0,15,60
45036,23,6,11,1,5,18
45037,12,1,6,0,5,7
45038,97,50,29,1,17,80
45039,8,4,1,0,3,5
45040,32,13,7,6,6,26
45041,21,6,1,7,7,14
45042,46,18,20,0,8,38
45043,35,17,9,0,9,26
45044,122,47,45,0,30,92
45045,41,17,13,0,11,30
45046,100,86,3,0,11,89
45047,70,35,18,3,14,56
45048,29,22,1,0,6,23
45049,158,61,68,8,21,137
45050,7,2,2,0,3,4
45051,17,9,0,3,5,12
45052,32,16,9,1,6,26
45053,79,23,37,2,17,62
45054,74,47,17,0,10,64
45055,91,39,8,25,19,72
45056,63,11,37,0,15,48
45057,279,98,125,14,42,237
45058,144,50,37,30,27,117
45059,28,1,7,14,6,22
45060,404,236,84,16,68,336
45061,42,7,24,2,9,33
45062,131,70,30,0,31,100
45063,119,47,40,7,25,94
45064,8,2,2,0,4,4
45065,3,0,3,0,0,3
45066,200,53,40,67,40,160
45067,172,118,22,0,32,140
45068,334,140,124,10,60,274
45069,112,50,32,0,30,82
45070,98,33,39,5,21,77
45071,18,1,13,0,4,14
45072,17,5,11,0,1,16
45073,417,196,142,7,72,345
45074,92,30,28,13,21,71
45075,245,128,76,0,41,204
45076,19,5,12,1,1,18
45077,25,2,15,5,3,22
45078,46,18,20,0,8,38
45079,24,16,5,0,3,21
45080,37,22,5,2,8,29
45081,195,104,51,9,31,164
45082,0,0,0,0,0,0
45083,9,0,8,0,1,8
45084,184,105,21,23,35,149
45085,37,14,16,1,6,31
45086,157,57,68,0,32,125
45087,58,15,30,0,13,45
45088,98,34,41,10,13,85
45089,236,154,22,3,57,179
45090,87,51,14,5,17,70
45091,72,19,30,2,21,51
45092,154,49,51,23,31,123
45093,20,6,10,1,3,17
45094,79,42,8,18,11,68
45095,194,61,80,14,39,155
45096,32,21,9,0,2,30
45097,4,1,1,1,1,3
45098,266,137,92,0,37,229
45099,87,47,18,0,22,65
45100,147,63,51,7,26,121
45101,130,70,26,5,29,101
45102,245,102,14,83,46,199
45103,92,66,7,0,19,73
45104,10,5,3,0,2,8
45105,435,245,86,9,95,340
45106,210,143,24,0,43,167
45107,65,9,24,15,17,48
45108,65,26,29,0,10,55
45109,61,24,9,17,11,50
45110,60,17,25,3,15,45
45111,75,46,15,0,14,61
45112,65,33,11,5,16,49
45113,107,22,51,14,20,87
45114,12,0,9,0,3,9
45115,41,21,10,2,8,33
45116,95,72,10,0,13,82
45117,64,41,13,1,9,55
45118,122,74,24,0,24,98
45119,62,43,8,4,7,55
45120,57,10,29,4,14,43
45121,240,106,75,16,43,197
45122,26,5,16,0,5,21
45123,33,6,19,0,8,25
45124,194,76,34,34,50,144
45125,49,30,11,1,7,42
45126,202,87,58,19,38,164
45127,14,6,1,5,2,12
45128,385,219,87,0,79,306
45129,257,126,65,15,51,206
45130,32,21,9,0,2,30
45131,3,0,3,0,0,3
45132,21,5,10,0,6,15
45133,69,15,27,17,10,59
45134,133,68,15,21,29,104
45135,85,55,11,1,18,67
45136,55,24,13,6,12,43
45137,59,19,15,13,12,47
45138,43,28,1,0,14,29
45139,186,50,17,92,27,159
45140,12,6,3,0,3,9
45141,133,90,18,1,24,109
45142,25,16,3,0,6,19
45143,122,32,65,0,25,97
45144,27,9,10,1,7,20
45145,287,135,75,20,57,230
45146,148,22,93,3,30,118
45147,76,53,2,0,21,55
45148,23,8,7,4,4,19
45149,16,1,6,1,8,8
45150,26,5,14,1,6,20
45151,112,25,41,25,21,91
45152,41,24,7,1,9,32
45153,17,0,12,0,5,12
45154,124,75,26,0,23,101
45155,91,37,24,10,20,71
45156,139,81,13,18,27,112
45157,19,9,3,0,7,12
45158,40,27,8,0,5,35
45159,110,37,43,11,19,91
45160,137,37,68,1,31,106
45161,41,10,26,0,5,36
45162,25,17,6,2,0,25
45163,95,54,26,1,14,81
45164,216,89,14,76,37,179
45165,58,28,12,5,13,45
45166,551,302,120,13,116,435
45167,68,48,2,0,18,50
45168,210,146,48,3,13,197
45169,13,5,6,0,2,11
45170,433,204,148,6,75,358
45171,55,25,18,0,12,43
45172,32,8,18,1,5,27
45173,79,44,15,0,20,59
45174,7,4,0,1,2,5
45175,124,46,47,0,31,93
45176,106,46,19,17,24,82
45177,39,29,2,0,8,31
45178,140,40,65,4,31,109
45179,53,20,14,5,14,39
45180,133,99,6,0,28,105
45181,50,30,16,0,4,46
45182,151,64,55,1,31,120
45183,45,27,12,1,5,40
45184,79,22,41,2,14,65
45185,94,56,19,5,14,80
45186,210,52,40,81,37,173
45187,34,7,18,0,9,25
45188,24,7,13,0,4,20
45189,323,161,92,5,65,258
45190,22,9,6,0,7,15
45191,158,68,56,1,33,125
45192,45,24,10,0,11,34
45193,46,18,20,0,8,38
45194,46,18,20,0,8,38
45195,55,41,7,0,7,48
45196,42,17,19,1,5,37
45197,86,40,22,1,23,63
45198,87,44,24,2,17,70
45199,58,43,3,3,9,49
45200,159,91,19,20,29,130
45201,31,11,13,0,7,24
45202,119,63,15,13,28,91
45203,61,33,21,0,7,54
45204,491,268,96,32,95,396
45205,20,9,6,3,2,18
45206,80,36,24,0,20,60
45207,32,9,10,6,7,25
45208,72,45,16,0,11,61
45209,84,26,40,6,12,72
45210,244,184,9,1,50,194
45211,346,151,121,6,68,278
45212,192,88,46,20,38,154
45213,131,71,23,3,34,97
45214,39,2,30,0,7,32
45215,21,8,9,2,2,19
45216,9,1,5,1,2,7
45217,40,9,15,10,6,34
45218,61,31,14,4,12,49
45219,84,21,46,3,14,70
45220,34,14,12,0,8,26
45221,22,1,12,1,8,14
45222,80,52,19,6,3,77
45223,47,29,8,1,9,38
45224,63,28,22,0,13,50
45225,3,0,3,0,0,3
45226,98,57,25,2,14,84
45227,40,20,11,1,8,32
45228,37,8,19,1,9,28
45229,652,377,149,18,108,544
45230,111,42,29,17,23,88
45231,436,118,178,44,96,340
45232,59,33,17,2,7,52
45233,22,4,17,0,1,21
45234,37,19,8,1,9,28
45235,126,75,20,3,28,98
45236,37,13,20,0,4,33
45237,18,8,6,0,4,14
45238,151,45,38,38,30,121
45239,118,51,50,3,14,104
45240,244,182,11,2,49,195
45241,94,65,20,0,9,85
45242,67,37,16,1,13,54
45243,33,6,23,1,3,30
45244,139,103,5,2,29,110
45245,49,19,24,0,6,43
45246,39,17,3,14,5,34
45247,23,5,8,3,7,16
45248,121,29,58,3,31,90
45249,27,16,6,0,5,22
45250,432,133,191,12,96,336
45251,73,8,52,3,10,63
45252,21,15,3,1,2,19
45253,27,8,14,0,5,22
45254,69,37,14,0,18,51
45255,105,51,40,2,12,93
45256,130,44,49,11,26,104
45257,126,28,40,22,36,90
45258,6,2,4,0,0,6
45259,44,33,1,0,10,34
45260,297,216,13,0,68,229
45261,75,9,42,5,19,56
45262,130,49,37,11,33,97
45263,55,33,14,2,6,49
45264,53,22,21,0,10,43
45265,157,8,93,26,30,127
45266,28,9,6,9,4,24
45267,63,37,17,3,6,57
45268,35,22,8,0,5,30
45269,118,58,21,16,23,95
45270,58,21,21,5,11,47
45271,376,204,75,7,90,286
45272,160,72,52,5,31,129
45273,62,29,21,3,9,53
45274,35,18,9,2,6,29
45275,30,2,22,2,4,26
45276,89,57,15,2,15,74
45277,143,61,31,17,34,109
45278,20,0,15,2,3,17
45279,15,2,12,0,1,14
45280,87,35,16,15,21,66
45281,107,101,0,6,0,107
45282,131,61,37,11,22,109
45283,67,23,13,20,11,56
45284,59,36,14,0,9,50
45285,122,92,4,2,24,98
45286,35,18,10,0,7,28
45287,32,10,15,1,6,26
45288,43,28,6,0,9,34
45289,17,5,7,0,5,12
45290,97,64,7,10,16,81
45291,50,34,1,2,13,37
45292,32,21,9,0,2,30
45293,77,42,22,0,13,64
45294,32,5,23,1,3,29
45295,144,107,9,0,28,116
45296,156,90,28,1,37,119
45297,32,21,9,0,2,30
45298,110,33,56,0,21,89
45299,144,80,26,1,37,107
45300,68,28,24,1,15,53
45301,268,191,28,1,48,220
45302,30,19,3,1,7,23
45303,139,79,21,2,37,102
45304,46,18,20,0,8,38
45305,59,16,24,10,9,50
45306,3,3,0,0,0,3
45307,84,43,20,1,20,64
45308,441,231,113,20,77,364
45309,64,41,11,1,11,53
45310,107,32,55,0,20,87
45311,28,13,11,0,4,24
45312,39,24,3,7,5,34
45313,209,89,61,20,39,170
45314,220,149,30,0,41,179
45315,69,33,24,1,11,58
45316,271,18,201,0,52,219
45317,110,32,53,7,18,92
45318,377,191,96,11,79,298
45319,149,96,28,1,24,125
45320,35,22,4,3,6,29
45321,17,6,7,1,3,14
45322,38,10,15,6,7,31
45323,8,2,3,0,3,5
45324,39,18,9,1,11,28
45325,49,19,24,0,6,43
45326,202,44,34,87,37,165
45327,59,30,15,4,10,49
45328,92,37,34,1,20,72
45329,71,19,40,0,12,59
45330,65,29,19,2,15,50
45331,65,32,19,1,13,52
45332,24,11,7,0,6,18
45333,47,13,25,1,8,39
45334,17,5,5,1,6,11
45335,45,18,13,1,13,32
45336,490,255,114,17,104,386
45337,49,15,11,17,6,43
45338,80,30,32,7,11,69
45339,203,136,48,4,15,188
45340,38,5,25,0,8,30
45341,2,1,0,0,1,1
45342,94,21,53,2,18,76
45343,21,6,6,1,8,13
45344,91,40,35,0,16,75
45345,37,20,7,3,7,30
45346,117,53,47,3,14,103
45347,32,13,11,1,7,25
45348,154,33,94,0,27,127
45349,228,88,25,73,42,186
45350,110,85,8,0,17,93
45351,104,90,3,0,11,93
45352,279,143,83,0,53,226
45353,81,52,12,0,17,64
45354,31,6,13,5,7,24
45355,49,25,12,0,12,37
45356,37,22,6,1,8,29
45357,2,1,1,0,0,2
45358,22,12,6,0,4,18
45359,14,5,4,0,5,9
45360,128,92,5,2,29,99
45361,30,4,20,1,5,25
45362,19,8,6,0,5,14
45363,340,173,103,3,61,279
45364,118,45,40,11,22,96
45365,31,10,11,0,10,21
45366,55,38,6,1,10,45
45367,94,47,18,4,25,69
45368,118,52,46,1,19,99
45369,3,2,0,1,0,3
45370,28,16,7,0,5,23
45371,42,35,4,0,3,39
45372,496,310,69,7,110,386
45373,201,101,51,0,49,152
45374,41,3,29,2,7,34
45375,104,37,5,48,14,90
45376,89,51,13,0,25,64
45377,44,33,3,2,6,38
45378,34,20,6,0,8,26
45379,114,45,34,10,25,89
45380,35,13,16,0,6,29
45381,383,253,41,1,88,295
45382,5,3,1,0,1,4
45383,84,48,18,0,18,66
45384,26,12,9,0,5,21
45385,61,21,32,0,8,53
45386,51,20,22,0,9,42
45387,107,40,30,13,24,83
45388,44,19,17,0,8,36
45389,177,85,34,25,33,144
45390,39,15,21,1,2,37
45391,16,5,4,1,6,10
45392,105,65,24,7,9,96
45393,203,13,151,0,39,164
45394,357,164,90,30,73,284
45395,124,46,31,19,28,96
45396,39,15,15,0,9,30
45397,43,6,28,5,4,39
45398,45,17,19,0,9,36
45399,77,24,31,9,13,64
45400,55,27,20,0,8,47
45401,21,9,6,5,1,20
45402,79,39,25,1,14,65
45403,78,27,25,14,12,66
45404,80,46,16,2,16,64
45405,11,4,4,1,2,9
45406,140,51,62,4,23,117
45407,216,51,124,2,39,177
45408,12,4,6,0,2,10
45409,226,131,22,26,47,179
45410,157,67,34,23,33,124
45411,45,19,12,8,6,39
45412,19,9,6,0,4,15
45413,378,193,119,0,66,312
45414,32,4,24,0,4,28
45415,26,16,6,0,4,22
45416,38,18,15,0,5,33
45417,32,21,9,0,2,30
45418,32,21,9,0,2,30
45419,11,4,4,0,3,8
45420,46,20,10,7,9,37
45421,393,226,88,0,79,314
45422,46,29,2,9,6,40
45423,30,12,15,0,3,27
45424,50,16,27,0,7,43
45425,141,68,37,0,36,105
45426,60,6,38,2,14,46
45427,7,5,2,0,0,7
45428,12,1,8,0,3,9
45429,69,40,13,0,16,53
45430,62,21,31,1,9,53
45431,25,15,5,0,5,20
45432,40,6,5,19,10,30
45433,42,34,1,0,7,35
45434,71,24,20,6,21,50
45435,115,76,23,3,13,102
45436,46,18,20,0,8,38
45437,34,5,22,0,7,27
45438,17,12,2,0,3,14
45439,84,36,20,5,23,61
45440,155,74,49,1,31,124
45441,39,21,9,1,8,31
45442,88,41,25,3,19,69
45443,15,2,7,0,6,9
45444,35,6,25,1,3,32
45445,294,134,106,5,49,245
45446,28,11,10,0,7,21
45447,89,37,23,10,19,70
45448,58,32,16,0,10,48
45449,32,21,9,0,2,30
45450,156,25,101,0,30,126
45451,63,27,29,0,7,56
45452,46,13,11,12,10,36
45453,61,25,18,0,18,43
45454,29,10,3,6,10,19
45455,31,12,12,1,6,25
45456,295,125,106,10,54,241
45457,355,153,127,6,69,286
45458,37,20,9,0,8,29
45459,40,18,8,2,12,28
45460,60,32,13,1,14,46
45461,41,6,29,0,6,35
45462,95,24,55,2,14,81
45463,476,266,101,13,96,380
45464,32,21,9,0,2,30
45465,225,148,21,3,53,172
45466,229,159,14,2,54,175
45467,145,21,70,20,34,111
45468,68,40,16,0,12,56
45469,11,7,0,0,4,7
45470,116,78,11,3,24,92
45471,171,113,27,1,30,141
45472,72,47,12,2,11,61
45473,5,0,4,0,1,4
45474,393,143,122,41,87,306
45475,8,5,3,0,0,8
45476,11,5,4,0,2,9
45477,48,33,3,3,9,39
45478,251,177,25,4,45,206
45479,121,45,35,15,26,95
45480,310,142,98,6,64,246
45481,5,5,0,0,0,5
45482,53,38,4,0,11,42
45483,33,5,22,0,6,27
45484,42,10,20,2,10,32
45485,72,44,12,2,14,58
45486,24,8,3,3,10,14
45487,49,35,5,1,8,41
45488,133,38,71,0,24,109
45489,20,12,5,1,2,18
45490,24,10,8,0,6,18
45491,36,20,4,3,9,27
45492,61,27,21,1,12,49
45493,38,7,10,16,5,33
45494,101,67,1,11,22,79
45495,307,140,100,12,55,252
45496,40,8,19,5,8,32
45497,33,24,5,0,4,29
45498,71,19,27,13,12,59
45499,53,14,30,0,9,44
45500,188,144,17,1,26,162
45501,215,51,31,96,37,178
45502,95,26,54,2,13,82
45503,57,34,9,4,10,47
45504,657,385,136,19,117,540
45505,19,13,2,0,4,15
45506,16,11,3,0,2,14
45507,212,113,48,0,51,161
45508,69,20,36,0,13,56
45509,33,1,25,0,7,26
45510,34,26,6,2,0,34
45511,81,40,25,1,15,66
45512,38,29,4,0,5,33
45513,21,7,7,1,6,15
45514,7,2,4,0,1,6
45515,68,47,8,3,10,58
45516,55,32,15,0,8,47
45517,143,61,32,16,34,109
45518,42,20,17,0,5,37
45519,111,96,3,0,12,99
45520,80,55,9,3,13,67
45521,32,21,9,0,2,30
45522,44,27,12,0,5,39
45523,47,21,9,7,10,37
45524,50,18,15,1,16,34
45525,28,13,10,0,5,23
45526,131,28,67,1,35,96
45527,24,3,10,5,6,18
45528,168,60,74,0,34,134
45529,78,53,13,0,12,66
45530,116,24,46,17,29,87
45531,224,100,72,0,52,172
45532,3,1,1,0,1,2
45533,83,36,33,0,14,69
45534,66,16,3,31,16,50
45535,266,18,198,0,50,216
45536,185,132,13,1,39,146
45537,39,28,3,2,6,33
45538,71,36,14,5,16,55
45539,58,21,22,1,14,44
45540,200,145,9,9,37,163
45541,2,0,0,0,2,0
45542,32,17,9,0,6,26
45543,10,3,4,0,3,7
45544,79,39,21,7,12,67
45545,580,411,46,1,122,458
45546,29,7,16,0,6,23
45547,46,18,20,0,8,38
45548,85,55,15,0,15,70
45549,164,125,5,2,32,132
45550,35,8,19,0,8,27
45551,26,11,6,0,9,17
45552,66,17,33,1,15,51
45553,6,0,5,0,1,5
45554,102,27,48,8,19,83
45555,199,85,56,20,38,161
45556,75,4,52,1,18,57
45557,22,6,8,2,6,16
45558,46,4,28,1,13,33
45559,34,3,22,2,7,27
45560,32,21,9,0,2,30
45561,11,1,10,0,0,11
45562,16,5,8,2,1,15
45563,38,14,17,1,6,32
45564,40,29,1,0,10,30
45565,30,12,10,2,6,24
45566,62,18,33,1,10,52
45567,77,36,22,1,18,59
45568,32,21,9,0,2,30
45569,190,145,18,0,27,163
45570,12,8,0,0,4,8
45571,87,38,23,2,24,63
45572,102,53,28,0,21,81
45573,39,27,5,2,5,34
45574,79,36,29,4,10,69
45575,99,36,34,9,20,79
45576,213,73,100,4,36,177
45577,53,26,3,14,10,43
45578,6,3,3,0,0,6
45579,115,67,17,5,26,89
45580,167,41,88,3,35,132
45581,35,10,20,0,5,30
45582,132,70,40,0,22,110
45583,31,11,15,1,4,27
45584,194,104,33,21,36,158
45585,428,203,114,20,91,337
45586,593,407,55,1,130,463
45587,164,66,40,26,32,132
45588,34,10,18,5,1,33
45589,61,14,22,2,23,38
45590,25,1,20,1,3,22
45591,39,19,11,0,9,30
45592,9,4,4,1,0,9
45593,32,19,9,0,4,28
45594,43,7,26,3,7,36
45595,91,13,43,16,19,72
45596,427,242,98,0,87,340
45597,56,20,20,3,13,43
45598,120,45,28,19,28,92
45599,515,258,97,53,107,408
45600,99,39,15,22,23,76
45601,637,416,77,6,138,499
45602,160,97,40,13,10,150
45603,140,49,55,0,36,104
45604,6,4,2,0,0,6
45605,38,5,28,0,5,33
45606,336,197,57,12,70,266
45607,11,0,10,0,1,10
45608,67,23,27,1,16,51
45609,135,47,46,19,23,112
45610,59,34,16,2,7,52
45611,88,38,8,26,16,72
45612,67,19,31,9,8,59
45613,180,63,67,18,32,148
45614,81,29,34,4,14,67
45615,88,46,23,1,18,70
45616,467,219,152,12,84,383
45617,21,13,4,1,3,18
45618,87,29,28,12,18,69
45619,85,38,29,4,14,71
45620,18,0,13,0,5,13
45621,309,167,72,0,70,239
45622,201,79,11,73,38,163
45623,15,7,5,2,1,14
45624,435,320,20,0,95,340
45625,98,43,33,4,18,80
45626,89,61,6,2,20,69
45627,26,12,2,4,8,18
45628,82,47,16,1,18,64
45629,33,22,6,1,4,29
45630,46,18,20,0,8,38
45631,72,33,14,6,19,53
45632,135,51,50,12,22,113
45633,193,105,24,25,39,154
45634,76,47,9,4,16,60
45635,99,47,14,23,15,84
45636,98,38,34,10,16,82
45637,253,139,57,14,43,210
45638,8,0,5,0,3,5
45639,129,44,48,12,25,104
45640,178,101,32,0,45,133
45641,164,108,11,8,37,127
45642,32,21,9,0,2,30
45643,73,43,17,0,13,60
45644,18,3,8,0,7,11
45645,72,38,18,0,16,56
45646,34,14,9,6,5,29
45647,22,5,15,0,2,20
45648,2,0,2,0,0,2
45649,49,28,11,4,6,43
45650,27,17,4,3,3,24
45651,26,14,7,0,5,21
45652,46,18,20,0,8,38
45653,72,36,20,3,13,59
45654,90,25,41,6,18,72
45655,10,2,3,0,5,5
45656,32,7,14,3,8,24
45657,73,50,9,0,14,59
45658,15,4,6,1,4,11
45659,25,12,4,6,3,22
45660,61,34,3,14,10,51
45661,512,273,84,49,106,406
45662,115,78,24,0,13,102
45663,84,52,9,4,19,65
45664,37,16,10,4,7,30
45665,40,14,13,3,10,30
45666,8,4,1,1,2,6
45667,35,22,2,0,11,24
45668,99,44,8,22,25,74
45669,79,30,27,2,20,59
45670,161,115,11,0,35,126
45671,160,111,23,0,26,134
45672,15,3,8,1,3,12
45673,291,125,101,10,55,236
45674,3,0,1,0,2,1
45675,48,31,1,4,12,36
45676,298,69,171,4,54,244
45677,9,1,7,0,1,8
45678,42,22,12,3,5,37
45679,56,37,12,0,7,49
45680,91,47,12,2,30,61
45681,156,25,100,1,30,126
45682,157,100,3,17,37,120
45683,215,117,33,20,45,170
45684,9,3,4,0,2,7
45685,427,315,20,0,92,335
45686,97,51,13,17,16,81
45687,95,47,15,2,31,64
45688,71,29,27,6,9,62
45689,54,14,26,9,5,49
45690,3,1,2,0,0,3
45691,274,23,198,2,51,223
45692,315,193,53,0,69,246
45693,73,15,35,2,21,52
45694,56,15,32,0,9,47
45695,167,83,48,1,35,132
45696,33,21,6,2,4,29
45697,145,82,25,11,27,118
45698,40,2,29,0,9,31
45699,103,32,36,14,21,82
45700,220,73,82,15,50,170
45701,89,19,53,0,17,72
45702,71,49,5,6,11,60
45703,27,3,15,2,7,20
45704,40,32,2,0,6,34
45705,107,44,22,17,24,83
45706,347,150,123,6,68,279
45707,21,1,14,0,6,15
45708,89,59,11,10,9,80
45709,55,37,10,0,8,47
45710,518,263,96,49,110,408
45711,48,31,8,1,8,40
45712,63,41,16,4,2,61
45713,23,8,9,1,5,18
45714,97,63,16,0,18,79
45715,204,134,23,0,47,157
45716,28,17,4,0,7,21
45717,286,161,59,12,54,232
45718,26,8,12,0,6,20
45719,55,24,21,0,10,45
45720,10,4,2,0,4,6
45721,76,25,25,13,13,63
45722,56,36,13,0,7,49
45723,78,24,36,3,15,63
45724,78,35,26,5,12,66
45725,150,73,20,24,33,117
45726,42,18,13,5,6,36
45727,10,5,0,2,3,7
45728,53,16,30,0,7,46
45729,65,42,7,1,15,50
45730,209,33,94,33,49,160
45731,50,28,12,3,7,43
45732,94,35,38,9,12,82
45733,32,21,9,0,2,30
45734,8,6,2,0,0,8
45735,12,7,1,2,2,10
45736,642,367,151,19,105,537
45737,198,90,38,23,47,151
45738,61,35,14,0,12,49
45739,35,26,2,0,7,28
45740,72,31,21,0,20,52
45741,166,50,54,25,37,129
45742,353,185,93,15,60,293
45743,40,21,10,1,8,32
45744,121,34,63,0,24,97
45745,190,109,24,22,35,155
45746,129,110,2,0,17,112
45747,422,311,23,1,87,335
45748,211,45,55,70,41,170
45749,73,45,18,0,10,63
45750,67,43,7,0,17,50
45751,28,10,12,0,6,22
45752,66,31,21,0,14,52
45753,18,10,4,0,4,14
45754,88,40,33,1,14,74
45755,151,86,18,22,25,126
45756,136,81,29,0,26,110
45757,29,16,8,0,5,24
45758,99,45,12,21,21,78
45759,46,18,20,0,8,38
45760,16,9,3,0,4,12
45761,173,133,14,1,25,148
45762,93,55,21,1,16,77
45763,45,21,15,0,9,36
45764,69,22,35,2,10,59
45765,24,9,7,2,6,18
45766,121,49,38,5,29,92
45767,44,26,8,0,10,34
45768,103,67,11,4,21,82
45769,490,248,91,48,103,387
45770,88,45,24,2,17,71
45771,131,98,4,2,27,104
45772,2,2,0,0,0,2
45773,28,11,11,0,6,22
45774,5,2,1,1,1,4
45775,27,14,7,0,6,21
45776,79,51,18,1,9,70
45777,41,3,29,2,7,34
45778,73,7,48,5,13,60
45779,125,40,52,7,26,99
45780,80,51,17,0,12,68
45781,65,37,15,5,8,57
45782,48,22,17,1,8,40
45783,49,19,23,1,6,43
45784,177,81,56,3,37,140
45785,46,18,20,0,8,38
45786,199,126,26,9,38,161
45787,31,11,6,7,7,24
45788,150,90,29,0,31,119
45789,411,195,138,7,71,340
45790,14,2,7,1,4,10
45791,172,121,14,2,35,137
45792,1,0,1,0,0,1
45793,68,42,12,0,14,54
45794,160,111,23,0,26,134
45795,51,8,31,0,12,39
45796,82,18,44,4,16,66
45797,139,80,33,0,26,113
45798,654,383,141,17,113,541
45799,45,14,13,9,9,36
45800,151,115,6,2,28,123
45801,81,38,27,1,15,66
45802,66,25,28,0,13,53
45803,32,21,9,0,2,30
45804,31,13,14,0,4,27
45805,7,2,3,0,2,5
45806,34,20,9,0,5,29
45807,11,7,2,0,2,9
45808,105,57,20,6,22,83
45809,8,2,3,0,3,5
45810,70,39,22,0,9,61
45811,30,13,10,1,6,24
45812,19,11,7,0,1,18
45813,182,39,47,62,34,148
45814,655,381,142,17,115,540
45815,24,7,12,1,4,20
45816,124,41,47,12,24,100
45817,59,40,12,5,2,57
45818,11,7,3,0,1,10
45819,440,234,113,19,74,366
45820,46,18,20,0,8,38
45821,14,5,6,2,1,13
45822,87,26,43,1,17,70
45823,21,11,7,1,2,19
45824,213,86,37,40,50,163
45825,46,27,11,0,8,38
45826,39,15,18,1,5,34
45827,95,47,27,5,16,79
45828,82,26,43,0,13,69
45829,194,108,26,21,39,155
45830,86,30,34,10,12,74
45831,29,5,20,2,2,27
45832,156,48,48,24,36,120
45833,28,15,5,1,7,21
45834,17,6,8,0,3,14
45835,262,64,141,7,50,212
45836,44,4,28,1,11,33
45837,72,20,41,0,11,61
45838,287,107,89,28,63,224
45839,24,7,14,0,3,21
45840,11,5,3,0,3,8
45841,42,9,11,9,13,29
45842,31,15,10,1,5,26
45843,334,143,116,6,69,265
45844,203,111,30,23,39,164
45845,96,20,60,0,16,80
45846,86,34,21,8,23,63
45847,56,17,33,0,6,50
45848,11,8,0,0,3,8
45849,158,113,20,0,25,133
45850,59,47,2,0,10,49
45851,140,49,60,6,25,115
45852,40,19,5,7,9,31
45853,437,210,138,11,78,359
45854,18,4,8,0,6,12
45855,27,12,8,5,2,25
45856,204,55,53,56,40,164
45857,55,32,15,2,6,49
45858,26,15,5,2,4,22
45859,182,101,32,1,48,134
45860,14,8,0,2,4,10
45861,40,21,8,2,9,31
45862,75,62,3,0,10,65
45863,47,36,0,0,11,36
45864,55,36,5,0,14,41
45865,4,1,3,0,0,4
45866,49,23,11,5,10,39
45867,34,13,12,0,9,25
45868,32,21,9,0,2,30
45869,19,14,3,0,2,17
45870,45,26,15,0,4,41
45871,14,8,0,2,4,10
45872,105,58,15,11,21,84
45873,104,59,8,18,19,85
45874,35,3,12,13,7,28
45875,32,21,9,0,2,30
45876,44,35,2,0,7,37
45877,88,44,25,2,17,71
45878,190,96,32,29,33,157
45879,151,79,20,21,31,120
45880,121,36,43,16,26,95
45881,25,10,10,0,5,20
45882,32,21,9,0,2,30
45883,70,26,27,2,15,55
45884,243,101,15,82,45,198
45885,38,15,13,3,7,31
45886,84,53,11,2,18,66
45887,33,14,10,0,9,24
45888,139,49,62,4,24,115
45889,68,38,17,0,13,55
45890,29,8,13,0,8,21
45891,167,85,40,0,42,125
45892,26,8,12,0,6,20
45893,37,3,26,0,8,29
45894,16,0,14,0,2,14
45895,28,0,19,2,7,21
45896,71,58,2,2,9,62
45897,7,3,4,0,0,7
45898,51,19,3,19,10,41
45899,42,5,28,0,9,33
45900,274,160,24,33,57,217
45901,115,36,65,0,14,101
45902,127,65,12,22,28,99
45903,135,52,35,15,33,102
45904,61,37,14,0,10,51
45905,65,26,30,1,8,57
45906,19,1,12,3,3,16
45907,36,19,8,0,9,27
45908,333,156,83,26,68,265
45909,99,66,2,11,20,79
45910,127,75,21,3,28,99
45911,59,34,12,0,13,46
45912,25,12,6,2,5,20
45913,29,18,3,0,8,21
45914,13,7,2,1,3,10
45915,24,17,3,0,4,20
45916,155,39,82,4,30,125
45917,20,7,10,0,3,17
45918,41,6,6,19,10,31
45919,21,14,5,1,1,20
45920,79,20,17,30,12,67
45921,18,6,9,0,3,15
45922,101,37,42,0,22,79
45923,64,52,0,1,11,53
45924,235,178,11,0,46,189
45925,63,10,37,1,15,48
45926,69,38,17,0,14,55
45927,29,2,21,1,5,24
45928,108,55,23,7,23,85
45929,62,20,14,14,14,48
45930,79,60,5,0,14,65
45931,15,6,3,2,4,11
45932,222,76,82,15,49,173
45933,19,3,0,8,8,11
45934,7,3,1,0,3,4
45935,93,23,45,2,23,70
45936,103,47,21,11,24,79
45937,14,12,0,0,2,12
45938,178,97,32,2,47,131
45939,176,59,90,4,23,153
45940,173,114,11,10,38,135
45941,259,135,72,0,52,207
45942,211,51,30,93,37,174
45943,18,2,12,1,3,15
45944,37,8,18,2,9,28
45945,32,21,9,0,2,30
45946,115,41,41,8,25,90
45947,113,86,2,0,25,88
45948,82,27,39,3,13,69
45949,238,92,25,77,44,194
45950,87,42,21,1,23,64
45951,80,22,20,16,22,58
45952,80,45,3,16,16,64
45953,71,37,16,2,16,55
45954,40,13,15,2,10,30
45955,60,13,29,5,13,47
45956,295,73,163,4,55,240
45957,161,108,27,0,26,135
45958,80,54,12,2,12,68
45959,72,47,10,1,14,58
45960,28,2,11,8,7,21
45961,32,21,9,0,2,30
45962,129,37,62,4,26,103
45963,70,54,2,0,14,56
45964,35,8,16,2,9,26
45965,57,24,12,9,12,45
45966,69,30,24,0,15,54
45967,73,27,28,4,14,59
45968,144,61,32,17,34,110
45969,65,30,20,2,13,52
45970,21,11,6,0,4,17
45971,39,12,18,0,9,30
45972,134,56,51,2,25,109
45973,53,34,8,1,10,43
45974,362,186,82,13,81,281
45975,114,43,39,0,32,82
45976,65,29,26,2,8,57
45977,91,47,27,0,17,74
45978,59,11,33,3,12,47
45979,94,64,8,0,22,72
45980,61,29,23,2,7,54
45981,174,85,49,4,36,138
45982,57,33,17,0,7,50
45983,114,47,30,15,22,92
45984,146,45,74,4,23,123
45985,91,31,25,14,21,70
45986,11,8,0,0,3,8
45987,76,44,15,3,14,62
45988,111,52,26,5,28,83
45989,233,155,32,0,46,187
45990,28,2,18,0,8,20
45991,32,13,10,0,9,23
45992,49,24,3,14,8,41
45993,248,168,59,4,17,231
45994,32,21,9,0,2,30
45995,46,18,20,0,8,38
45996,14,2,12,0,0,14
45997,83,57,5,7,14,69
45998,243,100,15,83,45,198
45999,73,28,7,22,16,57
46000,146,50,38,30,28,118
46001,67,46,6,0,15,52
46002,29,23,5,1,0,29
46003,61,24,20,7,10,51
46004,185,57,78,12,38,147
46005,58,17,15,14,12,46
46006,255,50,155,2,48,207
46007,117,46,27,21,23,94
46008,94,62,14,0,18,76
46009,195,142,16,2,35,160
46010,15,6,4,1,4,11
46011,77,36,19,9,13,64
46012,352,204,72,0,76,276
46013,43,30,8,0,5,38
46014,27,17,7,0,3,24
46015,18,11,5,0,2,16
46016,16,8,5,0,3,13
46017,414,133,163,26,92,322
46018,181,52,28,70,31,150
46019,59,13,6,29,11,48
46020,63,10,38,0,15,48
46021,507,279,112,17,99,408
46022,46,27,9,4,6,40
46023,167,33,96,4,34,133
46024,79,53,5,0,21,58
46025,107,48,20,15,24,83
46026,243,100,15,83,45,198
46027,84,24,35,12,13,71
46028,45,10,24,0,11,34
46029,61,40,13,0,8,53
46030,44,9,24,5,6,38
46031,36,12,15,0,9,27
46032,22,15,3,0,4,18
46033,15,10,1,0,4,11
46034,102,31,45,5,21,81
46035,37,19,12,0,6,31
46036,28,14,8,2,4,24
46037,201,115,70,2,14,187
46038,56,40,8,0,8,48
46039,45,28,9,0,8,37
46040,172,125,21,0,26,146
46041,32,11,13,1,7,25
46042,283,68,46,120,49,234
46043,16,5,7,0,4,12
46044,109,35,52,1,21,88
46045,28,15,8,0,5,23
46046,37,1,29,0,7,30
46047,196,76,35,34,51,145
46048,13,9,2,0,2,11
46049,2,0,2,0,0,2
46050,41,15,16,3,7,34
46051,51,17,21,4,9,42
46052,119,49,29,15,26,93
46053,46,26,10,0,10,36
46054,36,26,7,3,0,36
46055,29,1,24,0,4,25
46056,24,11,6,2,5,19
46057,3,1,2,0,0,3
46058,153,50,50,21,32,121
46059,9,8,0,0,1,8
46060,33,6,15,1,11,22
46061,69,21,29,6,13,56
46062,352,151,127,6,68,284
46063,74,40,18,1,15,59
46064,32,21,9,0,2,30
46065,412,191,120,12,89,323
46066,15,6,4,0,5,10
46067,136,101,6,0,29,107
46068,38,20,11,0,7,31
46069,43,12,19,4,8,35
46070,106,22,49,12,23,83
46071,408,230,95,0,83,325
46072,84,28,39,6,11,73
46073,109,36,29,25,19,90
46074,256,177,15,5,59,197
46075,32,21,9,0,2,30
46076,57,48,2,0,7,50
46077,32,21,9,0,2,30
46078,62,19,18,16,9,53
46079,45,12,25,2,6,39
46080,130,82,31,0,17,113
46081,26,19,3,1,3,23
46082,106,35,36,16,19,87
46083,581,325,123,13,120,461
46084,92,58,16,0,18,74
46085,74,15,30,14,15,59
46086,210,85,81,13,31,179
46087,45,24,10,0,11,34
46088,22,5,13,2,2,20
46089,37,21,6,2,8,29
46090,17,5,6,0,6,11
46091,41,21,15,0,5,36
46092,19,12,3,0,4,15
46093,83,41,17,5,20,63
46094,65,40,7,2,16,49
46095,404,190,136,7,71,333
46096,221,52,32,98,39,182
46097,534,245,130,45,114,420
46098,58,14,34,1,9,49
46099,46,18,20,0,8,38
46100,168,83,49,1,35,133
46101,146,64,45,10,27,119
46102,21,18,0,0,3,18
46103,59,26,15,4,14,45
46104,97,54,19,1,23,74
46105,76,36,19,8,13,63
46106,42,30,2,0,10,32
46107,98,32,31,12,23,75
46108,296,147,87,12,50,246
46109,63,42,6,1,14,49
46110,392,176,133,11,72,320
46111,11,7,2,0,2,9
46112,22,3,17,0,2,20
46113,189,121,24,7,37,152
46114,184,84,43,19,38,146
46115,54,1,41,0,12,42
46116,6,0,3,0,3,3
46117,154,117,2,1,34,120
46118,63,35,16,0,12,51
46119,51,7,32,0,12,39
46120,42,10,27,0,5,37
46121,18,9,4,2,3,15
46122,95,57,15,4,19,76
46123,118,66,16,8,28,90
46124,5,2,2,1,0,5
46125,25,17,1,0,7,18
46126,127,74,22,3,28,99
46127,57,32,7,4,14,43
46128,112,59,33,1,19,93
46129,119,45,37,11,26,93
46130,26,17,2,5,2,24
46131,34,14,15,0,5,29
46132,9,7,0,0,2,7
46133,144,51,36,30,27,117
46134,92,58,10,2,22,70
46135,58,8,31,4,15,43
46136,87,45,28,3,11,76
46137,66,21,26,3,16,50
46138,28,7,6,6,9,19
46139,93,19,31,25,18,75
46140,26,10,4,8,4,22
46141,14,2,10,0,2,12
46142,11,3,5,0,3,8
46143,26,9,12,1,4,22
46144,352,185,93,15,59,293
46145,92,27,49,0,16,76
46146,200,51,100,14,35,165
46147,80,35,28,4,13,67
46148,16,9,1,1,5,11
46149,383,127,158,12,86,297
46150,224,14,169,0,41,183
46151,134,47,29,27,31,103
46152,97,26,21,29,21,76
46153,139,73,27,10,29,110
46154,364,196,92,15,61,303
46155,37,21,6,2,8,29
46156,79,31,24,9,15,64
46157,95,29,43,1,22,73
46158,117,89,9,2,17,100
46159,3,2,1,0,0,3
46160,63,21,23,0,19,44
46161,37,13,16,0,8,29
46162,49,29,2,2,16,33
46163,42,2,32,0,8,34
46164,42,15,19,0,8,34
46165,150,63,32,21,34,116
46166,49,22,16,2,9,40
46167,88,46,31,2,9,79
46168,46,13,24,0,9,37
46169,130,70,24,11,25,105
46170,119,87,6,0,26,93
46171,130,41,59,4,26,104
46172,53,30,13,2,8,45
46173,489,283,91,11,104,385
46174,102,40,41,10,11,91
46175,461,138,184,36,103,358
46176,146,102,24,0,20,126
46177,47,19,20,0,8,39
46178,19,8,7,1,3,16
46179,33,19,6,0,8,25
46180,77,44,15,3,15,62
46181,134,28,73,4,29,105
46182,34,8,16,0,10,24
46183,263,22,191,2,48,215
46184,12,6,3,3,0,12
46185,13,6,3,1,3,10
46186,56,13,19,6,18,38
46187,122,50,37,13,22,100
46188,159,92,25,10,32,127
46189,52,19,19,0,14,38
46190,22,10,5,0,7,15
46191,138,52,37,15,34,104
46192,69,13,43,0,13,56
46193,30,12,11,1,6,24
46194,71,49,13,0,9,62
46195,280,98,125,14,43,237
46196,111,39,42,11,19,92
46197,70,27,12,20,11,59
46198,95,42,14,17,22,73
46199,34,1,25,0,8,26
46200,35,19,6,8,2,33
46201,111,34,32,21,24,87
46202,40,6,5,19,10,30
46203,30,8,7,5,10,20
46204,78,22,41,2,13,65
46205,68,28,31,0,9,59
46206,24,4,15,0,5,19
46207,91,82,0,9,0,91
46208,33,11,17,0,5,28
46209,46,18,20,0,8,38
46210,665,391,141,17,116,549
46211,83,36,29,6,12,71
46212,94,54,26,10,4,90
46213,72,17,41,4,10,62
46214,174,83,52,4,35,139
46215,42,6,25,2,9,33
46216,69,20,29,10,10,59
46217,89,42,29,0,18,71
46218,67,25,28,1,13,54
46219,122,80,17,2,23,99
46220,28,4,20,0,4,24
46221,20,10,3,0,7,13
46222,63,21,30,2,10,53
46223,82,58,2,2,20,62
46224,38,19,13,0,6,32
46225,76,26,36,1,13,63
46226,44,13,20,4,7,37
46227,51,12,23,5,11,40
46228,16,12,3,0,1,15
46229,46,18,20,0,8,38
46230,482,262,81,41,98,384
46231,192,40,51,66,35,157
46232,5,2,2,0,1,4
46233,85,17,52,1,15,70
46234,78,32,7,18,21,57
46235,100,66,1,12,21,79
46236,125,43,36,14,32,93
46237,204,43,55,66,40,164
46238,6,2,1,0,3,3
46239,107,32,38,10,27,80
46240,54,30,3,11,10,44
46241,131,53,31,18,29,102
46242,64,47,4,0,13,51
46243,62,22,14,17,9,53
46244,37,27,6,1,3,34
46245,56,3,40,1,12,44
46246,87,37,30,0,20,67
46247,55,37,8,1,9,46
46248,481,205,122,45,109,372
46249,43,11,28,0,4,39
46250,173,101,26,9,37,136
46251,54,15,32,0,7,47
46252,513,280,83,47,103,410
46253,25,2,19,0,4,21
46254,32,21,9,0,2,30
46255,433,199,100,42,92,341
46256,1046,387,416,46,197,849
46257,106,34,58,0,14,92
46258,78,63,3,2,10,68
46259,18,6,9,1,2,16
46260,98,22,46,11,19,79
46261,61,25,20,3,13,48
46262,573,419,40,1,113,460
46263,314,163,76,18,57,257
46264,59,40,10,2,7,52
46265,144,110,6,0,28,116
46266,36,13,14,1,8,28
46267,207,13,155,0,39,168
46268,46,18,20,0,8,38
46269,73,25,21,9,18,55
46270,76,43,19,0,14,62
46271,535,271,109,42,113,422
46272,157,85,36,6,30,127
46273,39,10,24,0,5,34
46274,75,39,15,2,19,56
46275,1,0,0,0,1,0
46276,21,4,8,3,6,15
46277,19,7,9,0,3,16
46278,90,54,19,3,14,76
46279,209,138,23,0,48,161
46280,39,18,7,0,14,25
46281,45,21,13,3,8,37
46282,59,35,13,0,11,48
46283,49,2,38,1,8,41
46284,47,18,16,2,11,36
46285,31,9,10,4,8,23
46286,78,51,9,3,15,63
46287,12,7,2,3,0,12
46288,88,61,5,9,13,75
46289,41,24,8,1,8,33
46290,29,0,23,0,6,23
46291,54,32,8,2,12,42
46292,87,33,34,1,19,68
46293,30,13,12,0,5,25
46294,33,7,19,1,6,27
46295,60,31,10,2,17,43
46296,65,21,31,3,10,55
46297,54,7,32,4,11,43
46298,102,93,0,9,0,102
46299,119,96,3,3,17,102
46300,229,124,36,25,44,185
46301,68,28,23,2,15,53
46302,39,11,21,0,7,32
46303,109,55,32,5,17,92
46304,28,14,6,2,6,22
46305,21,9,8,2,2,19
46306,187,84,62,13,28,159
46307,61,20,16,15,10,51
46308,78,49,17,0,12,66
46309,43,30,3,0,10,33
46310,29,9,11,0,9,20
46311,81,40,26,0,15,66
46312,153,81,20,21,31,122
46313,46,18,20,0,8,38
46314,86,17,54,0,15,71
46315,41,29,4,3,5,36
46316,17,9,2,0,6,11
46317,60,25,23,1,11,49
46318,9,1,5,1,2,7
46319,156,123,11,1,21,135
46320,24,9,7,3,5,19
46321,85,35,30,9,11,74
46322,658,386,143,16,113,545
46323,100,51,27,5,17,83
46324,25,11,10,0,4,21
46325,60,45,3,2,10,50
46326,11,7,3,0,1,10
46327,37,27,1,2,7,30
46328,71,41,11,1,18,53
46329,76,26,33,1,16,60
46330,32,21,9,0,2,30
46331,80,16,56,2,6,74
46332,23,3,16,0,4,19
46333,19,10,1,3,5,14
46334,52,16,28,0,8,44
46335,23,2,16,0,5,18
46336,32,21,9,0,2,30
46337,407,120,180,15,92,315
46338,62,20,25,9,8,54
46339,188,46,25,84,33,155
46340,83,39,30,4,10,73
46341,456,235,113,12,96,360
46342,29,7,10,5,7,22
46343,76,5,24,36,11,65
46344,106,50,29,3,24,82
46345,3,0,1,0,2,1
46346,56,12,20,6,18,38
46347,189,99,58,0,32,157
46348,32,6,23,0,3,29
46349,50,27,12,2,9,41
46350,16,5,7,1,3,13
46351,94,56,25,11,2,92
46352,36,2,26,0,8,28
46353,32,21,9,0,2,30
46354,85,34,19,14,18,67
46355,3,0,3,0,0,3
46356,8,6,1,0,1,7
46357,5,3,1,0,1,4
46358,21,9,6,0,6,15
46359,203,100,33,34,36,167
46360,73,44,16,0,13,60
46361,38,21,12,0,5,33
46362,72,32,25,2,13,59
46363,44,19,13,6,6,38
46364,146,86,20,3,37,109
46365,323,194,60,0,69,254
46366,7,2,5,0,0,7
46367,5,2,2,0,1,4
46368,5,5,0,0,0,5
46369,459,230,88,49,92,367
46370,46,30,6,1,9,37
46371,15,5,6,1,3,12
46372,178,134,14,1,29,149
46373,26,13,6,0,7,19
46374,101,71,19,1,10,91
46375,405,190,85,49,81,324
46376,38,29,6,3,0,38
46377,282,160,31,32,59,223
46378,18,5,8,0,5,13
46379,50,20,23,0,7,43
46380,151,52,73,0,26,125
46381,11,3,5,0,3,8
46382,45,11,24,0,10,35
46383,76,46,16,0,14,62
46384,63,41,10,2,10,53
46385,219,148,30,0,41,178
46386,34,23,9,2,0,34
46387,279,142,84,0,53,226
46388,266,199,15,0,52,214
46389,44,23,12,1,8,36
46390,92,32,32,9,19,73
46391,32,21,9,0,2,30
46392,41,1,30,2,8,33
46393,40,11,18,0,11,29
46394,9,3,2,1,3,6
46395,78,17,44,1,16,62
46396,17,5,9,1,2,15
46397,27,7,12,2,6,21
46398,40,15,16,0,9,31
46399,267,201,15,0,51,216
46400,32,21,9,0,2,30
46401,397,233,81,16,67,330
46402,62,18,32,1,11,51
46403,46,18,20,0,8,38
46404,43,25,8,0,10,33
46405,93,46,27,4,16,77
46406,149,69,29,26,25,124
46407,43,27,7,3,6,37
46408,255,79,123,12,41,214
46409,213,113,56,0,44,169
46410,10,1,7,0,2,8
46411,76,50,9,0,17,59
46412,8,7,1,0,0,8
46413,59,38,8,0,13,46
46414,52,26,8,6,12,40
46415,1,1,0,0,0,1
46416,36,13,17,0,6,30
46417,53,32,14,0,7,46
46418,107,81,4,2,20,87
46419,46,18,20,0,8,38
46420,34,18,10,0,6,28
46421,469,217,155,12,85,384
46422,32,21,9,0,2,30
46423,445,204,149,11,81,364
46424,18,15,1,0,2,16
46425,87,58,12,9,8,79
46426,59,42,1,0,16,43
46427,59,18,15,14,12,47
46428,225,150,34,0,41,184
46429,63,33,19,1,10,53
46430,166,74,53,6,33,133
46431,264,59,156,1,48,216
46432,35,16,8,4,7,28
46433,58,32,4,10,12,46
46434,293,79,33,132,49,244
46435,93,36,36,1,20,73
46436,93,7,66,5,15,78
46437,25,6,14,0,5,20
46438,28,10,13,0,5,23
46439,273,140,81,7,45,228
46440,630,374,130,16,110,520
46441,45,23,10,0,12,33
46442,66,19,24,6,17,49
46443,91,48,16,11,16,75
46444,46,18,20,0,8,38
46445,71,36,12,4,19,52
46446,107,84,8,0,15,92
46447,90,42,13,12,23,67
46448,135,85,12,10,28,107
46449,147,29,48,39,31,116
46450,43,11,27,0,5,38
46451,102,31,51,0,20,82
46452,126,96,4,2,24,102
46453,6,0,6,0,0,6
46454,231,154,35,0,42,189
46455,139,48,60,6,25,114
46456,33,21,4,0,8,25
46457,42,18,16,0,8,34
46458,52,35,5,2,10,42
46459,251,134,75,0,42,209
46460,34,18,10,1,5,29
46461,29,3,17,3,6,23
46462,139,12,95,2,30,109
46463,40,18,13,0,9,31
46464,362,158,125,11,68,294
46465,49,16,21,1,11,38
46466,59,19,24,8,8,51
46467,8,0,7,0,1,7
46468,21,7,10,0,4,17
46469,36,16,10,0,10,26
46470,23,20,0,0,3,20
46471,26,14,2,4,6,20
46472,9,3,4,0,2,7
46473,26,4,13,2,7,19
46474,12,3,7,0,2,10
46475,2,1,0,0,1,1
46476,67,26,26,4,11,56
46477,14,1,12,0,1,13
46478,90,54,14,2,20,70
46479,518,288,81,46,103,415
46480,21,3,9,0,9,12
46481,103,33,48,1,21,82
46482,88,61,8,0,19,69
46483,13,11,1,0,1,12
46484,61,0,41,3,17,44
46485,30,18,3,0,9,21
46486,20,1,8,8,3,17
46487,12,4,6,0,2,10
46488,393,236,59,7,91,302
46489,58,9,35,0,14,44
46490,22,14,2,0,6,16
46491,25,9,10,1,5,20
46492,103,50,31,2,20,83
46493,252,165,66,4,17,235
46494,57,38,7,3,9,48
46495,21,11,6,0,4,17
46496,125,47,51,12,15,110
46497,66,29,16,7,14,52
46498,46,12,25,1,8,38
46499,31,12,7,6,6,25
46500,39,22,8,0,9,30
46501,14,3,6,0,5,9
46502,80,28,33,1,18,62
46503,23,13,4,0,6,17
46504,92,54,16,0,22,70
46505,62,44,7,2,9,53
46506,23,4,3,10,6,17
46507,523,299,98,10,116,407
46508,21,7,10,2,2,19
46509,116,72,12,5,27,89
46510,135,75,24,7,29,106
46511,156,63,31,31,31,125
46512,65,37,14,0,14,51
46513,331,158,93,17,63,268
46514,203,91,56,13,43,160
46515,112,39,34,14,25,87
46516,41,20,12,0,9,32
46517,26,5,15,0,6,20
46518,65,32,24,0,9,56
46519,55,38,6,1,10,45
46520,21,13,3,1,4,17
46521,63,15,23,9,16,47
46522,78,33,9,16,20,58
46523,348,267,20,0,61,287
46524,10,3,4,0,3,7
46525,35,20,7,0,8,27
46526,70,48,7,3,12,58
46527,358,157,125,6,70,288
46528,70,39,17,3,11,59
46529,48,21,16,2,9,39
46530,84,59,16,0,9,75
46531,75,9,42,5,19,56
46532,8,0,8,0,0,8
46533,217,89,44,27,57,160
46534,394,297,22,0,75,319
46535,546,266,122,41,117,429
46536,103,68,5,6,24,79
46537,142,75,35,16,16,126
46538,39,23,10,0,6,33
46539,33,6,19,0,8,25
46540,370,103,176,6,85,285
46541,85,17,45,9,14,71
46542,56,13,19,6,18,38
46543,150,50,47,23,30,120
46544,201,110,29,23,39,162
46545,9,5,1,0,3,6
46546,101,29,37,11,24,77
46547,67,7,54,0,6,61
46548,635,356,154,23,102,533
46549,76,29,22,8,17,59
46550,538,258,114,53,113,425
46551,22,14,4,0,4,18
46552,63,35,11,1,16,47
46553,154,22,102,1,29,125
46554,32,2,24,1,5,27
46555,135,31,72,3,29,106
46556,52,12,32,2,6,46
46557,88,40,15,15,18,70
46558,68,27,26,2,13,55
46559,7,0,5,0,2,5
46560,187,126,17,0,44,143
46561,41,11,10,10,10,31
46562,91,31,39,9,12,79
46563,64,25,28,2,9,55
46564,33,14,10,0,9,24
46565,55,31,13,1,10,45
46566,20,1,15,2,2,18
46567,91,37,20,10,24,67
46568,124,39,52,8,25,99
46569,31,5,14,5,7,24
46570,213,87,14,75,37,176
46571,441,152,149,47,93,348
46572,50,4,35,7,4,46
46573,46,9,16,11,10,36
46574,166,104,28,5,29,137
46575,70,20,32,1,17,53
46576,190,12,143,0,35,155
46577,74,43,19,0,12,62
46578,25,13,3,0,9,16
46579,141,26,88,1,26,115
46580,242,183,13,0,46,196
46581,59,29,15,3,12,47
46582,46,18,20,0,8,38
46583,100,33,48,5,14,86
46584,68,12,41,0,15,53
46585,30,13,12,0,5,25
46586,74,32,35,0,7,67
46587,284,195,66,3,20,264
46588,62,25,13,7,17,45
46589,235,54,24,118,39,196
46590,93,44,34,0,15,78
46591,16,3,6,1,6,10
46592,74,25,30,0,19,55
46593,64,37,18,3,6,58
46594,163,47,73,5,38,125
46595,49,24,10,2,13,36
46596,32,14,11,0,7,25
46597,29,6,13,1,9,20
46598,56,19,31,0,6,50
46599,46,18,20,0,8,38
46600,36,8,22,1,5,31
46601,41,22,9,3,7,34
46602,245,96,105,4,40,205
46603,30,18,4,0,8,22
46604,58,37,12,2,7,51
46605,84,36,9,18,21,63
46606,72,34,14,11,13,59
46607,26,8,13,1,4,22
46608,14,5,4,0,5,9
46609,205,144,45,3,13,192
46610,158,69,32,20,37,121
46611,54,33,10,1,10,44
46612,398,231,87,0,80,318
46613,22,9,9,0,4,18
46614,115,42,33,21,19,96
46615,13,6,5,0,2,11
46616,44,11,21,5,7,37
46617,296,23,215,2,56,240
46618,39,16,11,3,9,30
46619,30,17,4,2,7,23
46620,184,101,35,1,47,137
46621,131,37,42,18,34,97
46622,61,22,26,0,13,48
46623,190,101,48,7,34,156
46624,278,160,26,33,59,219
46625,38,27,5,0,6,32
46626,26,8,12,0,6,20
46627,42,7,24,3,8,34
46628,46,18,20,0,8,38
46629,32,21,9,0,2,30
46630,50,35,0,0,15,35
46631,110,37,48,10,15,95
46632,73,31,12,13,17,56
46633,29,20,3,0,6,23
46634,9,0,3,0,6,3
46635,198,81,31,40,46,152
46636,50,11,26,3,10,40
46637,54,21,13,8,12,42
46638,71,43,13,0,15,56
46639,102,98,0,4,0,102
46640,32,21,9,0,2,30
46641,359,158,125,6,70,289
46642,172,125,21,0,26,146
46643,16,2,7,1,6,10
46644,4,0,1,0,3,1
46645,39,24,4,0,11,28
46646,73,26,22,9,16,57
46647,64,37,14,1,12,52
46648,36,17,10,0,9,27
46649,47,17,20,0,10,37
46650,136,91,18,1,26,110
46651,33,9,16,0,8,25
46652,30,13,13,0,4,26
46653,18,8,8,1,1,17
46654,39,24,7,0,8,31
46655,63,35,9,11,8,55
46656,107,81,5,0,21,86
46657,25,15,5,0,5,20
46658,70,35,19,4,12,58
46659,140,44,42,20,34,106
46660,47,34,6,0,7,40
46661,183,104,22,23,34,149
46662,44,8,23,0,13,31
46663,233,155,32,0,46,187
46664,24,5,13,0,6,18
46665,3,0,2,0,1,2
46666,26,13,7,0,6,20
46667,1,0,1,0,0,1
46668,186,88,55,1,42,144
46669,22,3,13,2,4,18
46670,39,23,9,4,3,36
46671,37,0,33,1,3,34
46672,93,24,48,3,18,75
46673,8,3,3,0,2,6
46674,52,19,15,5,13,39
46675,294,39,198,2,55,239
46676,5,3,1,0,1,4
46677,178,130,11,6,31,147
46678,207,89,43,26,49,158
46679,32,21,9,0,2,30
46680,29,9,12,2,6,23
46681,20,7,10,1,2,18
46682,74,28,31,1,14,60
46683,67,46,9,0,12,55
46684,17,3,13,0,1,16
46685,39,15,17,2,5,34
46686,32,22,4,0,6,26
46687,97,72,6,0,19,78
46688,160,119,4,2,35,125
46689,8,0,8,0,0,8
46690,8,7,0,0,1,7
46691,116,49,35,9,23,93
46692,67,46,6,0,15,52
46693,70,23,22,8,17,53
46694,14,8,3,0,3,11
46695,85,57,8,3,17,68
46696,60,34,18,0,8,52
46697,102,57,25,3,17,85
46698,162,83,31,23,25,137
46699,78,30,12,19,17,61
46700,63,36,16,0,11,52
46701,30,8,12,2,8,22
46702,14,6,4,2,2,12
46703,34,17,7,1,9,25
46704,154,101,30,0,23,131
46705,42,30,2,0,10,32
46706,113,59,14,13,27,86
46707,56,36,13,0,7,49
46708,155,73,49,1,32,123
46709,179,93,34,19,33,146
46710,477,219,159,13,86,391
46711,35,7,20,1,7,28
46712,28,13,6,0,9,19
46713,61,19,22,1,19,42
46714,53,0,33,3,17,36
46715,102,31,36,10,25,77
46716,70,13,44,3,10,60
46717,174,72,37,25,40,134
46718,70,20,38,0,12,58
46719,133,69,13,22,29,104
46720,397,226,89,0,82,315
46721,56,37,12,0,7,49
46722,69,15,31,4,19,50
46723,40,26,7,0,7,33
46724,560,400,43,1,116,444
46725,257,126,64,16,51,206
46726,85,38,15,9,23,62
46727,201,84,59,19,39,162
46728,49,9,29,2,9,40
46729,60,38,11,1,10,50
46730,12,6,1,0,5,7
46731,58,18,23,3,14,44
46732,36,13,14,0,9,27
46733,526,287,115,14,110,416
46734,36,9,14,1,12,24
46735,71,25,19,10,17,54
46736,201,101,51,0,49,152
46737,88,55,18,2,13,75
46738,34,8,16,6,4,30
46739,175,47,58,35,35,140
46740,65,18,26,6,15,50
46741,35,20,3,3,9,26
46742,192,113,34,6,39,153
46743,7,3,4,0,0,7
46744,56,40,9,0,7,49
46745,200,129,52,4,15,185
46746,29,12,14,0,3,26
46747,13,7,2,0,4,9
46748,555,323,111,18,103,452
46749,46,21,11,1,13,33
46750,62,24,27,2,9,53
46751,13,7,5,0,1,12
46752,41,18,17,0,6,35
46753,272,98,116,14,44,228
46754,135,69,16,22,28,107
46755,170,110,27,0,33,137
46756,57,37,1,4,15,42
46757,37,22,5,2,8,29
46758,74,41,15,1,17,57
46759,76,45,13,0,18,58
46760,29,6,17,2,4,25
46761,69,46,8,0,15,54
46762,91,23,50,2,16,75
46763,31,15,13,0,3,28
46764,17,0,11,2,4,13
46765,271,207,15,0,49,222
46766,52,31,10,0,11,41
46767,119,56,38,4,21,98
46768,35,1,29,0,5,30
46769,11,10,0,0,1,10
46770,9,8,0,0,1,8
46771,17,1,10,1,5,12
46772,15,5,8,0,2,13
46773,51,15,23,3,10,41
46774,3,0,3,0,0,3
46775,538,383,43,1,111,427
46776,12,0,10,0,2,10
46777,153,115,7,0,31,122
46778,289,32,202,2,53,236
46779,66,28,25,0,13,53
46780,32,12,2,14,4,28
46781,28,0,23,0,5,23
46782,231,126,65,0,40,191
46783,59,36,10,0,13,46
46784,11,5,3,0,3,8
46785,66,27,25,0,14,52
46786,53,2,26,18,7,46
46787,17,5,8,0,4,13
46788,166,101,30,3,32,134
46789,73,50,10,1,12,61
46790,1,1,0,0,0,1
46791,71,28,28,3,12,59
46792,69,30,25,0,14,55
46793,102,25,41,14,22,80
46794,173,103,35,6,29,144
46795,111,105,0,6,0,111
46796,475,221,155,11,88,387
46797,95,52,18,10,15,80
46798,48,22,15,2,9,39
46799,31,22,0,0,9,22
46800,18,0,15,2,1,17
46801,205,93,57,13,42,163
46802,189,104,27,23,35,154
46803,73,36,23,0,14,59
46804,7,2,4,0,1,6
46805,5,2,0,0,3,2
46806,75,22,26,9,18,57
46807,69,19,27,0,23,46
46808,27,16,8,0,3,24
46809,141,92,14,5,30,111
46810,41,32,4,0,5,36
46811,90,36,34,0,20,70
46812,198,89,51,20,38,160
46813,32,21,9,0,2,30
46814,42,8,25,3,6,36
46815,142,77,26,7,32,110
46816,17,2,13,0,2,15
46817,10,0,9,0,1,9
46818,92,61,8,4,19,73
46819,29,5,20,2,2,27
46820,65,27,23,0,15,50
46821,39,0,34,1,4,35
46822,10,1,5,1,3,7
46823,3,2,1,0,0,3
46824,124,56,25,16,27,97
46825,675,391,140,21,123,552
46826,32,21,9,0,2,30
46827,96,35,21,19,21,75
46828,35,25,5,5,0,35
46829,108,59,29,1,19,89
46830,32,13,12,0,7,25
46831,14,5,3,3,3,11
46832,103,35,49,4,15,88
46833,322,163,90,15,54,268
46834,32,21,5,0,6,26
46835,9,0,7,0,2,7
46836,14,8,4,1,1,13
46837,116,52,43,1,20,96
46838,93,39,33,1,20,73
46839,27,7,9,3,8,19
46840,32,19,6,0,7,25
46841,110,71,2,13,24,86
46842,4,1,3,0,0,4
46843,212,128,15,26,43,169
46844,24,8,12,1,3,21
46845,46,18,20,0,8,38
46846,55,18,31,0,6,49
46847,200,143,16,2,39,161
46848,37,8,16,2,11,26
46849,279,15,210,0,54,225
46850,42,21,5,7,9,33
46851,22,4,14,0,4,18
46852,89,42,30,1,16,73
46853,49,38,2,0,9,40
46854,32,21,9,0,2,30
46855,21,1,4,12,4,17
46856,65,44,4,2,15,50
46857,683,378,166,24,115,568
46858,27,2,10,8,7,20
46859,48,35,2,2,9,39
46860,102,68,1,11,22,80
46861,104,36,32,19,17,87
46862,121,41,50,11,19,102
46863,306,233,18,0,55,251
46864,243,163,59,4,17,226
46865,6,0,4,0,2,4
46866,2,0,1,0,1,1
46867,19,11,4,0,4,15
46868,277,98,125,13,41,236
46869,184,71,59,7,47,137
46870,28,24,0,0,4,24
46871,17,2,8,4,3,14
46872,36,21,4,1,10,26
46873,9,2,5,0,2,7
46874,98,29,35,10,24,74
46875,7,0,4,0,3,4
46876,11,7,3,0,1,10
46877,18,2,10,4,2,16
46878,162,115,11,0,36,126
46879,243,92,54,38,59,184
46880,128,78,20,5,25,103
46881,72,38,4,14,16,56
46882,43,28,7,0,8,35
46883,273,85,127,17,44,229
46884,23,6,11,1,5,18
46885,46,26,8,2,10,36
46886,48,27,12,2,7,41
46887,276,154,33,33,56,220
46888,17,3,8,0,6,11
46889,388,203,100,19,66,322
46890,78,44,18,2,14,64
46891,26,16,5,0,5,21
46892,90,32,30,8,20,70
46893,52,27,17,0,8,44
46894,23,16,3,1,3,20
46895,70,30,20,11,9,61
46896,47,18,18,2,9,38
46897,178,46,55,41,36,142
46898,104,48,40,3,13,91
46899,96,51,13,16,16,80
46900,35,15,8,0,12,23
46901,47,23,12,1,11,36
46902,166,110,25,1,30,136
46903,43,26,10,0,7,36
46904,50,29,11,0,10,40
46905,53,35,11,0,7,46
46906,142,25,80,0,37,105
46907,109,38,27,24,20,89
46908,172,60,70,9,33,139
46909,5,3,1,0,1,4
46910,19,11,1,0,7,12
46911,283,95,127,15,46,237
46912,82,41,19,0,22,60
46913,35,13,9,6,7,28
46914,65,23,31,0,11,54
46915,176,40,17,91,28,148
46916,56,37,8,1,10,46
46917,113,75,16,1,21,92
46918,137,82,20,7,28,109
46919,281,191,22,2,66,215
46920,46,18,20,0,8,38
46921,32,21,9,0,2,30
46922,18,1,11,0,6,12
46923,46,18,20,0,8,38
46924,138,67,36,0,35,103
46925,123,36,50,8,29,94
46926,30,20,3,0,7,23
46927,24,10,6,3,5,19
46928,166,97,39,1,29,137
46929,57,25,18,5,9,48
46930,70,48,5,6,11,59
46931,54,23,18,1,12,42
46932,204,57,109,5,33,171
46933,67,47,4,4,12,55
46934,636,368,148,17,103,533
46935,38,21,12,0,5,33
46936,55,33,10,0,12,43
46937,32,21,9,0,2,30
46938,149,118,4,0,27,122
46939,77,21,31,12,13,64
46940,55,21,22,1,11,44
46941,38,10,16,0,12,26
46942,210,128,13,26,43,167
46943,85,41,18,7,19,66
46944,127,75,22,2,28,99
46945,112,28,31,22,31,81
46946,33,14,10,0,9,24
46947,347,188,89,15,55,292
46948,46,24,10,1,11,35
46949,32,21,9,0,2,30
46950,58,2,47,0,9,49
46951,43,28,8,0,7,36
46952,85,51,18,0,16,69
46953,17,5,6,0,6,11
46954,63,30,11,7,15,48
46955,32,18,7,0,7,25
46956,38,8,22,0,8,30
46957,394,229,82,16,67,327
46958,37,17,14,0,6,31
46959,85,34,33,5,13,72
46960,104,50,35,0,19,85
46961,168,58,53,26,31,137
46962,55,19,12,8,16,39
46963,136,105,12,0,19,117
46964,197,139,40,1,17,180
46965,465,217,144,12,92,373
46966,87,47,17,7,16,71
46967,54,32,12,0,10,44
46968,149,23,97,1,28,121
46969,76,4,53,1,18,58
46970,34,8,19,1,6,28
46971,121,45,35,15,26,95
46972,69,37,22,1,9,60
46973,33,24,5,0,4,29
46974,64,26,17,4,17,47
46975,84,38,25,0,21,63
46976,139,79,23,3,34,105
46977,27,7,6,7,7,20
46978,112,42,34,19,17,95
46979,42,21,5,7,9,33
46980,151,66,28,20,37,114
46981,128,37,66,0,25,103
46982,184,74,43,22,45,139
46983,39,23,8,0,8,31
46984,4,2,0,0,2,2
46985,10,1,4,2,3,7
46986,53,25,19,0,9,44
46987,26,4,20,0,2,24
46988,71,48,9,0,14,57
46989,82,68,1,0,13,69
46990,49,32,6,2,9,40
46991,61,29,12,6,14,47
46992,100,42,21,18,19,81
46993,68,38,20,0,10,58
46994,32,21,9,0,2,30
46995,23,16,2,0,5,18
46996,290,127,74,32,57,233
46997,115,42,41,9,23,92
46998,95,52,25,0,18,77
46999,39,6,22,0,11,28
47000,61,32,13,3,13,48
47001,66,29,15,5,17,49
47002,123,64,21,12,26,97
47003,45,31,3,0,11,34
47004,85,43,12,8,22,63
47005,13,13,0,0,0,13
47006,460,218,142,13,87,373
47007,349,183,92,15,59,290
47008,30,22,0,0,8,22
47009,158,68,48,10,32,126
47010,224,150,33,0,41,183
47011,58,2,47,1,8,50
47012,67,47,9,0,11,56
47013,51,22,20,0,9,42
47014,84,34,36,2,12,72
47015,78,11,55,0,12,66
47016,75,35,15,14,11,64
47017,43,7,16,7,13,30
47018,70,22,19,9,20,50
47019,663,388,141,17,117,546
47020,21,8,8,1,4,17
47021,41,16,4,12,9,32
47022,27,12,10,0,5,22
47023,153,59,39,21,34,119
47024,74,36,18,2,18,56
47025,77,31,8,17,21,56
47026,31,2,24,1,4,27
47027,109,35,35,12,27,82
47028,66,5,45,0,16,50
47029,243,164,59,4,16,227
47030,93,55,15,5,18,75
47031,30,16,7,2,5,25
47032,21,5,8,1,7,14
47033,151,70,49,6,26,125
47034,143,35,71,4,33,110
47035,9,6,2,1,0,9
47036,19,12,3,1,3,16
47037,45,15,18,2,10,35
47038,166,113,40,1,12,154
47039,82,41,4,24,13,69
47040,40,21,9,0,10,30
47041,355,89,172,5,89,266
47042,42,12,10,10,10,32
47043,6,2,3,0,1,5
47044,24,7,7,2,8,16
47045,61,32,13,4,12,49
47046,39,12,14,3,10,29
47047,488,252,90,46,100,388
47048,41,32,1,0,8,33
47049,78,36,13,15,14,64
47050,46,18,20,0,8,38
47051,44,33,4,0,7,37
47052,46,28,10,0,8,38
47053,86,59,5,8,14,72
47054,388,120,156,31,81,307
47055,94,16,42,16,20,74
47056,19,2,10,0,7,12
47057,40,16,20,0,4,36
47058,19,7,7,0,5,14
47059,43,12,20,0,11,32
47060,132,69,41,11,11,121
47061,343,144,122,6,71,272
47062,22,2,14,2,4,18
47063,33,13,11,0,9,24
47064,33,8,15,1,9,24
47065,37,23,2,0,12,25
47066,170,51,86,0,33,137
47067,29,13,8,1,7,22
47068,102,30,37,11,24,78
47069,14,3,4,1,6,8
47070,21,14,1,1,5,16
47071,111,79,8,7,17,94
47072,4,1,1,1,1,3
47073,21,2,7,8,4,17
47074,112,34,55,0,23,89
47075,21,8,10,0,3,18
47076,31,19,3,0,9,22
47077,52,29,13,3,7,45
47078,49,29,5,5,10,39
47079,135,72,33,0,30,105
47080,144,82,39,13,10,134
47081,111,87,3,0,21,90
47082,155,30,93,1,31,124
47083,150,63,36,23,28,122
47084,120,31,45,16,28,92
47085,70,20,22,10,18,52
47086,131,62,41,4,24,107
47087,44,26,12,0,6,38
47088,146,68,28,17,33,113
47089,197,89,50,20,38,159
47090,38,12,21,1,4,34
47091,262,71,99,33,59,203
47092,135,54,40,15,26,109
47093,101,37,32,12,20,81
47094,504,246,99,57,102,402
47095,3,0,3,0,0,3
47096,51,25,16,1,9,42
47097,1,0,1,0,0,1
47098,40,1,33,0,6,34
47099,169,112,26,1,30,139
47100,30,1,21,0,8,22
47101,49,15,21,0,13,36
47102,57,24,6,13,14,43
47103,62,18,24,6,14,48
47104,32,21,9,0,2,30
47105,335,139,119,6,71,264
47106,65,18,20,9,18,47
47107,43,11,24,1,7,36
47108,14,10,2,0,2,12
47109,36,12,14,0,10,26
47110,46,18,20,0,8,38
47111,55,33,14,0,8,47
47112,4,0,4,0,0,4
47113,21,18,0,0,3,18
47114,42,22,9,2,9,33
47115,129,66,13,22,28,101
47116,41,12,22,1,6,35
47117,254,116,80,4,54,200
47118,105,33,52,0,20,85
47119,168,82,34,21,31,137
47120,59,36,10,1,12,47
47121,110,47,21,14,28,82
47122,503,279,79,41,104,399
47123,33,7,19,1,6,27
47124,55,7,33,4,11,44
47125,34,15,13,0,6,28
47126,0,0,0,0,0,0
47127,62,27,21,4,10,52
47128,42,23,8,2,9,33
47129,51,34,4,4,9,42
47130,24,7,8,0,9,15
47131,89,22,50,2,15,74
47132,32,21,9,0,2,30
47133,87,52,19,4,12,75
47134,232,97,87,4,44,188
47135,17,12,1,0,4,13
47136,25,10,7,0,8,17
47137,24,7,7,0,10,14
47138,52,24,15,5,8,44
47139,127,74,22,3,28,99
47140,205,111,61,0,33,172
47141,141,80,19,22,20,121
47142,6,3,0,1,2,4
47143,100,54,30,1,15,85
47144,23,14,5,0,4,19
47145,69,20,34,2,13,56
47146,29,5,22,0,2,27
47147,90,48,15,3,24,66
47148,50,26,8,4,12,38
47149,103,44,27,1,31,72
47150,50,5,37,0,8,42
47151,109,32,55,0,22,87
47152,21,15,4,0,2,19
47153,47,14,21,2,10,37
47154,114,55,31,6,22,92
47155,65,28,8,12,17,48
47156,137,72,34,0,31,106
47157,88,52,18,0,18,70
47158,210,51,30,92,37,173
47159,5,2,2,0,1,4
47160,127,96,4,2,25,102
47161,33,24,5,0,4,29
47162,73,18,32,8,15,58
47163,62,35,9,0,18,44
47164,39,14,18,2,5,34
47165,43,29,6,2,6,37
47166,42,15,20,0,7,35
47167,36,14,16,0,6,30
47168,44,32,5,0,7,37
47169,25,1,19,0,5,20
47170,30,19,3,0,8,22
47171,179,134,5,1,39,140
47172,123,68,23,5,27,96
47173,25,10,2,3,10,15
47174,207,14,156,0,37,170
47175,13,4,5,0,4,9
47176,54,22,3,20,9,45
47177,277,92,127,15,43,234
47178,23,9,7,2,5,18
47179,114,80,12,2,20,94
47180,233,141,9,31,52,181
47181,27,11,8,0,8,19
47182,36,2,24,0,10,26
47183,29,6,12,7,4,25
47184,117,30,44,16,27,90
47185,33,10,17,0,6,27
47186,148,74,37,0,37,111
47187,44,7,27,3,7,37
47188,45,13,24,0,8,37
47189,37,7,9,16,5,32
47190,22,13,4,0,5,17
47191,425,207,126,13,79,346
47192,66,20,29,2,15,51
47193,236,108,70,17,41,195
47194,43,0,37,0,6,37
47195,38,15,15,0,8,30
47196,9,5,2,0,2,7
47197,31,18,5,0,8,23
47198,165,49,52,26,38,127
47199,463,164,156,45,98,365
47200,8,3,3,2,0,8
47201,97,63,9,5,20,77
47202,31,18,5,2,6,25
47203,31,11,14,0,6,25
47204,14,8,3,0,3,11
47205,61,33,13,0,15,46
47206,25,6,12,0,7,18
47207,280,85,132,17,46,234
47208,56,37,12,0,7,49
47209,32,21,9,0,2,30
47210,73,25,37,0,11,62
47211,46,26,9,4,7,39
47212,177,85,52,4,36,141
47213,85,41,24,0,20,65
47214,58,11,33,4,10,48
47215,91,52,23,11,5,86
47216,190,134,37,2,17,173
47217,69,36,3,17,13,56
47218,206,42,53,70,41,165
47219,49,23,18,0,8,41
47220,1,1,0,0,0,1
47221,2,0,0,0,2,0
47222,36,21,10,0,5,31
47223,64,40,13,0,11,53
47224,35,21,7,2,5,30
47225,124,58,25,16,25,99
47226,169,100,35,8,26,143
47227,53,20,26,0,7,46
47228,151,105,18,0,28,123
47229,33,12,15,0,6,27
47230,40,12,15,2,11,29
47231,69,29,23,0,17,52
47232,97,29,47,6,15,82
47233,67,38,7,10,12,55
47234,25,14,7,0,4,21
47235,57,9,34,3,11,46
47236,65,23,31,1,10,55
47237,30,2,21,0,7,23
47238,35,16,11,3,5,30
47239,78,46,20,0,12,66
47240,49,28,11,0,10,39
47241,87,37,15,17,18,69
47242,34,10,18,0,6,28
47243,28,8,7,2,11,17
47244,63,25,28,1,9,54
47245,25,11,5,3,6,19
47246,50,25,16,4,5,45
47247,209,149,10,9,41,168
47248,21,6,8,0,7,14
47249,44,12,24,1,7,37
47250,100,46,4,33,17,83
47251,15,8,1,5,1,14
47252,98,55,12,14,17,81
47253,58,11,34,4,9,49
47254,34,26,5,3,0,34
47255,57,20,22,6,9,48
47256,47,28,10,0,9,38
47257,104,60,22,6,16,88
47258,14,6,5,0,3,11
47259,110,90,3,3,14,96
47260,1,1,0,0,0,1
47261,47,15,24,1,7,40
47262,159,67,32,21,39,120
47263,111,49,14,23,25,86
47264,201,69,62,27,43,158
47265,93,47,16,8,22,71
47266,43,7,24,2,10,33
47267,10,6,2,0,2,8
47268,32,21,9,0,2,30
47269,33,24,5,0,4,29
47270,212,128,13,25,46,166
47271,69,27,26,0,16,53
47272,55,32,13,2,8,47
47273,32,21,9,0,2,30
47274,31,16,10,0,5,26
47275,123,55,18,18,32,91
47276,89,67,3,0,19,70
47277,590,339,122,18,111,479
47278,30,16,5,0,9,21
47279,32,22,0,3,7,25
47280,47,9,18,8,12,35
47281,38,7,27,0,4,34
47282,35,14,14,2,5,30
47283,65,44,6,1,14,51
47284,36,7,22,1,6,30
47285,19,5,10,0,4,15
47286,155,69,25,24,37,118
47287,32,21,9,0,2,30
47288,86,17,46,1,22,64
47289,26,14,8,0,4,22
47290,139,80,13,19,27,112
47291,22,15,2,0,5,17
47292,24,13,5,1,5,19
47293,261,124,70,16,51,210
47294,52,17,21,4,10,42
47295,46,18,20,0,8,38
47296,68,37,12,0,19,49
47297,33,1,27,0,5,28
47298,263,196,16,0,51,212
47299,82,35,30,5,12,70
47300,20,5,12,0,3,17
47301,57,22,17,2,16,41
47302,27,15,7,0,5,22
47303,158,89,27,13,29,129
47304,166,115,37,3,11,155
47305,13,7,2,0,4,9
47306,228,153,34,0,41,187
47307,63,48,2,0,13,50
47308,140,46,45,22,27,113
47309,1,0,0,0,1,0
47310,14,3,10,0,1,13
47311,16,3,7,1,5,11
47312,31,14,9,0,8,23
47313,19,5,10,0,4,15
47314,64,17,37,1,9,55
47315,29,19,6,1,3,26
47316,76,39,16,2,19,57
47317,117,52,27,15,23,94
47318,42,22,10,0,10,32
47319,277,15,211,0,51,226
47320,369,265,31,0,73,296
47321,44,22,7,6,9,35
47322,7,1,5,0,1,6
47323,16,12,3,0,1,15
47324,348,150,124,6,68,280
47325,31,13,6,6,6,25
47326,88,22,42,2,22,66
47327,69,27,9,10,23,46
47328,44,7,29,0,8,36
47329,138,39,67,1,31,107
47330,5,3,1,0,1,4
47331,34,13,15,1,5,29
47332,94,51,25,4,14,80
47333,27,14,10,2,1,26
47334,32,21,9,0,2,30
47335,24,9,11,1,3,21
47336,51,21,22,0,8,43
47337,32,15,2,5,10,22
47338,47,21,15,0,11,36
47339,22,9,3,3,7,15
47340,43,24,8,2,9,34
47341,75,18,26,16,15,60
47342,93,62,9,2,20,73
47343,50,23,13,3,11,39
47344,37,24,4,3,6,31
47345,48,34,2,3,9,39
47346,148,53,36,29,30,118
47347,342,147,119,6,70,272
47348,36,7,21,0,8,28
47349,176,108,5,21,42,134
47350,64,5,44,0,15,49
47351,83,24,18,18,23,60
47352,147,64,54,1,28,119
47353,72,15,39,7,11,61
47354,14,2,8,3,1,13
47355,11,1,4,0,6,5
47356,63,19,27,5,12,51
47357,102,53,23,7,19,83
47358,90,32,39,3,16,74
47359,200,78,13,71,38,162
47360,164,129,14,1,20,144
47361,34,21,9,1,3,31
47362,15,10,2,0,3,12
47363,56,13,30,0,13,43
47364,55,2,44,0,9,46
47365,37,14,14,0,9,28
47366,21,6,9,0,6,15
47367,60,22,20,3,15,45
47368,65,34,14,0,17,48
47369,90,19,30,22,19,71
47370,94,49,13,17,15,79
47371,76,49,9,3,15,61
47372,104,44,13,16,31,73
47373,27,8,16,1,2,25
47374,62,23,20,1,18,44
47375,263,179,62,3,19,244
47376,37,11,22,0,4,33
47377,16,2,13,0,1,15
47378,33,4,23,0,6,27
47379,83,49,17,1,16,67
47380,137,53,44,9,31,106
47381,62,21,21,8,12,50
47382,68,26,31,0,11,57
47383,14,7,5,0,2,12
47384,90,61,14,0,15,75
47385,74,51,2,2,19,55
47386,66,21,29,2,14,52
47387,35,16,10,3,6,29
47388,9,5,0,3,1,8
47389,141,47,68,0,26,115
47390,2,0,0,1,1,1
47391,62,16,27,7,12,50
47392,30,14,9,0,7,23
47393,257,192,13,1,51,206
47394,73,18,33,16,6,67
47395,51,16,27,0,8,43
47396,22,5,12,0,5,17
47397,16,8,4,0,4,12
47398,91,46,31,7,7,84
47399,194,139,8,3,44,150
47400,22,11,8,1,2,20
47401,84,61,9,1,13,71
47402,44,19,17,1,7,37
47403,53,38,9,6,0,53
47404,29,7,13,1,8,21
47405,58,27,15,0,16,42
47406,61,25,12,8,16,45
47407,56,24,19,1,12,44
47408,5,0,3,0,2,3
47409,163,53,50,23,37,126
47410,32,4,25,0,3,29
47411,99,45,12,21,21,78
47412,49,8,25,5,11,38
47413,93,36,31,2,24,69
47414,104,35,52,0,17,87
47415,286,193,68,3,22,264
47416,41,13,13,6,9,32
47417,114,73,3,10,28,86
47418,93,67,7,0,19,74
47419,98,46,33,0,19,79
47420,46,18,20,0,8,38
47421,140,56,46,14,24,116
47422,36,1,27,1,7,29
47423,141,25,89,1,26,115
47424,637,386,108,8,135,502
47425,30,14,6,3,7,23
47426,104,29,23,31,21,83
47427,211,114,47,0,50,161
47428,175,115,47,1,12,163
47429,215,160,14,0,41,174
47430,23,11,2,5,5,18
47431,155,38,82,1,34,121
47432,624,408,73,6,137,487
47433,51,24,18,0,9,42
47434,44,9,24,5,6,38
47435,39,7,23,2,7,32
47436,623,361,128,18,116,507
47437,55,18,21,2,14,41
47438,86,43,24,2,17,69
47439,46,22,15,0,9,37
47440,35,9,16,0,10,25
47441,367,177,73,46,71,296
47442,67,38,20,0,9,58
47443,104,30,56,0,18,86
47444,64,33,14,0,17,47
47445,180,88,32,29,31,149
47446,108,44,14,17,33,75
47447,335,200,64,0,71,264
47448,85,47,12,9,17,68
47449,89,57,16,1,15,74
47450,24,3,12,0,9,15
47451,10,2,6,0,2,8
47452,193,100,33,26,34,159
47453,32,21,9,0,2,30
47454,85,54,16,0,15,70
47455,33,25,3,0,5,28
47456,239,15,179,0,45,194
47457,151,82,30,7,32,119
47458,52,3,37,0,12,40
47459,31,18,3,0,10,21
47460,44,3,32,1,8,36
47461,41,22,10,0,9,32
47462,32,21,9,0,2,30
47463,78,22,41,2,13,65
47464,608,419,56,1,132,476
47465,574,338,126,15,95,479
47466,242,76,115,12,39,203
47467,47,14,24,1,8,39
47468,184,101,35,1,47,137
47469,168,74,54,7,33,135
47470,61,16,29,1,15,46
47471,59,33,9,0,17,42
47472,109,82,9,2,16,93
47473,406,132,142,47,85,321
47474,19,13,1,5,0,19
47475,46,18,20,0,8,38
47476,9,2,5,0,2,7
47477,25,15,4,0,6,19
47478,206,68,81,15,42,164
47479,10,6,1,3,0,10
47480,209,89,61,20,39,170
47481,39,9,15,7,8,31
47482,105,21,50,16,18,87
47483,79,50,17,0,12,67
47484,79,35,31,0,13,66
47485,20,3,11,0,6,14
47486,17,3,10,1,3,14
47487,116,55,28,6,27,89
47488,154,117,2,1,34,120
47489,43,7,27,5,4,39
47490,67,24,23,4,16,51
47491,104,62,24,0,18,86
47492,57,38,4,1,14,43
47493,61,36,15,0,10,51
47494,100,22,46,13,19,81
47495,38,21,8,0,9,29
47496,72,42,17,0,13,59
47497,46,18,17,0,11,35
47498,404,232,91,0,81,323
47499,28,11,6,6,5,23
47500,77,24,27,14,12,65
47501,28,19,5,0,4,24
47502,19,8,7,0,4,15
47503,5,0,4,0,1,4
47504,38,17,12,0,9,29
47505,104,38,44,3,19,85
47506,34,13,14,2,5,29
47507,16,4,7,0,5,11
47508,57,28,15,5,9,48
47509,176,48,52,40,36,140
47510,686,387,165,22,112,574
47511,13,0,12,0,1,12
47512,28,8,15,0,5,23
47513,276,110,105,16,45,231
47514,65,21,19,7,18,47
47515,1304,524,184,338,258,1046
47516,63,15,26,8,14,49
47517,47,12,20,2,13,34
47518,198,98,50,0,50,148
47519,79,49,16,0,14,65
47520,15,2,5,4,4,11
47521,320,152,90,16,62,258
47522,162,110,26,0,26,136
47523,27,8,16,1,2,25
47524,7,2,4,0,1,6
47525,5,2,1,1,1,4
47526,69,12,44,0,13,56
47527,10,3,3,0,4,6
47528,37,3,26,0,8,29
47529,107,27,28,29,23,84
47530,26,0,20,3,3,23
47531,33,8,17,0,8,25
47532,21,9,6,0,6,15
47533,8,5,0,1,2,6
47534,58,2,48,0,8,50
47535,79,38,25,1,15,64
47536,46,24,15,1,6,40
47537,90,26,38,6,20,70
47538,33,12,12,2,7,26
47539,54,24,18,1,11,43
47540,127,41,47,7,32,95
47541,29,7,12,5,5,24
47542,84,50,16,2,16,68
47543,58,14,34,1,9,49
47544,43,11,24,1,7,36
47545,34,14,13,0,7,27
47546,72,53,0,0,19,53
47547,283,177,40,12,54,229
47548,105,53,21,4,27,78
47549,86,44,22,1,19,67
47550,20,18,0,0,2,18
47551,81,40,16,8,17,64
47552,496,257,93,46,100,396
47553,35,5,23,2,5,30
47554,27,14,9,0,4,23
47555,330,141,114,6,69,261
47556,185,118,25,9,33,152
47557,108,53,25,5,25,83
47558,334,140,123,10,61,273
47559,28,6,15,2,5,23
47560,68,14,37,1,16,52
47561,32,16,6,0,10,22
47562,251,178,14,5,54,197
47563,161,56,50,25,30,131
47564,63,28,22,3,10,53
47565,125,62,22,14,27,98
47566,76,57,6,0,13,63
47567,27,18,3,1,5,22
47568,14,9,3,0,2,12
47569,142,40,70,1,31,111
47570,76,52,15,6,3,73
47571,1,1,0,0,0,1
47572,44,11,23,0,10,34
47573,128,83,15,7,23,105
47574,60,29,22,2,7,53
47575,3,0,0,0,3,0
47576,14,10,2,0,2,12
47577,2,1,0,0,1,1
47578,106,42,35,9,20,86
47579,511,215,131,50,115,396
47580,155,55,38,30,32,123
47581,38,18,12,0,8,30
47582,46,18,20,0,8,38
47583,27,17,4,3,3,24
47584,420,112,167,46,95,325
47585,53,27,10,7,9,44
47586,36,18,9,0,9,27
47587,673,392,151,19,111,562
47588,88,45,24,2,17,71
47589,34,17,12,0,5,29
47590,32,9,14,3,6,26
47591,350,186,92,15,57,293
47592,48,16,19,2,11,37
47593,89,27,44,4,14,75
47594,102,54,23,6,19,83
47595,47,3,9,27,8,39
47596,42,16,18,0,8,34
47597,97,55,7,11,24,73
47598,32,21,9,0,2,30
47599,128,54,32,17,25,103
47600,51,25,16,0,10,41
47601,142,47,72,3,20,122
47602,164,63,67,0,34,130
47603,55,33,9,0,13,42
47604,43,11,27,0,5,38
47605,274,89,125,15,45,229
47606,24,2,20,0,2,22
47607,107,77,13,2,15,92
47608,49,22,7,11,9,40
47609,25,9,10,3,3,22
47610,38,6,4,19,9,29
47611,23,11,4,3,5,18
47612,87,29,43,0,15,72
47613,103,56,25,3,19,84
47614,143,59,47,8,29,114
47615,98,31,36,8,23,75
47616,160,93,37,1,29,131
47617,29,5,18,0,6,23
47618,23,3,17,0,3,20
47619,32,21,9,0,2,30
47620,12,6,5,0,1,11
47621,102,47,14,20,21,81
47622,46,18,20,0,8,38
47623,12,7,2,0,3,9
47624,6,1,3,0,2,4
47625,419,193,122,25,79,340
47626,125,81,21,0,23,102
47627,34,12,14,0,8,26
47628,20,7,9,0,4,16
47629,139,64,44,5,26,113
47630,110,34,34,15,27,83
47631,121,73,24,1,23,98
47632,27,7,14,2,4,23
47633,31,5,22,2,2,29
47634,6,0,5,1,0,6
47635,204,77,39,38,50,154
47636,73,63,2,0,8,65
47637,66,46,1,0,19,47
47638,16,6,4,0,6,10
47639,32,18,2,4,8,24
47640,111,47,35,5,24,87
47641,55,11,27,5,12,43
47642,36,5,14,9,8,28
47643,45,33,0,0,12,33
47644,122,36,46,19,21,101
47645,87,44,24,2,17,70
47646,12,5,4,1,2,10
47647,109,59,24,4,22,87
47648,44,19,13,6,6,38
47649,58,41,6,2,9,49
47650,47,13,23,0,11,36
47651,194,129,21,0,44,150
47652,51,21,21,4,5,46
47653,230,78,87,15,50,180
47654,52,36,2,0,14,38
47655,23,1,13,1,8,15
47656,162,72,49,9,32,130
47657,38,15,18,0,5,33
47658,280,175,42,0,63,217
47659,43,24,8,1,10,33
47660,253,137,72,0,44,209
47661,26,6,15,0,5,21
47662,51,25,10,7,9,42
47663,26,1,20,0,5,21
47664,38,18,7,5,8,30
47665,221,73,83,15,50,171
47666,115,60,21,12,22,93
47667,2,1,0,0,1,1
47668,206,31,137,0,38,168
47669,156,33,56,33,34,122
47670,451,209,142,10,90,361
47671,23,1,16,1,5,18
47672,524,359,55,1,109,415
47673,10,1,6,0,3,7
47674,671,391,144,17,119,552
47675,233,155,32,0,46,187
47676,146,63,31,17,35,111
47677,197,89,50,20,38,159
47678,31,12,2,13,4,27
47679,5,1,2,0,2,3
47680,218,147,30,0,41,177
47681,43,14,18,4,7,36
47682,38,10,15,6,7,31
47683,45,23,3,11,8,37
47684,105,43,47,2,13,92
47685,52,19,27,0,6,46
47686,502,265,111,17,109,393
47687,51,16,25,4,6,45
47688,7,0,4,0,3,4
47689,30,22,0,0,8,22
47690,41,7,24,1,9,32
47691,88,39,29,4,16,72
47692,45,21,15,0,9,36
47693,300,192,44,10,54,246
47694,76,13,39,6,18,58
47695,92,59,15,0,18,74
47696,282,67,61,98,56,226
47697,47,16,10,8,13,34
47698,53,21,23,1,8,45
47699,81,29,35,0,17,64
47700,20,1,14,0,5,15
47701,15,6,3,4,2,13
47702,10,3,4,1,2,8
47703,12,8,0,0,4,8
47704,116,51,33,0,32,84
47705,248,152,42,6,48,200
47706,60,22,24,1,13,47
47707,110,75,11,1,23,87
47708,157,66,48,11,32,125
47709,55,32,14,0,9,46
47710,62,31,24,2,5,57
47711,56,21,21,5,9,47
47712,50,23,13,2,12,38
47713,31,16,6,0,9,22
47714,69,32,29,0,8,61
47715,215,89,68,20,38,177
47716,32,21,9,0,2,30
47717,450,239,116,18,77,373
47718,61,18,24,6,13,48
47719,187,58,78,13,38,149
47720,434,319,24,1,90,344
47721,32,4,11,12,5,27
47722,55,4,9,28,14,41
47723,85,32,15,21,17,68
47724,46,18,20,0,8,38
47725,16,7,5,0,4,12
47726,28,17,4,0,7,21
47727,103,39,47,0,17,86
47728,130,88,17,1,24,106
47729,37,20,12,1,4,33
47730,51,21,6,16,8,43
47731,64,22,16,7,19,45
47732,41,14,17,4,6,35
47733,53,5,37,0,11,42
47734,65,31,21,3,10,55
47735,62,30,18,0,14,48
47736,41,27,1,0,13,28
47737,43,18,14,1,10,33
47738,33,12,10,1,10,23
47739,209,107,32,33,37,172
47740,155,47,82,4,22,133
47741,20,9,4,0,7,13
47742,55,32,15,2,6,49
47743,213,53,47,77,36,177
47744,27,11,10,2,4,23
47745,94,53,16,11,14,80
47746,32,21,9,0,2,30
47747,138,52,28,27,31,107
47748,112,106,0,6,0,112
47749,281,17,207,2,55,226
47750,64,12,38,0,14,50
47751,466,228,91,50,97,369
47752,54,30,9,4,11,43
47753,30,11,3,13,3,27
47754,2,2,0,0,0,2
47755,454,127,193,37,97,357
47756,55,23,13,6,13,42
47757,26,8,12,0,6,20
47758,56,6,41,1,8,48
47759,55,23,15,2,15,40
47760,247,129,51,16,51,196
47761,29,15,5,0,9,20
47762,14,4,2,5,3,11
47763,38,22,6,3,7,31
47764,32,21,9,0,2,30
47765,211,114,47,0,50,161
47766,253,188,13,1,51,202
47767,29,4,16,2,7,22
47768,151,46,46,23,36,115
47769,542,319,119,14,90,452
47770,96,64,14,0,18,78
47771,551,387,47,1,116,435
47772,95,42,27,1,25,70
47773,462,243,105,13,101,361
47774,55,20,19,1,15,40
47775,59,19,29,2,9,50
47776,58,35,16,2,5,53
47777,178,100,33,0,45,133
47778,27,17,4,3,3,24
47779,75,36,20,0,19,56
47780,60,1,24,26,9,51
47781,289,74,139,6,70,219
47782,156,76,49,5,26,130
47783,25,10,13,0,2,23
47784,106,10,63,10,23,83
47785,97,51,19,5,22,75
47786,27,16,6,1,4,23
47787,32,12,2,14,4,28
47788,90,36,21,13,20,70
47789,105,45,33,2,25,80
47790,114,48,14,18,34,80
47791,126,93,4,0,29,97
47792,428,204,120,13,91,337
47793,56,28,5,4,19,37
47794,29,10,10,0,9,20
47795,55,33,10,0,12,43
47796,44,34,6,1,3,41
47797,130,37,67,0,26,104
47798,31,0,11,15,5,26
47799,666,390,142,17,117,549
47800,79,15,56,2,6,73
47801,9,8,0,0,1,8
47802,128,52,28,21,27,101
47803,24,13,8,1,2,22
47804,64,33,14,0,17,47
47805,29,5,22,0,2,27
47806,53,32,11,2,8,45
47807,97,72,4,1,20,77
47808,43,27,4,1,11,32
47809,61,20,15,9,17,44
47810,22,13,4,0,5,17
47811,15,12,1,0,2,13
47812,5,4,0,0,1,4
47813,77,9,50,3,15,62
47814,221,126,73,5,17,204
47815,371,166,124,11,70,301
47816,37,19,8,1,9,28
47817,92,21,44,3,24,68
47818,215,86,37,41,51,164
47819,9,4,2,0,3,6
47820,44,37,1,0,6,38
47821,16,10,2,0,4,12
47822,164,55,84,4,21,143
47823,80,37,30,1,12,68
47824,342,179,92,16,55,287
47825,69,40,16,0,13,56
47826,420,196,133,10,81,339
47827,41,32,1,0,8,33
47828,21,7,10,0,4,17
47829,26,13,8,0,5,21
47830,557,322,112,17,106,451
47831,20,6,9,0,5,15
47832,456,238,74,42,102,354
47833,68,33,26,1,8,60
47834,77,16,43,7,11,66
47835,98,43,33,4,18,80
47836,53,34,8,0,11,42
47837,107,54,28,5,20,87
47838,31,4,21,0,6,25
47839,206,57,111,4,34,172
47840,50,16,19,1,14,36
47841,120,63,22,10,25,95
47842,22,12,5,0,5,17
47843,59,19,15,13,12,47
47844,136,43,63,4,26,110
47845,15,15,0,0,0,15
47846,108,44,10,28,26,82
47847,104,66,19,2,17,87
47848,35,19,11,0,5,30
47849,200,110,28,23,39,161
47850,32,21,9,0,2,30
47851,16,10,2,0,4,12
47852,291,208,16,4,63,228
47853,17,1,13,0,3,14
47854,109,53,38,1,17,92
47855,112,49,37,0,26,86
47856,7,0,4,0,3,4
47857,8,4,1,1,2,6
47858,59,29,20,0,10,49
47859,16,10,3,0,3,13
47860,527,293,117,17,100,427
47861,140,105,4,3,28,112
47862,63,23,27,1,12,51
47863,6,1,4,0,1,5
47864,203,78,15,70,40,163
47865,45,35,6,1,3,42
47866,141,61,31,17,32,109
47867,66,50,5,4,7,59
47868,81,54,17,1,9,72
47869,69,40,12,4,13,56
47870,17,6,5,0,6,11
47871,67,33,15,2,17,50
47872,471,217,157,10,87,384
47873,6,5,0,1,0,6
47874,21,13,1,3,4,17
47875,60,45,3,2,10,50
47876,60,32,18,0,10,50
47877,302,141,88,12,61,241
47878,15,9,4,0,2,13
47879,14,6,1,2,5,9
47880,26,11,8,1,6,20
47881,49,30,3,9,7,42
47882,73,44,15,0,14,59
47883,162,102,4,18,38,124
47884,9,3,2,0,4,5
47885,2,0,2,0,0,2
47886,71,27,25,2,17,54
47887,53,16,30,0,7,46
47888,45,0,26,3,16,29
47889,18,11,5,0,2,16
47890,12,7,4,0,1,11
47891,37,9,17,2,9,28
47892,220,149,30,0,41,179
47893,81,42,9,19,11,70
47894,206,93,57,13,43,163
47895,406,229,94,0,83,323
47896,113,23,54,14,22,91
47897,37,13,11,0,13,24
47898,45,25,13,0,7,38
47899,61,30,7,8,16,45
47900,193,104,57,0,32,161
47901,78,47,21,1,9,69
47902,106,53,18,14,21,85
47903,77,44,3,15,15,62
47904,20,9,2,3,6,14
47905,170,112,27,1,30,140
47906,32,21,9,0,2,30
47907,134,50,48,8,28,106
47908,47,29,10,0,8,39
47909,73,39,11,8,15,58
47910,63,16,25,8,14,49
47911,12,0,9,0,3,9
47912,423,197,121,13,92,331
47913,106,56,24,4,22,84
47914,368,200,90,8,70,298
47915,44,31,4,0,9,35
47916,9,1,7,0,1,8
47917,58,14,32,1,11,47
47918,193,74,64,7,48,145
47919,111,49,32,0,30,81
47920,66,15,39,1,11,55
47921,23,9,5,0,9,14
47922,54,29,18,0,7,47
47923,52,36,2,0,14,38
47924,85,42,5,25,13,72
47925,73,24,21,10,18,55
47926,7,0,5,0,2,5
47927,109,36,51,0,22,87
47928,356,159,122,6,69,287
47929,172,111,27,0,34,138
47930,110,23,53,0,34,76
47931,97,62,22,0,13,84
47932,163,96,16,14,37,126
47933,310,131,113,6,60,250
47934,15,5,5,0,5,10
47935,25,10,10,0,5,20
47936,67,46,6,0,15,52
47937,11,10,0,0,1,10
47938,6,1,4,0,1,5
47939,150,109,9,4,28,122
47940,25,15,6,0,4,21
47941,10,5,0,0,5,5
47942,31,9,19,0,3,28
47943,46,18,20,0,8,38
47944,24,16,5,0,3,21
47945,103,52,22,7,22,81
47946,35,21,4,4,6,29
47947,30,15,11,0,4,26
47948,31,15,10,2,4,27
47949,74,38,8,17,11,63
47950,8,2,2,0,4,4
47951,24,8,5,5,6,18
47952,131,52,31,15,33,98
47953,666,386,137,20,123,543
47954,93,63,6,0,24,69
47955,25,14,6,1,4,21
47956,236,113,68,4,51,185
47957,137,37,68,1,31,106
47958,28,12,14,0,2,26
47959,35,15,10,0,10,25
47960,38,18,15,0,5,33
47961,97,26,56,1,14,83
47962,103,71,12,2,18,85
47963,26,3,8,7,8,18
47964,199,85,70,4,40,159
47965,77,16,37,5,19,58
47966,58,41,6,1,10,48
47967,241,162,58,4,17,224
47968,13,3,9,0,1,12
47969,80,29,35,1,15,65
47970,32,21,9,0,2,30
47971,31,19,3,0,9,22
47972,198,83,47,23,45,153
47973,77,47,21,9,0,77
47974,218,167,6,2,43,175
47975,147,59,57,6,25,122
47976,30,11,3,13,3,27
47977,14,9,1,0,4,10
47978,161,102,3,18,38,123
47979,34,8,18,1,7,27
47980,119,32,37,24,26,93
47981,76,34,5,15,22,54
47982,62,41,5,0,16,46
47983,36,17,13,0,6,30
47984,68,38,16,0,14,54
47985,54,36,5,0,13,41
47986,32,21,9,0,2,30
47987,67,27,17,8,15,52
47988,45,22,8,5,10,35
47989,198,98,50,0,50,148
47990,10,1,7,0,2,8
47991,50,25,17,0,8,42
47992,14,4,5,1,4,10
47993,54,25,14,2,13,41
47994,27,18,0,0,9,18
47995,133,53,53,2,25,108
47996,84,58,5,0,21,63
47997,75,42,19,6,8,67
47998,25,1,17,1,6,19
47999,84,56,13,0,15,69
48000,220,149,30,0,41,179
48001,96,54,26,0,16,80
48002,103,38,24,19,22,81
48003,25,9,9,1,6,19
48004,250,184,13,1,52,198
48005,35,4,26,0,5,30
48006,72,29,24,4,15,57
48007,96,50,28,1,17,79
48008,75,11,49,0,15,60
48009,101,80,2,2,17,84
48010,2,1,1,0,0,2
48011,31,9,19,0,3,28
48012,16,3,9,0,4,12
48013,115,32,32,27,24,91
48014,65,28,24,5,8,57
48015,62,23,20,1,18,44
48016,38,17,16,0,5,33
48017,42,27,8,0,7,35
48018,37,3,26,0,8,29
48019,7,5,1,0,1,6
48020,147,85,22,3,37,110
48021,32,21,9,0,2,30
48022,73,19,42,1,11,62
48023,46,18,20,0,8,38
48024,18,6,10,1,1,17
48025,78,54,2,0,22,56
48026,108,58,28,0,22,86
48027,22,0,19,1,2,20
48028,91,23,25,28,15,76
48029,90,32,33,6,19,71
48030,48,15,24,1,8,40
48031,19,8,5,0,6,13
48032,75,20,37,1,17,58
48033,39,19,13,0,7,32
48034,120,93,6,0,21,99
48035,27,7,9,5,6,21
48036,32,14,8,2,8,24
48037,81,45,19,1,16,65
48038,160,93,37,1,29,131
48039,113,59,22,9,23,90
48040,126,46,34,18,28,98
48041,37,22,6,1,8,29
48042,26,13,11,1,1,25
48043,32,19,7,0,6,26
48044,42,33,3,1,5,37
48045,122,39,55,0,28,94
48046,4,1,3,0,0,4
48047,63,43,8,0,12,51
48048,1,0,0,0,1,0
48049,107,42,36,7,22,85
48050,32,21,9,0,2,30
48051,32,23,3,1,5,27
48052,358,196,90,15,57,301
48053,44,26,5,0,13,31
48054,28,15,8,0,5,23
48055,115,51,27,12,25,90
48056,109,71,20,0,18,91
48057,21,0,19,0,2,19
48058,113,47,40,2,24,89
48059,454,334,20,0,100,354
48060,33,18,10,0,5,28
48061,135,105,7,1,22,113
48062,46,18,20,0,8,38
48063,26,9,10,1,6,20
48064,42,19,11,1,11,31
48065,46,26,8,0,12,34
48066,91,33,11,27,20,71
48067,50,32,1,5,12,38
48068,67,29,18,9,11,56
48069,97,41,34,4,18,79
48070,50,20,21,0,9,41
48071,98,40,35,7,16,82
48072,97,62,24,0,11,86
48073,70,11,46,0,13,57
48074,15,8,5,0,2,13
48075,49,23,3,13,10,39
48076,8,5,3,0,0,8
48077,19,5,12,1,1,18
48078,177,46,55,40,36,141
48079,171,113,27,1,30,141
48080,216,47,112,4,53,163
48081,153,101,29,0,23,130
48082,55,44,1,0,10,45
48083,59,42,10,1,6,53
48084,42,13,22,0,7,35
48085,380,175,127,8,70,310
48086,32,17,10,1,4,28
48087,188,97,29,28,34,154
48088,45,29,7,0,9,36
48089,104,58,8,19,19,85
48090,85,24,35,12,14,71
48091,220,149,30,0,41,179
48092,323,143,119,5,56,267
48093,18,1,10,5,2,16
48094,32,8,14,1,9,23
48095,69,44,12,1,12,57
48096,20,1,11,0,8,12
48097,34,17,10,0,7,27
48098,105,26,27,29,23,82
48099,74,28,26,3,17,57
48100,15,7,4,0,4,11
48101,32,17,10,0,5,27
48102,14,4,6,0,4,10
48103,51,25,14,0,12,39
48104,88,5,57,8,18,70
48105,244,101,15,83,45,199
48106,155,98,31,0,26,129
48107,73,48,6,1,18,55
48108,150,67,31,18,34,116
48109,85,44,12,8,21,64
48110,109,48,32,2,27,82
48111,155,53,32,34,36,119
48112,32,15,4,5,8,24
48113,32,13,13,0,6,26
48114,70,16,40,0,14,56
48115,32,21,9,0,2,30
48116,60,38,3,9,10,50
48117,2,1,0,0,1,1
48118,123,92,4,1,26,97
48119,209,130,38,2,39,170
48120,28,10,12,0,6,22
48121,140,66,43,9,22,118
48122,141,40,65,3,33,108
48123,21,4,16,0,1,20
48124,100,44,23,11,22,78
48125,41,21,14,1,5,36
48126,42,28,5,0,9,33
48127,8,3,4,0,1,7
48128,220,149,30,0,41,179
48129,169,128,5,2,34,135
48130,5,1,3,0,1,4
48131,204,80,12,74,38,166
48132,58,14,34,1,9,49
48133,96,36,29,12,19,77
48134,9,2,5,0,2,7
48135,433,109,178,48,98,335
48136,40,28,7,0,5,35
48137,85,20,48,0,17,68
48138,93,35,29,9,20,73
48139,155,95,34,3,23,132
48140,117,74,21,2,20,97
48141,68,32,24,1,11,57
48142,53,19,21,1,12,41
48143,18,11,3,2,2,16
48144,81,23,36,6,16,65
48145,146,63,31,17,35,111
48146,46,25,3,10,8,38
48147,73,34,30,0,9,64
48148,58,2,48,0,8,50
48149,71,54,2,0,15,56
48150,51,7,27,5,12,39
48151,28,7,16,2,3,25
48152,14,6,5,1,2,12
48153,23,12,7,0,4,19
48154,25,7,12,1,5,20
48155,45,8,25,0,12,33
48156,43,14,16,4,9,34
48157,215,88,37,38,52,163
48158,32,21,9,0,2,30
48159,50,35,0,0,15,35
48160,23,8,9,0,6,17
48161,57,15,33,1,8,49
48162,79,22,42,2,13,66
48163,332,196,65,0,71,261
48164,46,18,20,0,8,38
48165,112,55,34,5,18,94
48166,295,78,33,135,49,246
48167,165,97,38,1,29,136
48168,32,21,9,0,2,30
48169,29,9,13,0,7,22
48170,102,67,1,12,22,80
48171,261,62,133,7,59,202
48172,11,7,1,0,3,8
48173,110,39,26,20,25,85
48174,52,38,7,0,7,45
48175,466,320,45,1,100,366
48176,10,3,3,0,4,6
48177,4,0,2,0,2,2
48178,649,382,145,18,104,545
48179,14,2,5,2,5,9
48180,81,52,11,0,18,63
48181,51,21,19,1,10,41
48182,31,18,3,0,10,21
48183,82,38,5,16,23,59
48184,14,8,0,2,4,10
48185,97,27,21,28,21,76
48186,40,29,6,0,5,35
48187,17,12,1,3,1,16
48188,33,20,6,0,7,26
48189,6,3,3,0,0,6
48190,73,30,20,1,22,51
48191,55,37,7,2,9,46
48192,38,22,5,3,8,30
48193,43,27,6,2,8,35
48194,475,217,161,13,84,391
48195,30,19,2,0,9,21
48196,27,15,9,1,2,25
48197,21,10,10,0,1,20
48198,88,44,25,2,17,71
48199,19,4,9,0,6,13
48200,36,5,23,0,8,28
48201,20,2,16,0,2,18
48202,283,189,68,3,23,260
48203,58,23,19,3,13,45
48204,6,6,0,0,0,6
48205,30,11,14,0,5,25
48206,63,44,9,0,10,53
48207,55,33,14,2,6,49
48208,97,41,34,4,18,79
48209,175,57,86,0,32,143
48210,83,28,41,4,10,73
48211,32,21,9,0,2,30
48212,301,147,86,4,64,237
48213,38,21,8,0,9,29
48214,61,49,0,1,11,50
48215,31,9,7,10,5,26
48216,8,7,1,0,0,8
48217,167,83,48,3,33,134
48218,63,39,11,0,13,50
48219,232,78,91,14,49,183
48220,335,160,93,11,71,264
48221,83,28,31,11,13,70
48222,84,60,5,1,18,66
48223,115,75,24,3,13,102
48224,95,39,35,5,16,79
48225,61,39,9,0,13,48
48226,39,10,24,0,5,34
48227,55,32,15,2,6,49
48228,145,102,20,0,23,122
48229,352,187,90,15,60,292
48230,53,23,13,2,15,38
48231,48,31,10,0,7,41
48232,32,21,9,0,2,30
48233,233,57,118,4,54,179
48234,27,8,13,1,5,22
48235,165,85,39,0,41,124
48236,172,125,21,0,26,146
48237,239,156,65,2,16,223
48238,56,19,16,6,15,41
48239,56,36,5,6,9,47
48240,32,11,6,8,7,25
48241,21,13,4,1,3,18
48242,28,15,5,1,7,21
48243,14,9,2,0,3,11
48244,49,25,12,1,11,38
48245,15,5,6,1,3,12
48246,236,64,120,1,51,185
48247,18,4,11,0,3,15
48248,40,19,9,1,11,29
48249,280,189,68,3,20,260
48250,46,18,20,0,8,38
48251,50,18,9,13,10,40
48252,89,53,22,1,13,76
48253,17,9,2,1,5,12
48254,197,101,48,0,48,149
48255,61,35,14,0,12,49
48256,64,16,27,7,14,50
48257,30,16,7,2,5,25
48258,133,103,10,0,20,113
48259,14,4,6,2,2,12
48260,47,6,13,17,11,36
48261,56,8,37,0,11,45
48262,55,24,22,2,7,48
48263,658,386,140,17,115,543
48264,582,399,54,1,128,454
48265,216,86,14,77,39,177
48266,51,31,13,0,7,44
48267,55,33,10,0,12,43
48268,64,43,12,0,9,55
48269,17,10,1,0,6,11
48270,82,34,23,5,20,62
48271,268,200,15,0,53,215
48272,53,36,6,0,11,42
48273,47,28,11,8,0,47
48274,56,29,15,1,11,45
48275,7,7,0,0,0,7
48276,27,9,15,0,3,24
48277,24,9,7,0,8,16
48278,33,11,11,1,10,23
48279,91,26,36,3,26,65
48280,29,16,6,0,7,22
48281,19,2,10,0,7,12
48282,208,137,23,0,48,160
48283,652,366,158,22,106,546
48284,124,96,8,2,18,106
48285,97,32,41,7,17,80
48286,137,82,29,0,26,111
48287,73,36,17,5,15,58
48288,113,54,43,3,13,100
48289,21,16,4,0,1,20
48290,100,77,3,0,20,80
48291,188,115,39,19,15,173
48292,110,53,38,1,18,92
48293,109,105,0,4,0,109
48294,81,35,32,0,14,67
48295,2,0,1,0,1,1
48296,195,94,58,1,42,153
48297,80,36,28,0,16,64
48298,46,18,20,0,8,38
48299,18,6,6,0,6,12
48300,157,98,31,1,27,130
48301,445,113,187,45,100,345
48302,46,18,20,0,8,38
48303,49,24,20,0,5,44
48304,82,39,21,3,19,63
48305,111,77,15,10,9,102
48306,14,2,8,2,2,12
48307,429,134,177,25,93,336
48308,32,15,4,5,8,24
48309,30,18,6,1,5,25
48310,636,381,108,9,138,498
48311,54,14,27,5,8,46
48312,48,20,15,4,9,39
48313,296,23,215,2,56,240
48314,37,8,22,0,7,30
48315,101,31,37,6,27,74
48316,308,161,86,0,61,247
48317,352,186,91,15,60,292
48318,33,25,3,0,5,28
48319,35,20,4,2,9,26
48320,78,55,5,6,12,66
48321,78,46,18,0,14,64
48322,174,127,5,1,41,133
48323,301,183,44,17,57,244
48324,440,200,147,11,82,358
48325,55,24,21,2,8,47
48326,45,12,25,0,8,37
48327,107,82,5,0,20,87
48328,181,103,15,21,42,139
48329,46,18,20,0,8,38
48330,203,123,12,24,44,159
48331,131,74,14,17,26,105
48332,100,72,14,0,14,86
48333,6,2,3,0,1,5
48334,46,21,13,0,12,34
48335,66,38,3,13,12,54
48336,92,34,38,3,17,75
48337,44,10,21,0,13,31
48338,41,15,15,0,11,30
48339,209,111,47,14,37,172
48340,67,48,8,0,11,56
48341,400,299,20,0,81,319
48342,1,1,0,0,0,1
48343,8,2,3,1,2,6
48344,129,40,35,29,25,104
48345,51,21,12,1,17,34
48346,151,22,70,25,34,117
48347,19,12,0,0,7,12
48348,26,12,3,5,6,20
48349,189,108,23,23,35,154
48350,250,103,18,82,47,203
48351,13,2,8,1,2,11
48352,6,1,4,0,1,5
48353,91,19,46,10,16,75
48354,96,43,10,18,25,71
48355,17,15,0,0,2,15
48356,38,6,24,0,8,30
48357,58,7,34,4,13,45
48358,58,19,23,8,8,50
48359,447,216,123,14,94,353
48360,35,22,7,0,6,29
48361,32,13,9,1,9,23
48362,40,29,6,5,0,40
48363,10,5,5,0,0,10
48364,35,22,6,0,7,28
48365,16,8,2,0,6,10
48366,87,33,34,1,19,68
48367,54,38,2,0,14,40
48368,163,29,102,1,31,132
48369,149,60,45,9,35,114
48370,36,27,2,0,7,29
48371,18,10,1,0,7,11
48372,70,45,11,2,12,58
48373,208,110,34,20,44,164
48374,120,65,9,22,24,96
48375,45,37,1,0,7,38
48376,99,42,22,11,24,75
48377,76,26,38,0,12,64
48378,7,6,0,0,1,6
48379,123,59,32,0,32,91
48380,144,35,77,1,31,113
48381,22,12,8,0,2,20
48382,123,46,43,8,26,97
48383,31,15,8,0,8,23
48384,38,4,14,10,10,28
48385,78,17,27,18,16,62
48386,54,31,11,0,12,42
48387,42,9,14,8,11,31
48388,136,63,39,5,29,107
48389,30,17,7,0,6,24
48390,43,8,21,5,9,34
48391,14,3,7,1,3,11
48392,47,23,12,0,12,35
48393,33,19,7,0,7,26
48394,38,10,16,5,7,31
48395,129,87,17,1,24,105
48396,29,16,8,0,5,24
48397,111,81,7,0,23,88
48398,36,9,17,1,9,27
48399,45,19,15,2,9,36
48400,70,41,15,0,14,56
48401,48,30,6,0,12,36
48402,99,35,43,4,17,82
48403,56,39,2,1,14,42
48404,192,75,34,33,50,142
48405,21,5,7,2,7,14
48406,113,60,10,20,23,90
48407,32,16,3,5,8,24
48408,87,53,12,2,20,67
48409,121,44,33,21,23,98
48410,46,18,20,0,8,38
48411,17,10,4,0,3,14
48412,45,20,14,5,6,39
48413,16,3,12,0,1,15
48414,17,9,2,1,5,12
48415,427,197,145,9,76,351
48416,190,53,22,85,30,160
48417,66,5,44,4,13,53
48418,76,17,41,2,16,60
48419,26,10,8,2,6,20
48420,286,210,18,2,56,230
48421,114,33,52,3,26,88
48422,61,28,17,4,12,49
48423,37,18,9,1,9,28
48424,160,74,32,14,40,120
48425,299,79,34,138,48,251
48426,0,0,0,0,0,0
48427,222,154,48,2,18,204
48428,48,30,2,9,7,41
48429,31,11,14,0,6,25
48430,69,47,13,0,9,60
48431,85,39,28,4,14,71
48432,131,59,46,3,23,108
48433,13,5,4,0,4,9
48434,224,96,14,76,38,186
48435,112,51,41,1,19,93
48436,68,25,6,23,14,54
48437,24,5,14,1,4,20
48438,54,12,20,4,18,36
48439,78,23,40,2,13,65
48440,113,57,33,0,23,90
48441,64,5,44,0,15,49
48442,181,66,74,3,38,143
48443,57,27,22,2,6,51
48444,95,36,32,2,25,70
48445,111,59,31,0,21,90
48446,28,6,18,0,4,24
48447,104,74,12,10,8,96
48448,79,32,33,1,13,66
48449,116,44,35,16,21,95
48450,135,36,46,18,35,100
48451,82,36,31,4,11,71
48452,121,48,29,25,19,102
48453,55,40,7,1,7,48
48454,109,58,25,4,22,87
48455,644,379,140,15,110,534
48456,12,6,4,0,2,10
48457,126,46,48,9,23,103
48458,57,29,15,0,13,44
48459,141,61,31,18,31,110
48460,42,8,24,2,8,34
48461,38,17,16,0,5,33
48462,63,33,15,0,15,48
48463,27,5,15,1,6,21
48464,57,18,31,1,7,50
48465,32,21,9,0,2,30
48466,5,1,0,1,3,2
48467,10,7,1,0,2,8
48468,25,9,8,0,8,17
48469,80,20,35,8,17,63
48470,330,140,115,6,69,261
48471,34,10,16,1,7,27
48472,32,21,9,0,2,30
48473,527,290,116,13,108,419
48474,50,30,11,0,9,41
48475,174,121,10,10,33,141
48476,46,18,20,0,8,38
48477,141,26,88,1,26,115
48478,36,8,19,2,7,29
48479,37,10,11,12,4,33
48480,261,81,122,6,52,209
48481,19,6,8,0,5,14
48482,146,58,45,9,34,112
48483,126,51,31,18,26,100
48484,296,162,68,0,66,230
48485,76,38,20,0,18,58
48486,58,40,5,1,12,46
48487,14,9,2,0,3,11
48488,19,9,8,0,2,17
48489,2,0,2,0,0,2
48490,292,133,105,5,49,243
48491,145,91,27,3,24,121
48492,50,28,11,0,11,39
48493,40,17,12,1,10,30
48494,8,0,7,1,0,8
48495,96,39,35,0,22,74
48496,205,86,69,19,31,174
48497,381,167,132,11,71,310
48498,213,56,38,82,37,176
48499,145,65,49,1,30,115
48500,57,25,16,3,13,44
48501,383,201,90,17,75,308
48502,12,3,3,0,6,6
48503,30,13,12,1,4,26
48504,38,19,9,1,9,29
48505,24,20,2,0,2,22
48506,39,26,7,0,6,33
48507,204,63,98,10,33,171
48508,373,160,131,11,71,302
48509,188,71,63,7,47,141
48510,41,1,30,0,10,31
48511,49,29,10,0,10,39
48512,360,237,37,1,85,275
48513,41,21,7,8,5,36
48514,103,23,47,15,18,85
48515,423,199,119,14,91,332
48516,79,41,16,4,18,61
48517,14,1,11,0,2,12
48518,118,52,22,16,28,90
48519,48,30,9,0,9,39
48520,140,66,42,10,22,118
48521,31,9,9,5,8,23
48522,262,117,84,17,44,218
48523,92,56,20,0,16,76
48524,27,9,12,2,4,23
48525,45,24,17,0,4,41
48526,67,18,26,0,23,44
48527,202,41,56,65,40,162
48528,18,8,4,1,5,13
48529,21,11,7,0,3,18
48530,73,35,20,0,18,55
48531,33,6,15,1,11,22
48532,32,14,7,3,8,24
48533,184,95,35,21,33,151
48534,58,5,49,0,4,54
48535,27,10,12,1,4,23
48536,202,89,56,19,38,164
48537,1,1,0,0,0,1
48538,247,103,15,82,47,200
48539,6,0,5,0,1,5
48540,28,21,3,0,4,24
48541,48,15,25,0,8,40
48542,330,127,114,24,65,265
48543,50,41,3,1,5,45
48544,45,13,20,4,8,37
48545,246,101,54,36,55,191
48546,68,21,25,2,20,48
48547,151,100,28,0,23,128
48548,32,2,22,0,8,24
48549,16,6,8,0,2,14
48550,56,15,26,0,15,41
48551,42,17,16,2,7,35
48552,47,26,16,0,5,42
48553,44,7,25,4,8,36
48554,12,3,5,0,4,8
48555,29,14,10,0,5,24
48556,175,80,47,16,32,143
48557,84,45,5,15,19,65
48558,14,4,5,3,2,12
48559,243,163,62,2,16,227
48560,197,109,28,23,37,160
48561,41,8,22,3,8,33
48562,48,15,28,0,5,43
48563,46,18,20,0,8,38
48564,21,9,8,1,3,18
48565,435,115,179,35,106,329
48566,36,2,29,0,5,31
48567,32,21,9,0,2,30
48568,64,19,32,1,12,52
48569,18,1,11,4,2,16
48570,173,137,9,1,26,147
48571,83,36,24,3,20,63
48572,45,26,9,4,6,39
48573,110,42,39,6,23,87
48574,512,282,84,41,105,407
48575,42,28,1,2,11,31
48576,190,63,58,25,44,146
48577,167,52,53,26,36,131
48578,54,5,34,1,14,40
48579,3,0,2,0,1,2
48580,59,25,24,2,8,51
48581,127,68,23,4,32,95
48582,60,18,16,11,15,45
48583,34,18,11,0,5,29
48584,454,332,25,0,97,357
48585,39,23,8,0,8,31
48586,34,8,19,0,7,27
48587,65,22,27,2,14,51
48588,90,40,28,3,19,71
48589,67,48,2,0,17,50
48590,24,14,3,0,7,17
48591,83,56,13,1,13,70
48592,6,0,4,0,2,4
48593,37,5,23,0,9,28
48594,12,1,7,0,4,8
48595,71,19,22,16,14,57
48596,64,12,39,1,12,52
48597,88,31,18,10,29,59
48598,53,37,4,1,11,42
48599,347,146,127,6,68,279
48600,85,31,35,1,18,67
48601,184,53,48,47,36,148
48602,153,97,29,1,26,127
48603,73,34,16,6,17,56
48604,30,8,11,2,9,21
48605,16,10,5,1,0,16
48606,38,12,16,5,5,33
48607,24,7,7,0,10,14
48608,162,119,8,5,30,132
48609,159,53,45,33,28,131
48610,54,21,18,0,15,39
48611,251,146,55,0,50,201
48612,365,274,21,1,69,296
48613,32,26,0,0,6,26
48614,54,32,9,3,10,44
48615,75,38,22,0,15,60
48616,43,32,1,0,10,33
48617,96,44,33,0,19,77
48618,53,29,12,0,12,41
48619,277,128,95,0,54,223
48620,54,27,14,1,12,42
48621,125,23,73,3,26,99
48622,78,25,38,2,13,65
48623,29,19,6,1,3,26
48624,81,19,39,7,16,65
48625,492,252,88,47,105,387
48626,68,34,15,3,16,52
48627,33,17,14,0,2,31
48628,15,5,7,2,1,14
48629,91,39,23,13,16,75
48630,190,145,14,1,30,160
48631,43,15,23,0,5,38
48632,18,5,8,0,5,13
48633,49,7,30,2,10,39
48634,146,14,99,2,31,115
48635,263,201,15,0,47,216
48636,266,110,96,16,44,222
48637,383,195,96,11,81,302
48638,136,70,35,5,26,110
48639,520,270,93,48,109,411
48640,40,23,13,0,4,36
48641,38,14,17,3,4,34
48642,42,13,19,4,6,36
48643,59,18,14,21,6,53
48644,44,9,22,0,13,31
48645,17,5,4,3,5,12
48646,47,23,7,8,9,38
48647,21,9,6,2,4,17
48648,171,113,27,1,30,141
48649,73,45,15,0,13,60
48650,125,100,4,0,21,104
48651,72,43,15,0,14,58
48652,27,9,15,0,3,24
48653,144,92,28,2,22,122
48654,691,409,141,20,121,570
48655,63,37,16,0,10,53
48656,123,68,24,4,27,96
48657,10,6,3,0,1,9
48658,72,18,29,0,25,47
48659,155,79,45,1,30,125
48660,377,218,81,0,78,299
48661,14,2,6,1,5,9
48662,21,4,13,0,4,17
48663,65,36,12,2,15,50
48664,157,125,4,0,28,129
48665,170,123,21,0,26,144
48666,50,34,8,0,8,42
48667,112,49,32,18,13,99
48668,255,50,153,4,48,207
48669,341,143,121,6,71,270
48670,136,39,67,1,29,107
48671,84,46,19,4,15,69
48672,254,101,91,16,46,208
48673,142,116,7,1,18,124
48674,10,8,0,0,2,8
48675,484,226,106,53,99,385
48676,46,18,20,0,8,38
48677,66,28,19,3,16,50
48678,56,38,2,0,16,40
48679,95,31,5,45,14,81
48680,228,14,171,0,43,185
48681,57,27,23,0,7,50
48682,139,55,44,9,31,108
48683,83,15,40,8,20,63
48684,186,97,28,28,33,153
48685,74,31,30,3,10,64
48686,223,89,88,4,42,181
48687,16,10,1,0,5,11
48688,98,42,34,4,18,80
48689,35,3,24,0,8,27
48690,59,28,9,6,16,43
48691,48,23,20,0,5,43
48692,32,13,11,0,8,24
48693,32,21,9,0,2,30
48694,457,242,117,20,78,379
48695,92,66,7,0,19,73
48696,35,23,4,0,8,27
48697,17,12,2,0,3,14
48698,73,21,34,7,11,62
48699,265,133,63,16,53,212
48700,99,56,12,14,17,82
48701,32,21,9,0,2,30
48702,83,32,37,1,13,70
48703,71,43,13,3,12,59
48704,33,8,13,4,8,25
48705,70,56,2,0,12,58
48706,18,11,5,1,1,17
48707,278,186,20,3,69,209
48708,30,10,7,6,7,23
48709,5,2,1,0,2,3
48710,179,63,51,23,42,137
48711,19,12,3,0,4,15
48712,62,15,30,0,17,45
48713,62,20,18,15,9,53
48714,13,2,8,0,3,10
48715,49,29,10,0,10,39
48716,110,66,16,3,25,85
48717,47,17,18,2,10,37
48718,64,18,24,0,22,42
48719,20,9,9,0,2,18
48720,283,69,70,85,59,224
48721,95,51,17,5,22,73
48722,151,24,98,1,28,123
48723,36,2,28,1,5,31
48724,38,26,3,2,7,31
48725,58,18,24,1,15,43
48726,37,19,8,1,9,28
48727,41,16,11,4,10,31
48728,19,7,7,0,5,14
48729,417,221,107,19,70,347
48730,186,85,59,0,42,144
48731,89,19,47,7,16,73
48732,41,13,17,3,8,33
48733,565,412,35,1,117,448
48734,17,13,1,0,3,14
48735,112,46,37,8,21,91
48736,27,17,7,1,2,25
48737,28,16,7,0,5,23
48738,478,324,49,2,103,375
48739,104,54,18,11,21,83
48740,60,32,7,9,12,48
48741,47,33,1,1,12,35
48742,134,75,22,3,34,100
48743,49,6,35,0,8,41
48744,150,96,3,16,35,115
48745,21,10,8,1,2,19
48746,336,113,144,9,70,266
48747,30,22,3,1,4,26
48748,220,149,30,0,41,179
48749,16,5,11,0,0,16
48750,57,11,31,0,15,42
48751,113,45,42,2,24,89
48752,27,7,9,5,6,21
48753,57,25,18,5,9,48
48754,377,277,18,2,80,297
48755,32,21,9,0,2,30
48756,21,18,2,0,1,20
48757,67,24,17,5,21,46
48758,98,24,53,3,18,80
48759,16,7,6,0,3,13
48760,76,31,8,17,20,56
48761,82,42,13,8,19,63
48762,30,11,13,0,6,24
48763,44,32,5,0,7,37
48764,138,79,13,19,27,111
48765,102,63,12,2,25,77
48766,34,15,12,1,6,28
48767,34,2,24,0,8,26
48768,8,4,4,0,0,8
48769,103,47,25,11,20,83
48770,206,143,48,2,13,193
48771,36,17,12,0,7,29
48772,71,50,7,1,13,58
48773,16,0,14,0,2,14
48774,49,26,8,0,15,34
48775,15,7,3,3,2,13
48776,139,44,47,23,25,114
48777,27,11,9,4,3,24
48778,193,78,50,20,45,148
48779,36,23,8,0,5,31
48780,46,21,15,0,10,36
48781,82,36,31,0,15,67
48782,36,2,29,0,5,31
48783,39,10,23,3,3,36
48784,52,22,18,0,12,40
48785,29,10,11,0,8,21
48786,435,200,145,9,81,354
48787,68,15,41,1,11,57
48788,59,36,7,7,9,50
48789,81,38,22,0,21,60
48790,6,0,3,0,3,3
48791,266,143,62,13,48,218
48792,9,3,4,0,2,7
48793,74,42,11,0,21,53
48794,157,51,77,0,29,128
48795,108,58,21,7,22,86
48796,34,2,26,0,6,28
48797,91,55,19,5,12,79
48798,42,9,21,5,7,35
48799,68,16,33,10,9,59
48800,9,4,5,0,0,9
48801,27,18,3,1,5,22
48802,140,81,21,3,35,105
48803,74,39,18,0,17,57
48804,84,50,18,4,12,72
48805,32,21,9,0,2,30
48806,63,36,13,2,12,51
48807,53,14,25,3,11,42
48808,18,6,9,0,3,15
48809,92,33,38,9,12,80
48810,214,59,116,6,33,181
48811,4,3,0,0,1,3
48812,31,15,8,3,5,26
48813,32,21,9,0,2,30
48814,19,9,4,1,5,14
48815,74,25,32,0,17,57
48816,43,7,30,0,6,37
48817,20,10,5,0,5,15
48818,29,5,22,0,2,27
48819,49,11,29,0,9,40
48820,160,114,11,0,35,125
48821,74,18,23,21,12,62
48822,76,21,29,5,21,55
48823,54,32,10,4,8,46
48824,115,64,33,1,17,98
48825,14,5,8,0,1,13
48826,22,0,16,0,6,16
48827,19,14,3,0,2,17
48828,113,44,44,0,25,88
48829,67,46,6,0,15,52
48830,32,21,9,0,2,30
48831,6,1,4,0,1,5
48832,44,34,1,0,9,35
48833,14,3,9,0,2,12
48834,662,385,144,17,116,546
48835,46,18,20,0,8,38
48836,23,5,10,4,4,19
48837,27,18,5,0,4,23
48838,149,63,53,7,26,123
48839,58,14,34,1,9,49
48840,1,0,0,0,1,0
48841,40,28,3,5,4,36
48842,25,22,0,0,3,22
48843,57,22,18,6,11,46
48844,47,27,10,0,10,37
48845,135,53,52,8,22,113
48846,162,110,26,0,26,136
48847,108,40,40,14,14,94
48848,66,40,12,3,11,55
48849,34,13,15,1,5,29
48850,390,167,111,33,79,311
48851,364,177,117,2,68,296
48852,34,12,10,6,6,28
48853,62,18,25,10,9,53
48854,372,210,84,0,78,294
48855,32,21,3,3,5,27
48856,27,8,16,1,2,25
48857,41,7,23,0,11,30
48858,37,28,4,0,5,32
48859,79,21,37,6,15,64
48860,70,39,15,2,14,56
48861,7,1,2,1,3,4
48862,66,33,19,4,10,56
48863,62,17,28,2,15,47
48864,17,2,14,0,1,16
48865,58,37,7,0,14,44
48866,104,57,24,4,19,85
48867,423,210,101,28,84,339
48868,39,10,25,0,4,35
48869,78,24,28,14,12,66
48870,40,22,3,4,11,29
48871,70,28,7,20,15,55
48872,52,9,28,5,10,42
48873,650,376,149,17,108,542
48874,480,349,28,0,103,377
48875,10,1,6,0,3,7
48876,30,18,6,1,5,25
48877,15,3,9,1,2,13
48878,125,42,45,7,31,94
48879,212,148,47,3,14,198
48880,53,22,10,17,4,49
48881,86,39,31,0,16,70
48882,107,75,21,0,11,96
48883,41,8,25,4,4,37
48884,136,45,44,16,31,105
48885,580,325,142,20,93,487
48886,41,19,13,0,9,32
48887,230,140,7,31,52,178
48888,220,138,39,3,40,180
48889,138,59,41,9,29,109
48890,23,10,2,7,4,19
48891,73,30,25,2,16,57
48892,69,19,27,0,23,46
48893,416,193,120,13,90,326
48894,32,12,11,2,7,25
48895,54,33,14,0,7,47
48896,17,1,14,0,2,15
48897,60,14,40,0,6,54
48898,104,28,59,0,17,87
48899,142,90,14,10,28,114
48900,78,24,28,14,12,66
48901,63,27,23,1,12,51
48902,79,65,3,0,11,68
48903,32,21,9,0,2,30
48904,347,188,89,15,55,292
48905,225,136,35,7,47,178
48906,283,145,79,12,47,236
48907,88,43,17,7,21,67
48908,34,23,2,0,9,25
48909,21,16,1,0,4,17
48910,36,18,5,8,5,31
48911,67,21,30,0,16,51
48912,101,27,42,5,27,74
48913,211,115,61,0,35,176
48914,32,21,9,0,2,30
48915,15,6,5,2,2,13
48916,12,0,10,0,2,10
48917,137,106,6,0,25,112
48918,46,18,20,0,8,38
48919,21,9,5,0,7,14
48920,77,43,19,0,15,62
48921,30,22,0,0,8,22
48922,13,1,9,0,3,10
48923,56,36,8,1,11,45
48924,37,2,25,0,10,27
48925,119,28,35,22,34,85
48926,67,46,6,0,15,52
48927,79,12,51,4,12,67
48928,21,0,4,13,4,17
48929,87,53,9,0,25,62
48930,34,17,6,2,9,25
48931,43,20,16,0,7,36
48932,33,8,14,1,10,23
48933,10,7,1,0,2,8
48934,7,3,4,0,0,7
48935,65,39,14,0,12,53
48936,93,30,21,23,19,74
48937,25,10,7,0,8,17
48938,90,59,13,10,8,82
48939,49,26,12,4,7,42
48940,79,23,33,13,10,69
48941,29,2,21,1,5,24
48942,157,66,56,9,26,131
48943,62,9,39,0,14,48
48944,56,24,19,1,12,44
48945,79,30,32,2,15,64
48946,113,42,45,6,20,93
48947,31,17,10,2,2,29
48948,84,42,17,2,23,61
48949,28,16,4,3,5,23
48950,21,1,15,1,4,17
48951,90,32,37,2,19,71
48952,235,121,66,3,45,190
48953,144,56,58,2,28,116
48954,81,31,32,0,18,63
48955,126,29,42,30,25,101
48956,350,154,121,6,69,281
48957,90,32,37,2,19,71
48958,9,4,3,0,2,7
48959,50,14,24,0,12,38
48960,20,14,3,0,3,17
48961,15,1,12,0,2,13
48962,23,9,8,0,6,17
48963,16,9,4,1,2,14
48964,334,179,86,15,54,280
48965,67,33,21,0,13,54
48966,51,0,34,2,15,36
48967,16,7,9,0,0,16
48968,31,12,11,0,8,23
48969,20,9,5,1,5,15
48970,222,75,82,15,50,172
48971,7,1,2,0,4,3
48972,44,29,10,0,5,39
48973,27,2,17,2,6,21
48974,98,22,46,11,19,79
48975,53,9,27,5,12,41
48976,24,12,7,0,5,19
48977,138,82,28,5,23,115
48978,1325,535,194,337,259,1066
48979,14,6,2,0,6,8
48980,197,106,59,0,32,165
48981,153,53,39,30,31,122
48982,30,19,9,2,0,30
48983,587,334,122,16,115,472
48984,180,130,14,2,34,146
48985,42,24,7,3,8,34
48986,222,93,46,25,58,164
48987,60,7,41,0,12,48
48988,226,162,15,4,45,181
48989,33,24,5,0,4,29
48990,159,108,26,0,25,134
48991,64,19,24,5,16,48
48992,32,11,13,4,4,28
48993,84,28,42,1,13,71
48994,32,21,5,0,6,26
48995,70,59,0,1,10,60
48996,46,18,20,0,8,38
48997,30,3,19,2,6,24
48998,451,216,91,44,100,351
48999,17,10,3,1,3,14
49000,270,60,144,3,63,207
49001,15,5,6,0,4,11
49002,294,78,34,134,48,246
49003,110,71,27,0,12,98
49004,151,103,20,1,27,124
49005,141,74,18,20,29,112
49006,57,28,8,8,13,44
49007,475,225,154,13,83,392
49008,66,37,15,0,14,52
49009,47,9,21,4,13,34
49010,55,20,17,4,14,41
49011,73,11,7,35,20,53
49012,32,21,9,0,2,30
49013,9,6,0,2,1,8
49014,24,3,15,1,5,19
49015,45,11,26,1,7,38
49016,35,10,16,3,6,29
49017,20,8,3,3,6,14
49018,309,167,75,0,67,242
49019,271,188,19,4,60,211
49020,178,101,20,16,41,137
49021,25,0,19,0,6,19
49022,36,14,16,0,6,30
49023,150,71,39,0,40,110
49024,13,8,2,0,3,10
49025,43,9,20,0,14,29
49026,246,126,59,11,50,196
49027,46,18,20,0,8,38
49028,25,4,12,1,8,17
49029,44,6,29,5,4,40
49030,44,22,11,0,11,33
49031,79,33,31,0,15,64
49032,11,1,5,0,5,6
49033,62,39,12,1,10,52
49034,49,10,28,1,10,39
49035,323,196,56,0,71,252
49036,323,131,130,5,57,266
49037,304,180,56,6,62,242
49038,346,204,68,0,74,272
49039,141,48,33,28,32,109
49040,41,1,35,0,5,36
49041,19,3,13,0,3,16
49042,63,45,4,3,11,52
49043,113,77,20,0,16,97
49044,164,88,38,6,32,132
49045,62,21,26,6,9,53
49046,118,60,31,0,27,91
49047,30,22,3,1,4,26
49048,125,52,22,26,25,100
49049,24,5,13,0,6,18
49050,18,7,10,0,1,17
49051,68,51,6,0,11,57
49052,72,37,16,7,12,60
49053,66,49,12,0,5,61
49054,69,29,23,2,15,54
49055,91,43,34,0,14,77
49056,81,43,9,5,24,57
49057,359,262,19,2,76,283
49058,19,4,13,1,1,18
49059,55,16,27,2,10,45
49060,195,46,28,86,35,160
49061,145,68,49,5,23,122
49062,67,26,25,1,15,52
49063,249,179,12,5,53,196
49064,62,32,14,4,12,50
49065,170,52,86,0,32,138
49066,69,45,11,1,12,57
49067,22,7,12,1,2,20
49068,191,146,14,1,30,161
49069,97,51,28,1,17,80
49070,126,69,22,7,28,98
49071,49,10,30,0,9,40
49072,23,5,11,0,7,16
49073,6,1,4,0,1,5
49074,95,64,6,0,25,70
49075,24,9,7,2,6,18
49076,50,30,11,0,9,41
49077,130,40,68,2,20,110
49078,593,330,145,23,95,498
49079,108,26,52,4,26,82
49080,97,36,24,11,26,71
49081,469,226,148,12,83,386
49082,334,136,123,6,69,265
49083,13,7,2,0,4,9
49084,80,42,21,4,13,67
49085,6,2,2,0,2,4
49086,39,26,5,0,8,31
49087,21,1,4,12,4,17
49088,34,11,14,3,6,28
49089,165,51,89,4,21,144
49090,52,0,32,3,17,35
49091,98,24,55,4,15,83
49092,62,14,42,0,6,56
49093,545,328,107,10,100,445
49094,32,21,7,0,4,28
49095,34,18,7,3,6,28
49096,101,43,42,4,12,89
49097,129,40,56,6,27,102
49098,527,320,78,7,122,405
49099,27,12,8,2,5,22
49100,161,43,55,25,38,123
49101,101,46,39,1,15,86
49102,100,74,9,1,16,84
49103,31,15,8,3,5,26
49104,37,18,15,1,3,34
49105,118,66,31,0,21,97
49106,10,3,6,0,1,9
49107,71,38,19,0,14,57
49108,32,7,15,4,6,26
49109,125,28,39,23,35,90
49110,607,420,56,1,130,477
49111,150,98,24,2,26,124
49112,43,24,11,0,8,35
49113,25,10,10,0,5,20
49114,33,0,27,0,6,27
49115,6,3,0,0,3,3
49116,158,93,26,11,28,130
49117,433,140,176,20,97,336
49118,32,22,0,0,10,22
49119,105,36,26,24,19,86
49120,51,36,5,0,10,41
49121,127,74,22,3,28,99
49122,220,150,29,0,41,179
49123,81,52,18,2,9,72
49124,9,1,7,0,1,8
49125,32,21,9,0,2,30
49126,65,42,11,2,10,55
49127,123,48,32,23,20,103
49128,88,41,35,2,10,78
49129,68,33,23,1,11,57
49130,21,13,3,0,5,16
49131,46,15,22,2,7,39
49132,81,42,27,0,12,69
49133,15,5,6,2,2,13
49134,2,0,1,0,1,1
49135,41,9,24,0,8,33
49136,91,33,33,8,17,74
49137,75,23,36,2,14,61
49138,147,37,75,1,34,113
49139,157,5,128,0,24,133
49140,109,48,21,15,25,84
49141,100,50,25,9,16,84
49142,145,14,98,2,31,114
49143,62,34,12,4,12,50
49144,60,37,11,0,12,48
49145,55,34,9,0,12,43
49146,28,2,11,8,7,21
49147,111,47,46,3,15,96
49148,39,5,28,0,6,33
49149,10,3,3,0,4,6
49150,165,97,38,1,29,136
49151,52,15,22,7,8,44
49152,629,401,81,8,139,490
49153,5,4,0,0,1,4
49154,63,26,21,4,12,51
49155,140,57,52,3,28,112
49156,63,47,12,0,4,59
49157,103,59,23,6,15,88
49158,46,18,20,0,8,38
49159,204,135,22,0,47,157
49160,312,171,69,0,72,240
49161,104,30,54,0,20,84
49162,133,73,36,1,23,110
49163,86,40,18,12,16,70
49164,200,98,59,0,43,157
49165,56,38,11,0,7,49
49166,48,24,3,13,8,40
49167,65,16,32,0,17,48
49168,5,4,1,0,0,5
49169,48,15,24,1,8,40
49170,66,31,21,0,14,52
49171,9,4,4,0,1,8
49172,42,5,26,0,11,31
49173,93,53,14,11,15,78
49174,125,42,47,11,25,100
49175,244,108,61,27,48,196
49176,66,22,15,11,18,48
49177,26,13,2,5,6,20
49178,50,19,20,0,11,39
49179,154,97,31,0,26,128
49180,142,40,68,1,33,109
49181,55,19,23,3,10,45
49182,92,53,16,3,20,72
49183,67,38,3,13,13,54
49184,16,8,5,0,3,13
49185,43,27,13,0,3,40
49186,46,26,8,0,12,34
49187,93,47,28,1,17,76
49188,4,0,2,1,1,3
49189,61,25,30,0,6,55
49190,53,27,15,0,11,42
49191,204,135,22,0,47,157
49192,58,19,31,0,8,50
49193,51,34,6,1,10,41
49194,49,9,29,1,10,39
49195,13,3,7,0,3,10
49196,72,36,16,8,12,60
49197,160,48,50,25,37,123
49198,29,6,14,1,8,21
49199,635,370,133,17,115,520
49200,214,90,54,24,46,168
49201,110,45,14,16,35,75
49202,98,32,39,10,17,81
49203,47,33,4,0,10,37
49204,68,45,5,3,15,53
49205,47,29,11,0,7,40
49206,46,18,20,0,8,38
49207,59,22,13,15,9,50
49208,7,5,0,2,0,7
49209,32,25,5,2,0,32
49210,176,70,42,28,36,140
49211,25,14,7,0,4,21
49212,46,29,8,0,9,37
49213,32,11,6,8,7,25
49214,74,53,7,3,11,63
49215,641,372,147,16,106,535
49216,78,24,38,2,14,64
49217,106,44,13,15,34,72
49218,32,21,9,0,2,30
49219,120,56,26,15,23,97
49220,73,17,37,1,18,55
49221,74,29,7,22,16,58
49222,157,106,21,1,29,128
49223,14,4,5,1,4,10
49224,17,9,4,0,4,13
49225,12,3,6,0,3,9
49226,163,120,3,1,39,124
49227,52,25,14,4,9,43
49228,32,21,9,0,2,30
49229,151,95,25,5,26,125
49230,220,149,30,0,41,179
49231,45,32,4,0,9,36
49232,139,50,60,5,24,115
49233,57,45,1,0,11,46
49234,46,18,20,0,8,38
49235,26,1,18,0,7,19
49236,83,42,25,1,15,68
49237,33,3,23,1,6,27
49238,113,60,38,4,11,102
49239,36,1,26,0,9,27
49240,70,29,20,3,18,52
49241,67,21,29,2,15,52
49242,6,2,3,0,1,5
49243,115,63,14,13,25,90
49244,44,35,2,0,7,37
49245,43,18,18,0,7,36
49246,35,12,9,5,9,26
49247,19,14,2,0,3,16
49248,11,5,3,1,2,9
49249,24,3,18,0,3,21
49250,187,72,47,28,40,147
49251,31,17,11,0,3,28
49252,10,0,8,0,2,8
49253,550,273,117,44,116,434
49254,39,31,1,0,7,32
49255,198,98,50,0,50,148
49256,84,41,22,1,20,64
49257,77,14,8,36,19,58
49258,121,34,63,0,24,97
49259,62,37,6,2,17,45
49260,45,20,8,8,9,36
49261,55,21,13,7,14,41
49262,163,117,21,0,25,138
49263,21,10,4,0,7,14
49264,23,6,8,2,7,16
49265,96,69,4,2,21,75
49266,59,34,15,0,10,49
49267,56,15,32,0,9,47
49268,70,43,12,2,13,57
49269,38,9,16,6,7,31
49270,111,71,24,0,16,95
49271,42,23,9,0,10,32
49272,9,3,3,1,2,7
49273,84,42,21,1,20,64
49274,9,7,0,1,1,8
49275,26,8,9,3,6,20
49276,46,18,20,0,8,38
49277,48,17,20,0,11,37
49278,335,171,95,5,64,271
49279,78,52,15,1,10,68
49280,60,31,19,1,9,51
49281,57,15,32,1,9,48
49282,111,55,33,4,19,92
49283,57,19,27,0,11,46
49284,270,80,132,4,54,216
49285,226,78,88,13,47,179
49286,46,20,9,6,11,35
49287,655,383,142,16,114,541
49288,396,298,19,0,79,317
49289,232,92,14,82,44,188
49290,35,28,1,0,6,29
49291,63,45,8,3,7,56
49292,77,5,55,1,16,61
49293,48,24,15,0,9,39
49294,12,5,4,1,2,10
49295,70,26,28,3,13,57
49296,120,46,27,19,28,92
49297,30,22,0,0,8,22
49298,50,8,29,3,10,40
49299,32,21,9,0,2,30
49300,656,386,134,20,116,540
49301,37,18,8,1,10,27
49302,53,35,10,0,8,45
49303,276,65,157,4,50,226
49304,138,79,29,0,30,108
49305,134,92,10,5,27,107
49306,216,164,8,0,44,172
49307,48,20,15,4,9,39
49308,129,57,30,15,27,102
49309,178,119,28,1,30,148
49310,148,44,65,4,35,113
49311,141,85,29,0,27,114
49312,260,113,100,5,42,218
49313,21,8,6,1,6,15
49314,32,2,24,0,6,26
49315,74,53,7,3,11,63
49316,159,118,8,4,29,130
49317,146,80,46,10,10,136
49318,88,54,19,2,13,75
49319,101,43,27,8,23,78
49320,251,188,11,1,51,200
49321,89,39,28,3,19,70
49322,197,141,16,2,38,159
49323,94,55,25,1,13,81
49324,95,42,27,1,25,70
49325,44,18,18,0,8,36
49326,637,355,157,23,102,535
49327,52,41,1,0,10,42
49328,10,5,3,1,1,9
49329,74,41,20,0,13,61
49330,43,32,3,0,8,35
49331,13,2,8,0,3,10
49332,91,29,34,11,17,74
49333,33,15,9,3,6,27
49334,125,43,44,6,32,93
49335,663,381,153,17,112,551
49336,55,33,10,0,12,43
49337,77,43,14,2,18,59
49338,46,27,9,4,6,40
49339,42,28,1,2,11,31
49340,88,37,14,15,22,66
49341,15,12,0,0,3,12
49342,179,102,31,0,46,133
49343,405,184,118,25,78,327
49344,148,111,7,1,29,119
49345,37,21,6,2,8,29
49346,43,23,9,2,9,34
49347,92,36,26,13,17,75
49348,7,1,4,2,0,7
49349,644,385,126,20,113,531
49350,67,2,53,0,12,55
49351,45,18,10,4,13,32
49352,29,2,22,0,5,24
49353,44,23,10,0,11,33
49354,183,71,29,52,31,152
49355,72,35,11,7,19,53
49356,56,36,7,0,13,43
49357,92,41,26,1,24,68
49358,115,31,41,16,27,88
49359,10,5,2,1,2,8
49360,176,105,47,13,11,165
49361,126,70,32,0,24,102
49362,6,2,3,0,1,5
49363,90,45,26,2,17,73
49364,156,75,49,1,31,125
49365,20,7,6,5,2,18
49366,337,180,70,15,72,265
49367,134,50,43,17,24,110
49368,171,62,54,25,30,141
49369,155,100,3,17,35,120
49370,26,20,3,0,3,23
49371,27,6,16,0,5,22
49372,181,101,32,1,47,134
49373,45,35,1,0,9,36
49374,45,1,34,0,10,35
49375,157,46,79,0,32,125
49376,127,45,56,2,24,103
49377,24,5,17,0,2,22
49378,71,49,13,0,9,62
49379,39,22,12,0,5,34
49380,97,41,33,4,19,78
49381,36,15,14,1,6,30
49382,155,50,45,33,27,128
49383,41,26,7,3,5,36
49384,339,140,123,5,71,268
49385,32,21,9,0,2,30
49386,18,4,13,0,1,17
49387,104,39,39,12,14,90
49388,6,2,3,0,1,5
49389,45,18,16,0,11,34
49390,86,58,6,0,22,64
49391,29,2,21,1,5,24
49392,49,31,8,0,10,39
49393,139,88,31,3,17,122
49394,23,14,1,2,6,17
49395,41,34,0,0,7,34
49396,27,9,15,0,3,24
49397,39,2,19,12,6,33
49398,105,47,35,4,19,86
49399,257,178,57,2,20,237
49400,205,88,61,19,37,168
49401,74,30,18,14,12,62
49402,16,8,2,4,2,14
49403,69,44,8,2,15,54
49404,175,120,15,0,40,135
49405,48,24,12,1,11,37
49406,170,117,15,0,38,132
49407,44,35,2,0,7,37
49408,10,5,3,0,2,8
49409,36,15,15,2,4,32
49410,70,20,38,1,11,59
49411,47,21,14,4,8,39
49412,216,126,52,0,38,178
49413,169,100,39,1,29,140
49414,23,11,7,0,5,18
49415,52,23,20,0,9,43
49416,6,4,0,0,2,4
49417,27,14,10,0,3,24
49418,27,9,12,2,4,23
49419,458,120,196,39,103,355
49420,55,40,4,1,10,45
49421,145,62,29,19,35,110
49422,28,17,3,0,8,20
49423,468,215,158,9,86,382
49424,90,25,40,2,23,67
49425,55,39,4,0,12,43
49426,170,112,27,1,30,140
49427,95,53,25,13,4,91
49428,31,12,14,1,4,27
49429,39,0,27,0,12,27
49430,131,46,27,26,32,99
49431,72,28,25,3,16,56
49432,22,10,7,0,5,17
49433,49,17,16,1,15,34
49434,46,18,20,0,8,38
49435,31,13,12,2,4,27
49436,99,95,0,4,0,99
49437,4,1,3,0,0,4
49438,25,5,1,15,4,21
49439,35,1,26,1,7,28
49440,211,113,48,0,50,161
49441,48,25,14,2,7,41
49442,15,2,9,0,4,11
49443,82,53,14,0,15,67
49444,49,10,28,1,10,39
49445,52,32,12,0,8,44
49446,58,3,43,2,10,48
49447,55,32,15,2,6,49
49448,191,86,52,13,40,151
49449,30,11,9,7,3,27
49450,378,220,80,0,78,300
49451,18,6,6,1,5,13
49452,628,370,135,15,108,520
49453,19,12,5,0,2,17
49454,11,8,0,0,3,8
49455,80,28,38,0,14,66
49456,90,54,20,4,12,78
49457,247,49,153,1,44,203
49458,58,21,17,7,13,45
49459,35,16,8,2,9,26
49460,19,14,3,0,2,17
49461,56,25,21,1,9,47
49462,109,61,20,4,24,85
49463,304,129,106,6,63,241
49464,66,16,28,12,10,56
49465,1,1,0,0,0,1
49466,73,31,28,1,13,60
49467,437,321,23,0,93,344
49468,95,57,23,10,5,90
49469,41,8,18,1,14,27
49470,1290,523,175,336,256,1034
49471,15,10,2,0,3,12
49472,155,71,49,5,30,125
49473,127,74,22,3,28,99
49474,64,16,24,8,16,48
49475,393,107,189,5,92,301
49476,163,82,22,27,32,131
49477,38,13,16,0,9,29
49478,211,113,48,0,50,161
49479,64,46,6,1,11,53
49480,77,40,3,18,16,61
49481,78,35,29,0,14,64
49482,17,2,10,1,4,13
49483,405,188,119,12,86,319
49484,223,150,57,0,16,207
49485,49,17,24,0,8,41
49486,81,41,20,0,20,61
49487,12,2,7,0,3,9
49488,139,64,46,5,24,115
49489,435,321,20,0,94,341
49490,36,10,19,0,7,29
49491,66,19,22,19,6,60
49492,22,12,6,0,4,18
49493,47,18,18,0,11,36
49494,82,26,41,0,15,67
49495,39,12,17,3,7,32
49496,88,35,14,12,27,61
49497,26,5,11,0,10,16
49498,45,19,5,5,16,29
49499,37,21,6,2,8,29
49500,48,30,10,0,8,40
49501,59,21,29,1,8,51
49502,42,34,1,0,7,35
49503,72,25,35,2,10,62
49504,58,34,15,0,9,49
49505,53,32,6,1,14,39
49506,183,138,15,1,29,154
49507,24,7,13,0,4,20
49508,46,18,20,0,8,38
49509,92,57,18,5,12,80
49510,22,17,0,0,5,17
49511,11,8,3,0,0,11
49512,147,49,7,65,26,121
49513,34,0,28,0,6,28
49514,30,0,6,19,5,25
49515,37,1,27,1,8,29
49516,58,11,34,4,9,49
49517,138,60,27,23,28,110
49518,61,20,28,0,13,48
49519,155,79,45,1,30,125
49520,262,121,94,5,42,220
49521,80,47,22,10,1,79
49522,97,37,34,9,17,80
49523,389,178,128,5,78,311
49524,169,82,66,4,17,152
49525,26,2,20,0,4,22
49526,159,12,95,24,28,131
49527,57,41,11,4,1,56
49528,45,23,12,1,9,36
49529,83,56,8,3,16,67
49530,78,53,10,0,15,63
49531,131,28,46,29,28,103
49532,11,7,4,0,0,11
49533,213,8,169,0,36,177
49534,70,47,12,0,11,59
49535,244,150,44,11,39,205
49536,21,6,8,0,7,14
49537,436,135,174,31,96,340
49538,129,68,23,13,25,104
49539,273,67,46,115,45,228
49540,50,29,13,0,8,42
49541,11,5,5,0,1,10
49542,108,47,29,12,20,88
49543,44,14,20,1,9,35
49544,54,35,6,2,11,43
49545,11,1,6,1,3,8
49546,119,46,25,25,23,96
49547,65,38,15,0,12,53
49548,72,34,19,7,12,60
49549,147,59,57,8,23,124
49550,138,73,41,0,24,114
49551,111,45,37,10,19,92
49552,27,4,18,0,5,22
49553,61,33,21,2,5,56
49554,54,41,5,0,8,46
49555,175,136,6,0,33,142
49556,52,41,1,0,10,42
49557,76,13,47,0,16,60
49558,6,1,2,0,3,3
49559,28,22,5,1,0,28
49560,40,15,12,3,10,30
49561,14,0,12,0,2,12
49562,98,48,36,2,12,86
49563,95,20,58,0,17,78
49564,32,8,12,3,9,23
49565,15,1,13,0,1,14
49566,230,156,32,0,42,188
49567,72,44,15,0,13,59
49568,32,21,9,0,2,30
49569,63,22,21,8,12,51
49570,29,14,8,0,7,22
49571,53,35,6,5,7,46
49572,37,12,15,1,9,28
49573,22,11,5,1,5,17
49574,120,67,30,0,23,97
49575,82,56,6,1,19,63
49576,79,37,23,0,19,60
49577,17,14,3,0,0,17
49578,32,21,9,0,2,30
49579,61,20,24,3,14,47
49580,53,34,12,0,7,46
49581,67,31,15,5,16,51
49582,566,404,41,1,120,446
49583,45,17,14,1,13,32
49584,32,21,9,0,2,30
49585,83,69,1,0,13,70
49586,94,49,23,4,18,76
49587,156,70,55,2,29,127
49588,60,21,31,0,8,52
49589,171,130,8,6,27,144
49590,79,46,5,6,22,57
49591,39,0,29,0,10,29
49592,79,37,23,0,19,60
49593,73,14,37,7,15,58
49594,148,28,91,1,28,120
49595,137,92,12,5,28,109
49596,5,4,0,0,1,4
49597,247,123,59,17,48,199
49598,32,21,9,0,2,30
49599,37,27,1,2,7,30
49600,179,102,32,0,45,134
49601,146,67,28,18,33,113
49602,230,91,14,81,44,186
49603,111,52,36,6,17,94
49604,34,32,0,0,2,32
49605,85,37,25,3,20,65
49606,41,30,4,0,7,34
49607,46,18,20,0,8,38
49608,97,56,25,13,3,94
49609,69,31,17,0,21,48
49610,69,44,12,1,12,57
49611,288,77,151,1,59,229
49612,205,135,23,0,47,158
49613,35,26,4,0,5,30
49614,49,22,16,1,10,39
49615,90,27,42,0,21,69
49616,35,13,13,2,7,28
49617,53,10,32,0,11,42
49618,58,43,2,0,13,45
49619,120,84,4,15,17,103
49620,32,16,3,5,8,24
49621,76,17,43,0,16,60
49622,173,69,77,4,23,150
49623,388,179,133,7,69,319
49624,44,34,6,1,3,41
49625,242,110,78,3,51,191
49626,26,1,22,0,3,23
49627,89,39,8,25,17,72
49628,38,13,20,1,4,34
49629,26,10,5,7,4,22
49630,14,4,7,1,2,12
49631,43,15,21,0,7,36
49632,15,7,4,0,4,11
49633,148,31,83,4,30,118
49634,33,24,2,0,7,26
49635,8,1,5,0,2,6
49636,46,34,0,2,10,36
49637,32,21,9,0,2,30
49638,48,12,26,6,4,44
49639,61,36,14,1,10,51
49640,7,7,0,0,0,7
49641,82,22,44,0,16,66
49642,220,149,30,0,41,179
49643,76,38,21,3,14,62
49644,68,37,11,6,14,54
49645,33,21,7,1,4,29
49646,174,82,55,3,34,140
49647,124,50,41,0,33,91
49648,125,50,32,15,28,97
49649,24,8,11,0,5,19
49650,211,21,151,2,37,174
49651,450,225,118,14,93,357
49652,53,27,9,2,15,38
49653,10,0,8,0,2,8
49654,53,33,12,8,0,53
49655,34,13,15,0,6,28
49656,29,19,6,1,3,26
49657,27,18,3,3,3,24
49658,244,173,13,2,56,188
49659,136,81,28,0,27,109
49660,58,21,16,6,15,43
49661,324,164,108,0,52,272
49662,198,132,21,0,45,153
49663,100,48,31,5,16,84
49664,458,118,193,46,101,357
49665,117,63,36,9,9,108
49666,25,9,8,2,6,19
49667,59,12,31,0,16,43
49668,63,21,15,17,10,53
49669,51,7,27,5,12,39
49670,150,105,19,0,26,124
49671,25,16,5,0,4,21
49672,146,71,20,22,33,113
49673,36,22,1,5,8,28
49674,110,53,37,0,20,90
49675,46,18,20,0,8,38
49676,17,11,4,1,1,16
49677,71,33,15,6,17,54
49678,92,57,18,5,12,80
49679,206,127,34,6,39,167
49680,67,12,42,1,12,55
49681,24,4,14,1,5,19
49682,43,21,10,0,12,31
49683,86,45,17,0,24,62
49684,157,97,34,1,25,132
49685,24,11,10,0,3,21
49686,8,0,5,0,3,5
49687,54,16,32,0,6,48
49688,187,75,44,22,46,141
49689,114,68,20,7,19,95
49690,68,15,37,1,15,53
49691,15,4,5,0,6,9
49692,61,33,13,0,15,46
49693,674,389,155,21,109,565
49694,148,47,42,32,27,121
49695,44,11,21,0,12,32
49696,73,41,23,4,5,68
49697,154,81,39,0,34,120
49698,22,9,9,1,3,19
49699,193,88,47,20,38,155
49700,37,5,18,5,9,28
49701,44,14,15,3,12,32
49702,1,0,0,1,0,1
49703,124,50,36,9,29,95
49704,132,100,1,1,30,102
49705,260,73,135,1,51,209
49706,422,104,179,45,94,328
49707,28,1,23,0,4,24
49708,81,23,34,3,21,60
49709,36,11,20,0,5,31
49710,432,125,165,47,95,337
49711,180,128,14,0,38,142
49712,77,53,4,0,20,57
49713,70,40,11,2,17,53
49714,78,13,41,7,17,61
49715,16,7,5,0,4,12
49716,44,18,19,2,5,39
49717,45,5,30,0,10,35
49718,310,161,83,15,51,259
49719,37,15,13,0,9,28
49720,110,72,13,1,24,86
49721,40,6,23,0,11,29
49722,50,9,32,2,7,43
49723,40,22,15,0,3,37
49724,104,53,22,7,22,82
49725,32,21,9,0,2,30
49726,140,47,45,21,27,113
49727,56,35,12,0,9,47
49728,92,40,32,4,16,76
49729,73,27,33,3,10,63
49730,20,18,0,0,2,18
49731,123,75,24,0,24,99
49732,140,106,3,2,29,111
49733,57,15,27,1,14,43
49734,46,12,22,0,12,34
49735,29,12,13,0,4,25
49736,19,2,12,0,5,14
49737,26,12,7,4,3,23
49738,634,351,156,24,103,531
49739,48,26,9,3,10,38
49740,90,35,15,12,28,62
49741,357,155,127,6,69,288
49742,364,273,19,2,70,294
49743,151,45,37,39,30,121
49744,301,152,81,16,52,249
49745,91,41,15,17,18,73
49746,87,34,17,10,26,61
49747,41,9,15,10,7,34
49748,467,224,147,13,83,384
49749,18,1,10,5,2,16
49750,7,3,3,0,1,6
49751,123,42,38,20,23,100
49752,69,29,26,7,7,62
49753,89,65,5,0,19,70
49754,238,177,10,4,47,191
49755,67,31,24,2,10,57
49756,155,33,55,33,34,121
49757,44,18,15,2,9,35
49758,50,25,16,0,9,41
49759,34,18,11,0,5,29
49760,8,2,6,0,0,8
49761,24,6,13,0,5,19
49762,48,20,17,1,10,38
49763,628,370,137,15,106,522
49764,37,19,9,0,9,28
49765,100,22,46,11,21,79
49766,60,14,40,0,6,54
49767,42,31,4,0,7,35
49768,62,40,8,0,14,48
49769,139,48,33,22,36,103
49770,10,1,7,0,2,8
49771,315,200,42,13,60,255
49772,111,59,10,20,22,89
49773,252,134,77,0,41,211
49774,228,78,89,13,48,180
49775,46,18,20,0,8,38
49776,17,7,10,0,0,17
49777,86,48,26,0,12,74
49778,85,26,40,2,17,68
49779,46,14,25,0,7,39
49780,106,38,27,24,17,89
49781,444,327,21,0,96,348
49782,13,9,0,1,3,10
49783,70,25,25,6,14,56
49784,474,203,117,47,107,367
49785,38,13,13,5,7,31
49786,62,23,27,1,11,51
49787,281,157,35,33,56,225
49788,36,3,21,0,12,24
49789,212,52,39,83,38,174
49790,121,53,18,18,32,89
49791,7,5,2,0,0,7
49792,10,5,4,0,1,9
49793,121,55,17,18,31,90
49794,54,27,6,4,17,37
49795,202,134,22,0,46,156
49796,43,22,12,4,5,38
49797,32,21,9,0,2,30
49798,22,7,14,0,1,21
49799,22,9,7,1,5,17
49800,132,42,36,30,24,108
49801,93,42,33,0,18,75
49802,57,28,6,4,19,38
49803,150,97,15,6,32,118
49804,178,100,33,0,45,133
49805,451,333,25,0,93,358
49806,38,29,0,0,9,29
49807,65,19,29,3,14,51
49808,6,4,2,0,0,6
49809,100,54,31,4,11,89
49810,42,11,26,0,5,37
49811,147,59,45,9,34,113
49812,576,323,142,19,92,484
49813,73,43,14,3,13,60
49814,16,2,9,1,4,12
49815,203,136,49,4,14,189
49816,293,81,40,123,49,244
49817,78,55,12,1,10,68
49818,18,6,9,0,3,15
49819,172,82,53,3,34,138
49820,15,5,8,0,2,13
49821,36,23,6,0,7,29
49822,205,115,48,9,33,172
49823,202,41,55,66,40,162
49824,19,8,9,0,2,17
49825,33,4,20,0,9,24
49826,293,165,74,0,54,239
49827,177,79,28,28,42,135
49828,57,24,28,0,5,52
49829,72,36,20,0,16,56
49830,65,1,53,0,11,54
49831,73,30,20,1,22,51
49832,9,1,4,1,3,6
49833,131,101,3,0,27,104
49834,467,232,116,20,99,368
49835,142,91,34,11,6,136
49836,29,17,9,0,3,26
49837,161,68,34,20,39,122
49838,33,1,25,0,7,26
49839,10,1,7,0,2,8
49840,56,24,20,0,12,44
49841,7,5,2,0,0,7
49842,61,35,13,0,13,48
49843,64,32,16,2,14,50
49844,249,103,18,81,47,202
49845,73,26,26,7,14,59
49846,94,53,14,0,27,67
49847,71,43,14,0,14,57
49848,128,64,16,17,31,97
49849,36,2,24,0,10,26
49850,49,10,28,1,10,39
49851,425,241,95,0,89,336
49852,32,12,11,3,6,26
49853,33,13,12,4,4,29
49854,211,70,82,15,44,167
49855,191,96,53,4,38,153
49856,31,2,15,2,12,19
49857,35,20,7,0,8,27
49858,65,34,10,6,15,50
49859,203,162,11,1,29,174
49860,78,46,16,2,14,64
49861,46,13,31,0,2,44
49862,81,30,34,2,15,66
49863,4,2,1,1,0,4
49864,35,6,27,0,2,33
49865,46,18,20,0,8,38
49866,78,47,16,0,15,63
49867,32,24,1,0,7,25
49868,50,28,3,10,9,41
49869,222,131,18,26,47,175
49870,75,38,26,0,11,64
49871,28,0,23,0,5,23
49872,89,24,53,0,12,77
49873,9,0,8,1,0,9
49874,21,9,7,2,3,18
49875,79,29,24,8,18,61
49876,131,28,45,30,28,103
49877,24,10,9,2,3,21
49878,45,11,27,1,6,39
49879,32,9,16,1,6,26
49880,409,106,165,48,90,319
49881,331,239,17,2,73,258
49882,479,334,42,1,102,377
49883,85,68,3,0,14,71
49884,135,99,6,0,30,105
49885,55,32,15,2,6,49
49886,85,24,38,2,21,64
49887,121,42,50,11,18,103
49888,35,21,10,0,4,31
49889,58,12,30,0,16,42
49890,194,101,53,4,36,158
49891,112,24,49,14,25,87
49892,60,32,4,11,13,47
49893,92,58,13,3,18,74
49894,46,18,20,0,8,38
49895,183,92,52,0,39,144
49896,37,22,6,1,8,29
49897,6,0,6,0,0,6
49898,94,90,0,4,0,94
49899,127,97,6,3,21,106
49900,11,5,3,0,3,8
49901,29,13,14,0,2,27
49902,18,5,12,0,1,17
49903,47,39,1,0,7,40
49904,70,18,28,10,14,56
49905,55,38,6,1,10,45
49906,46,18,20,0,8,38
49907,302,148,88,5,61,241
49908,30,12,9,3,6,24
49909,28,21,0,0,7,21
49910,29,8,8,10,3,26
49911,117,31,37,23,26,91
49912,211,150,10,9,42,169
49913,99,66,9,2,22,77
49914,325,140,111,6,68,257
49915,93,27,38,10,18,75
49916,62,43,8,4,7,55
49917,26,9,10,1,6,20
49918,264,58,63,89,54,210
49919,55,42,3,2,8,47
49920,10,8,2,0,0,10
49921,88,64,10,0,14,74
49922,191,108,25,23,35,156
49923,2,0,2,0,0,2
49924,65,28,24,0,13,52
49925,26,18,2,0,6,20
49926,34,14,10,3,7,27
49927,56,25,20,0,11,45
49928,59,42,10,5,2,57
49929,36,23,4,1,8,28
49930,80,45,18,1,16,64
49931,11,8,2,0,1,10
49932,43,13,20,3,7,36
49933,38,9,17,4,8,30
49934,37,23,4,1,9,28
49935,32,21,9,0,2,30
49936,7,7,0,0,0,7
49937,68,14,38,1,15,53
49938,19,9,5,1,4,15
49939,108,103,0,5,0,108
49940,36,20,8,0,8,28
49941,51,14,24,0,13,38
49942,103,61,27,12,3,100
49943,83,36,29,4,14,69
49944,15,2,13,0,0,15
49945,579,400,53,1,125,454
49946,78,21,43,0,14,64
49947,62,41,5,0,16,46
49948,76,10,42,5,19,57
49949,47,5,30,0,12,35
49950,21,9,7,2,3,18
49951,42,25,11,0,6,36
49952,17,9,5,1,2,15
49953,55,16,28,0,11,44
49954,16,3,10,0,3,13
49955,35,21,4,4,6,29
49956,60,21,17,6,16,44
49957,15,3,8,0,4,11
49958,67,38,3,14,12,55
49959,75,56,5,0,14,61
49960,43,12,20,0,11,32
49961,413,297,23,0,93,320
49962,149,63,31,20,35,114
49963,17,2,12,0,3,14
49964,58,13,35,1,9,49
49965,71,22,34,2,13,58
49966,23,15,4,1,3,20
49967,166,75,52,6,33,133
49968,259,137,79,0,43,216
49969,8,4,1,1,2,6
49970,221,94,14,76,37,184
49971,95,54,23,3,15,80
49972,0,0,0,0,0,0
49973,46,18,20,0,8,38
49974,213,113,48,0,52,161
49975,36,12,16,0,8,28
49976,70,34,21,1,14,56
49977,474,214,160,12,88,386
49978,285,160,34,33,58,227
49979,446,254,84,15,93,353
49980,65,32,19,1,13,52
49981,20,7,7,2,4,16
49982,94,24,46,7,17,77
49983,42,14,23,0,5,37
49984,164,112,8,4,40,124
49985,38,14,18,1,5,33
49986,222,61,117,5,39,183
49987,317,128,131,3,55,262
49988,42,8,24,6,4,38
49989,52,34,8,2,8,44
49990,53,33,4,0,16,37
49991,362,163,119,8,72,290
49992,21,12,2,1,6,15
49993,44,2,27,7,8,36
49994,56,15,32,1,8,48
49995,24,15,7,0,2,22
49996,71,42,7,3,19,52
49997,7,4,3,0,0,7
49998,116,51,21,16,28,88
49999,56,21,25,0,10,46
50000,12,5,2,1,4,8
50001,249,171,26,7,45,204
50002,41,31,0,0,10,31
50003,53,9,34,0,10,43
50004,86,35,19,15,17,69
50005,47,21,19,1,6,41
50006,35,9,24,0,2,33
50007,54,33,14,0,7,47
50008,80,38,28,4,10,70
50009,48,27,17,0,4,44
50010,425,201,87,49,88,337
50011,29,4,22,0,3,26
50012,65,33,21,0,11,54
50013,90,18,30,24,18,72
50014,202,144,24,2,32,170
50015,67,52,2,0,13,54
50016,49,21,12,5,11,38
50017,30,9,7,4,10,20
50018,17,14,0,0,3,14
50019,94,45,29,3,17,77
50020,63,34,9,1,19,44
50021,10,2,5,0,3,7
50022,50,24,9,5,12,38
50023,63,29,25,0,9,54
50024,54,27,9,7,11,43
50025,33,14,13,0,6,27
50026,464,248,102,13,101,363
50027,13,6,4,0,3,10
50028,90,54,26,6,4,86
50029,415,201,137,7,70,345
50030,1,1,0,0,0,1
50031,67,30,18,7,12,55
50032,18,4,10,0,4,14
50033,433,205,141,12,75,358
50034,42,6,24,3,9,33
50035,545,260,124,41,120,425
50036,169,92,33,0,44,125
50037,108,79,12,1,16,92
50038,30,6,14,2,8,22
50039,36,13,15,1,7,29
50040,65,15,28,8,14,51
50041,62,18,33,1,10,52
50042,80,35,16,9,20,60
50043,37,17,12,0,8,29
50044,31,8,17,0,6,25
50045,191,146,14,1,30,161
50046,12,7,5,0,0,12
50047,36,21,6,2,7,29
50048,17,10,4,1,2,15
50049,32,21,9,0,2,30
50050,420,205,107,20,88,332
50051,24,10,8,2,4,20
50052,36,13,13,3,7,29
50053,58,31,6,8,13,45
50054,28,13,11,3,1,27
50055,468,121,200,41,106,362
50056,15,13,0,0,2,13
50057,71,53,1,0,17,54
50058,92,63,13,0,16,76
50059,113,57,32,0,24,89
50060,35,15,10,0,10,25
50061,173,90,45,4,34,139
50062,29,15,11,2,1,28
50063,63,51,0,1,11,52
50064,170,67,25,31,47,123
50065,82,29,37,3,13,69
50066,12,6,3,0,3,9
50067,7,2,3,0,2,5
50068,280,96,126,15,43,237
50069,145,82,13,23,27,118
50070,90,41,31,3,15,75
50071,1070,392,436,46,196,874
50072,162,107,24,1,30,132
50073,55,25,13,5,12,43
50074,20,9,9,0,2,18
50075,51,11,31,0,9,42
50076,16,4,5,3,4,12
50077,341,168,109,0,64,277
50078,25,11,13,0,1,24
50079,43,23,9,2,9,34
50080,73,32,5,14,22,51
50081,71,33,15,13,10,61
50082,123,59,29,14,21,102
50083,49,6,29,0,14,35
50084,99,55,13,14,17,82
50085,99,43,35,4,17,82
50086,33,7,20,1,5,28
50087,11,4,2,0,5,6
50088,215,113,59,0,43,172
50089,38,28,0,2,8,30
50090,9,3,3,1,2,7
50091,61,15,33,1,12,49
50092,67,26,26,4,11,56
50093,60,2,41,12,5,55
50094,672,392,143,17,120,552
50095,36,13,13,2,8,28
50096,33,5,18,1,9,24
50097,156,52,43,31,30,126
50098,33,3,5,17,8,25
50099,42,25,9,0,8,34
50100,269,184,19,4,62,207
50101,208,154,21,1,32,176
50102,551,393,43,1,114,437
50103,429,202,140,12,75,354
50104,30,13,13,0,4,26
50105,13,5,5,0,3,10
50106,75,19,34,3,19,56
50107,46,18,20,0,8,38
50108,14,2,7,3,2,12
50109,70,44,15,1,10,60
50110,7,1,5,0,1,6
50111,32,21,9,0,2,30
50112,100,52,36,2,10,90
50113,155,63,23,28,41,114
50114,285,142,82,5,56,229
50115,171,126,5,1,39,132
50116,42,27,6,2,7,35
50117,7,3,2,0,2,5
50118,631,354,151,22,104,527
50119,44,17,9,4,14,30
50120,142,89,16,9,28,114
50121,34,14,10,2,8,26
50122,373,210,85,0,78,295
50123,91,32,43,5,11,80
50124,66,34,14,0,18,48
50125,63,21,27,1,14,49
50126,83,32,34,0,17,66
50127,295,37,201,2,55,240
50128,65,20,3,31,11,54
50129,152,74,36,9,33,119
50130,47,9,29,0,9,38
50131,540,395,30,1,114,426
50132,72,35,23,1,13,59
50133,16,10,4,1,1,15
50134,32,21,9,0,2,30
50135,110,29,61,0,20,90
50136,40,22,10,0,8,32
50137,38,9,18,0,11,27
50138,57,29,12,3,13,44
50139,536,301,117,17,101,435
50140,153,100,3,16,34,119
50141,49,30,6,0,13,36
50142,64,37,14,0,13,51
50143,34,6,20,0,8,26
50144,105,49,33,5,18,87
50145,31,19,5,2,5,26
50146,19,1,11,0,7,12
50147,113,44,51,1,17,96
50148,176,53,90,0,33,143
50149,5,3,1,0,1,4
50150,97,45,15,22,15,82
50151,63,12,29,4,18,45
50152,54,23,20,1,10,44
50153,41,13,19,0,9,32
50154,109,44,14,17,34,75
50155,19,0,10,0,9,10
50156,66,25,16,10,15,51
50157,23,8,7,0,8,15
50158,189,88,47,16,38,151
50159,68,18,39,1,10,58
50160,661,365,163,23,110,551
50161,1,0,1,0,0,1
50162,91,57,10,2,22,69
50163,22,3,10,4,5,17
50164,32,11,14,2,5,27
50165,351,152,123,6,70,281
50166,67,4,51,2,10,57
50167,101,41,26,11,23,78
50168,28,8,13,0,7,21
50169,32,21,9,0,2,30
50170,65,36,12,2,15,50
50171,71,49,13,0,9,62
50172,35,5,25,1,4,31
50173,66,25,28,1,12,54
50174,363,206,71,7,79,284
50175,48,33,8,0,7,41
50176,46,18,20,0,8,38
50177,452,255,91,12,94,358
50178,431,201,150,6,74,357
50179,24,3,18,0,3,21
50180,40,11,18,0,11,29
50181,89,43,29,1,16,73
50182,108,43,36,7,22,86
50183,27,14,2,4,7,20
50184,55,22,5,18,10,45
50185,64,37,13,2,12,52
50186,84,44,16,8,16,68
50187,46,22,9,3,12,34
50188,37,4,25,0,8,29
50189,67,36,3,16,12,55
50190,211,91,63,20,37,174
50191,31,19,3,0,9,22
50192,29,8,19,1,1,28
50193,29,17,3,0,9,20
50194,98,44,27,6,21,77
50195,90,61,6,0,23,67
50196,159,108,26,0,25,134
50197,19,2,14,0,3,16
50198,71,16,37,7,11,60
50199,9,1,3,4,1,8
50200,466,319,47,1,99,367
50201,247,144,55,3,45,202
50202,26,4,14,1,7,19
50203,163,23,101,1,38,125
50204,372,248,39,1,84,288
50205,46,18,20,0,8,38
50206,5,4,1,0,0,5
50207,37,13,18,1,5,32
50208,20,4,11,2,3,17
50209,39,8,22,0,9,30
50210,188,107,23,23,35,153
50211,40,27,4,0,9,31
50212,46,18,20,0,8,38
50213,49,24,10,5,10,39
50214,8,5,1,0,2,6
50215,92,37,40,2,13,79
50216,94,58,11,2,23,71
50217,42,23,9,0,10,32
50218,156,71,50,5,30,126
50219,32,14,9,1,8,24
50220,151,69,47,6,29,122
50221,96,62,16,0,18,78
50222,158,79,23,25,31,127
50223,35,8,16,3,8,27
50224,15,0,11,0,4,11
50225,104,55,23,5,21,83
50226,79,41,15,3,20,59
50227,6,1,4,0,1,5
50228,301,186,49,0,66,235
50229,62,33,9,5,15,47
50230,33,9,16,0,8,25
50231,74,20,28,12,14,60
50232,30,13,8,1,8,22
50233,144,85,26,4,29,115
50234,27,7,10,3,7,20
50235,161,71,52,6,32,129
50236,159,90,21,20,28,131
50237,9,5,2,0,2,7
50238,280,159,29,33,59,221
50239,11,2,8,0,1,10
50240,46,18,20,0,8,38
50241,7,1,2,0,4,3
50242,17,7,8,0,2,15
50243,55,38,6,1,10,45
50244,96,56,19,6,15,81
50245,96,36,30,10,20,76
50246,122,58,32,0,32,90
50247,9,3,2,0,4,5
50248,30,2,23,1,4,26
50249,15,5,8,0,2,13
50250,76,41,22,0,13,63
50251,420,197,136,11,76,344
50252,66,35,13,2,16,50
50253,167,99,38,1,29,138
50254,47,6,30,0,11,36
50255,41,6,29,0,6,35
50256,20,9,2,3,6,14
50257,51,9,32,0,10,41
50258,29,11,11,0,7,22
50259,65,35,14,1,15,50
50260,53,23,15,3,12,41
50261,33,11,13,0,9,24
50262,46,15,22,1,8,38
50263,64,36,12,0,16,48
50264,102,68,1,11,22,80
50265,36,9,19,0,8,28
50266,79,41,18,0,20,59
50267,31,16,2,5,8,23
50268,10,5,2,0,3,7
50269,14,7,4,1,2,12
50270,111,49,28,2,32,79
50271,19,11,5,0,3,16
50272,64,46,1,0,17,47
50273,359,182,108,4,65,294
50274,34,3,24,5,2,32
50275,56,23,11,8,14,42
50276,6,1,4,0,1,5
50277,43,10,20,0,13,30
50278,45,34,8,3,0,45
50279,114,37,29,21,27,87
50280,84,25,29,11,19,65
50281,27,4,14,2,7,20
50282,86,39,31,0,16,70
50283,63,11,30,4,18,45
50284,32,17,2,5,8,24
50285,237,59,128,7,43,194
50286,474,344,29,0,101,373
50287,350,189,92,14,55,295
50288,95,36,19,12,28,67
50289,657,386,140,17,114,543
50290,42,4,31,1,6,36
50291,123,96,2,1,24,99
50292,46,18,20,0,8,38
50293,672,392,141,19,120,552
50294,39,20,14,0,5,34
50295,177,101,16,20,40,137
50296,124,55,35,8,26,98
50297,60,15,32,1,12,48
50298,36,4,22,2,8,28
50299,43,16,18,3,6,37
50300,33,15,7,1,10,23
50301,57,44,1,0,12,45
50302,321,194,57,0,70,251
50303,57,21,21,4,11,46
50304,55,23,15,2,15,40
50305,70,37,12,8,13,57
50306,139,56,35,20,28,111
50307,60,49,0,1,10,50
50308,125,58,35,0,32,93
50309,46,32,4,0,10,36
50310,60,20,23,4,13,47
50311,129,60,40,4,25,104
50312,369,204,92,14,59,310
50313,12,3,5,0,4,8
50314,31,8,10,5,8,23
50315,84,43,4,24,13,71
50316,45,29,11,0,5,40
50317,35,12,18,0,5,30
50318,18,8,7,1,2,16
50319,140,109,6,0,25,115
50320,444,254,85,12,93,351
50321,104,36,46,4,18,86
50322,31,15,3,5,8,23
50323,164,81,37,10,36,128
50324,51,25,10,7,9,42
50325,6,0,5,0,1,5
50326,68,55,2,0,11,57
50327,20,10,4,1,5,15
50328,550,395,36,1,118,432
50329,51,30,5,9,7,44
50330,30,13,8,1,8,22
50331,138,58,50,0,30,108
50332,86,40,28,4,14,72
50333,490,264,124,20,82,408
50334,37,16,11,3,7,30
50335,70,26,12,21,11,59
50336,160,114,11,0,35,125
50337,64,28,13,4,19,45
50338,138,43,72,3,20,118
50339,21,5,11,1,4,17
50340,104,49,35,4,16,88
50341,50,27,10,2,11,39
50342,21,5,5,2,9,12
50343,80,37,27,1,15,65
50344,30,11,15,0,4,26
50345,9,2,3,0,4,5
50346,77,20,36,7,14,63
50347,93,57,16,1,19,74
50348,58,39,13,6,0,58
50349,110,41,26,24,19,91
50350,44,38,1,0,5,39
50351,279,177,38,11,53,226
50352,36,19,14,0,3,33
50353,252,165,22,3,62,190
50354,97,41,29,7,20,77
50355,134,52,47,8,27,107
50356,395,131,157,23,84,311
50357,48,25,7,8,8,40
50358,95,49,13,18,15,80
50359,142,35,76,1,30,112
50360,55,21,15,5,14,41
50361,36,16,8,5,7,29
50362,38,20,7,2,9,29
50363,75,10,50,0,15,60
50364,178,100,33,0,45,133
50365,17,2,9,1,5,12
50366,21,11,8,1,1,20
50367,194,88,48,20,38,156
50368,24,5,13,0,6,18
50369,33,8,17,4,4,29
50370,35,2,27,2,4,31
50371,34,14,11,0,9,25
50372,37,18,9,0,10,27
50373,566,327,118,18,103,463
50374,189,38,68,39,44,145
50375,188,132,39,2,15,173
50376,77,42,19,0,16,61
50377,92,29,4,45,14,78
50378,125,69,32,0,24,101
50379,32,21,9,0,2,30
50380,93,49,20,5,19,74
50381,32,14,9,0,9,23
50382,442,116,186,38,102,340
50383,16,12,3,0,1,15
50384,45,25,8,4,8,37
50385,35,15,9,2,9,26
50386,21,9,6,1,5,16
50387,19,2,10,0,7,12
50388,42,10,27,0,5,37
50389,10,0,6,0,4,6
50390,87,37,27,3,20,67
50391,390,99,158,47,86,304
50392,35,21,4,0,10,25
50393,19,8,4,2,5,14
50394,40,6,27,0,7,33
50395,33,21,4,0,8,25
50396,70,33,29,0,8,62
50397,70,31,25,0,14,56
50398,220,94,14,75,37,183
50399,29,2,21,1,5,24
50400,32,21,9,0,2,30
50401,54,26,21,0,7,47
50402,33,25,1,0,7,26
50403,39,23,9,4,3,36
50404,88,21,45,7,15,73
50405,250,127,71,0,52,198
50406,94,58,19,2,15,79
50407,51,34,5,3,9,42
50408,419,197,137,11,74,345
50409,29,13,11,0,5,24
50410,99,33,26,21,19,80
50411,49,34,4,4,7,42
50412,148,94,28,0,26,122
50413,2,1,1,0,0,2
50414,1,1,0,0,0,1
50415,20,15,0,0,5,15
50416,74,39,21,0,14,60
50417,46,18,20,0,8,38
50418,96,43,33,4,16,80
50419,47,27,16,0,4,43
50420,40,9,15,10,6,34
50421,61,27,22,0,12,49
50422,213,114,34,20,45,168
50423,506,266,87,49,104,402
50424,39,11,18,0,10,29
50425,88,44,29,3,12,76
50426,619,363,139,18,99,520
50427,32,13,11,1,7,25
50428,46,28,5,7,6,40
50429,227,126,51,0,50,177
50430,98,43,33,4,18,80
50431,80,29,42,2,7,73
50432,76,29,34,3,10,66
50433,73,62,0,1,10,63
50434,199,64,81,14,40,159
50435,141,84,29,0,28,113
50436,142,91,29,0,22,120
50437,30,17,4,8,1,29
50438,18,4,11,0,3,15
50439,26,1,21,1,3,23
50440,15,7,5,0,3,12
50441,42,23,9,0,10,32
50442,38,7,10,16,5,33
50443,36,16,8,2,10,26
50444,33,17,7,4,5,28
50445,63,41,4,0,18,45
50446,32,21,9,0,2,30
50447,32,21,9,0,2,30
50448,42,17,16,0,9,33
50449,52,28,8,4,12,40
50450,110,34,54,1,21,89
50451,24,2,17,0,5,19
50452,6,5,0,0,1,5
50453,11,4,2,0,5,6
50454,61,36,15,0,10,51
50455,37,2,25,0,10,27
50456,99,40,36,0,23,76
50457,36,18,11,2,5,31
50458,27,7,14,0,6,21
50459,15,13,0,1,1,14
50460,92,32,36,5,19,73
50461,66,33,16,0,17,49
50462,21,13,4,0,4,17
50463,58,41,4,0,13,45
50464,135,57,50,2,26,109
50465,57,38,13,0,6,51
50466,64,30,22,0,12,52
50467,73,24,27,9,13,60
50468,11,3,8,0,0,11
50469,97,30,35,12,20,77
50470,35,8,15,3,9,26
50471,31,6,13,4,8,23
50472,40,24,10,4,2,38
50473,64,41,5,0,18,46
50474,132,52,36,16,28,104
50475,134,84,30,0,20,114
50476,23,3,14,0,6,17
50477,17,10,4,0,3,14
50478,36,14,11,3,8,28
50479,23,13,7,0,3,20
50480,46,18,20,0,8,38
50481,156,64,36,18,38,118
50482,49,30,11,0,8,41
50483,290,132,105,5,48,242
50484,141,85,29,5,22,119
50485,40,4,27,0,9,31
50486,143,60,32,17,34,109
50487,93,61,21,0,11,82
50488,373,276,18,2,77,296
50489,131,49,48,8,26,105
50490,35,7,14,0,14,21
50491,32,21,9,0,2,30
50492,57,20,25,0,12,45
50493,26,2,19,0,5,21
50494,8,3,4,1,0,8
50495,149,115,13,1,20,129
50496,456,128,188,36,104,352
50497,15,9,0,5,1,14
50498,94,55,7,16,16,78
50499,73,45,9,7,12,61
50500,8,3,4,0,1,7
50501,117,44,26,24,23,94
50502,151,98,15,6,32,119
50503,233,155,32,0,46,187
50504,441,136,187,19,99,342
50505,58,21,11,17,9,49
50506,51,26,18,0,7,44
50507,140,66,43,9,22,118
50508,70,39,13,2,16,54
50509,351,185,92,15,59,292
50510,50,30,10,0,10,40
50511,46,26,9,4,7,39
50512,398,180,131,6,81,317
50513,53,23,24,0,6,47
50514,56,39,11,6,0,56
50515,54,32,9,0,13,41
50516,61,43,3,0,15,46
50517,19,7,4,1,7,12
50518,74,56,7,4,7,67
50519,22,19,2,0,1,21
50520,76,35,5,14,22,54
50521,470,219,149,13,89,381
50522,144,81,37,1,25,119
50523,1079,395,438,46,200,879
50524,1,0,0,0,1,0
50525,30,12,5,2,11,19
50526,84,37,26,3,18,66
50527,56,30,15,2,9,47
50528,101,63,25,0,13,88
50529,82,8,46,10,18,64
50530,149,45,50,21,33,116
50531,46,18,20,0,8,38
50532,21,11,2,5,3,18
50533,97,32,45,1,19,78
50534,210,93,84,5,28,182
50535,73,51,9,2,11,62
50536,100,36,47,3,14,86
50537,87,40,32,1,14,73
50538,44,11,21,0,12,32
50539,71,44,13,2,12,59
50540,452,137,188,33,94,358
50541,153,87,39,1,26,127
50542,160,62,42,25,31,129
50543,10,6,1,0,3,7
50544,15,2,1,10,2,13
50545,9,7,1,0,1,8
50546,270,93,112,11,54,216
50547,44,23,14,0,7,37
50548,44,13,20,0,11,33
50549,60,11,22,15,12,48
50550,163,69,35,20,39,124
50551,32,21,9,0,2,30
50552,17,9,2,1,5,12
50553,85,55,15,0,15,70
50554,53,39,6,2,6,47
50555,2,0,2,0,0,2
50556,76,42,19,0,15,61
50557,116,94,4,2,16,100
50558,74,44,16,0,14,60
50559,80,50,19,9,2,78
50560,105,30,32,24,19,86
50561,75,20,32,10,13,62
50562,58,21,23,1,13,45
50563,140,63,44,7,26,114
50564,66,5,45,0,16,50
50565,8,2,5,0,1,7
50566,32,21,9,0,2,30
50567,127,68,23,4,32,95
50568,19,5,12,1,1,18
50569,66,19,24,12,11,55
50570,35,10,9,7,9,26
50571,434,206,120,14,94,340
50572,13,2,8,1,2,11
50573,105,42,33,10,20,85
50574,64,27,21,5,11,53
50575,176,47,53,40,36,140
50576,128,102,4,0,22,106
50577,15,5,8,0,2,13
50578,132,46,29,26,31,101
50579,105,47,34,5,19,86
50580,36,3,22,0,11,25
50581,41,15,14,4,8,33
50582,3,2,1,0,0,3
50583,26,13,4,0,9,17
50584,90,24,47,2,17,73
50585,86,35,40,1,10,76
50586,28,7,16,0,5,23
50587,253,190,13,0,50,203
50588,186,96,48,7,35,151
50589,50,18,18,1,13,37
50590,71,29,26,4,12,59
50591,190,128,20,0,42,148
50592,112,105,0,7,0,112
50593,123,47,49,13,14,109
50594,13,5,8,0,0,13
50595,113,43,42,10,18,95
50596,78,39,20,4,15,63
50597,41,24,8,1,8,33
50598,473,133,195,38,107,366
50599,53,20,19,2,12,41
50600,211,116,47,0,48,163
50601,57,26,25,0,6,51
50602,96,42,26,3,25,71
50603,249,187,11,0,51,198
50604,104,15,49,12,28,76
50605,53,27,10,7,9,44
50606,559,398,44,1,116,443
50607,77,31,27,2,17,60
50608,49,22,19,0,8,41
50609,73,35,12,7,19,54
50610,32,21,9,0,2,30
50611,82,34,25,4,19,63
50612,645,359,160,22,104,541
50613,120,77,11,4,28,92
50614,216,80,61,30,45,171
50615,9,5,1,0,3,6
50616,41,19,8,5,9,32
50617,87,71,2,0,14,73
50618,35,20,10,0,5,30
50619,44,22,16,0,6,38
50620,544,348,69,7,120,424
50621,9,2,3,0,4,5
50622,30,8,15,0,7,23
50623,33,24,5,0,4,29
50624,94,49,13,17,15,79
50625,17,7,7,0,3,14
50626,40,30,1,2,7,33
50627,56,40,9,0,7,49
50628,81,9,53,3,16,65
50629,14,5,6,2,1,13
50630,43,1,37,0,5,38
50631,456,272,78,5,101,355
50632,32,14,12,0,6,26
50633,49,22,6,11,10,39
50634,35,17,7,0,11,24
50635,25,16,3,0,6,19
50636,446,214,141,11,80,366
50637,32,21,3,0,8,24
50638,77,39,19,0,19,58
50639,276,19,200,2,55,221
50640,481,281,87,7,106,375
50641,64,26,27,0,11,53
50642,23,10,6,2,5,18
50643,240,127,58,12,43,197
50644,75,12,49,0,14,61
50645,29,13,11,0,5,24
50646,126,74,21,3,28,98
50647,47,23,14,1,9,38
50648,16,8,2,1,5,11
50649,79,27,31,10,11,68
50650,56,40,8,0,8,48
50651,116,48,31,15,22,94
50652,448,225,117,14,92,356
50653,60,16,17,12,15,45
50654,93,24,41,3,25,68
50655,85,44,26,0,15,70
50656,42,7,27,0,8,34
50657,82,79,0,3,0,82
50658,111,58,30,4,19,92
50659,94,27,42,6,19,75
50660,59,42,10,5,2,57
50661,33,13,11,1,8,25
50662,79,22,36,1,20,59
50663,42,15,21,0,6,36
50664,99,36,46,3,14,85
50665,67,27,16,6,18,49
50666,24,12,7,1,4,20
50667,46,13,21,1,11,35
50668,224,123,55,0,46,178
50669,16,4,6,0,6,10
50670,468,121,198,42,107,361
50671,65,44,8,0,13,52
50672,46,31,1,2,12,34
50673,86,55,11,3,17,69
50674,27,13,3,5,6,21
50675,17,7,7,0,3,14
50676,95,10,61,5,19,76
50677,80,37,5,16,22,58
50678,45,14,11,10,10,35
50679,38,18,9,1,10,28
50680,32,24,2,0,6,26
50681,14,9,4,0,1,13
50682,69,43,12,3,11,58
50683,29,14,7,0,8,21
50684,509,280,83,41,105,404
50685,1,0,1,0,0,1
50686,25,8,7,2,8,17
50687,8,2,3,0,3,5
50688,32,21,9,0,2,30
50689,35,27,3,1,4,31
50690,45,19,13,1,12,33
50691,71,36,17,0,18,53
50692,37,2,26,2,7,30
50693,165,98,37,1,29,136
50694,17,5,5,0,7,10
50695,424,120,193,11,100,324
50696,84,22,44,7,11,73
50697,88,59,8,0,21,67
50698,27,14,5,0,8,19
50699,77,25,31,8,13,64
50700,319,164,80,18,57,262
50701,121,91,6,0,24,97
50702,85,53,21,10,1,84
50703,68,42,16,0,10,58
50704,66,36,2,17,11,55
50705,127,47,32,20,28,99
50706,16,10,3,0,3,13
50707,11,5,4,0,2,9
50708,81,56,8,3,14,67
50709,37,23,2,0,12,25
50710,19,3,15,0,1,18
50711,33,9,16,0,8,25
50712,25,18,3,0,4,21
50713,23,10,11,0,2,21
50714,44,7,24,6,7,37
50715,187,115,39,18,15,172
50716,642,372,147,17,106,536
50717,110,44,14,17,35,75
50718,44,7,18,9,10,34
50719,43,3,33,4,3,40
50720,572,320,117,13,122,450
50721,15,5,8,0,2,13
50722,76,34,10,15,17,59
50723,13,6,4,0,3,10
50724,66,33,9,6,18,48
50725,92,65,13,0,14,78
50726,16,10,5,1,0,16
50727,68,41,13,0,14,54
50728,42,23,9,0,10,32
50729,33,5,20,0,8,25
50730,68,36,11,7,14,54
50731,192,94,63,1,34,158
50732,27,5,18,0,4,23
50733,471,220,148,13,90,381
50734,130,38,60,4,28,102
50735,141,25,89,1,26,115
50736,144,48,46,19,31,113
50737,73,50,6,0,17,56
50738,57,23,4,20,10,47
50739,13,4,6,0,3,10
50740,31,2,24,1,4,27
50741,96,50,26,0,20,76
50742,122,54,22,19,27,95
50743,32,16,12,0,4,28
50744,191,78,40,29,44,147
50745,202,153,19,1,29,173
50746,55,39,9,7,0,55
50747,196,110,25,23,38,158
50748,143,36,76,1,30,113
50749,187,74,39,29,45,142
50750,19,9,9,0,1,18
50751,22,2,16,0,4,18
50752,81,67,1,0,13,68
50753,154,107,22,0,25,129
50754,9,2,4,1,2,7
50755,63,9,42,0,12,51
50756,259,171,21,3,64,195
50757,8,1,2,4,1,7
50758,253,73,132,1,47,206
50759,55,26,16,1,12,43
50760,35,27,3,1,4,31
50761,18,10,7,0,1,17
50762,217,90,43,27,57,160
50763,49,8,29,3,9,40
50764,190,133,14,8,35,155
50765,93,44,30,0,19,74
50766,38,27,1,0,10,28
50767,506,356,43,1,106,400
50768,21,11,2,5,3,18
50769,21,7,11,1,2,19
50770,38,23,5,1,9,29
50771,75,43,11,6,15,60
50772,189,58,78,14,39,150
50773,201,93,69,2,37,164
50774,47,9,30,0,8,39
50775,191,146,14,1,30,161
50776,53,21,18,4,10,43
50777,76,21,35,7,13,63
50778,16,15,0,0,1,15
50779,20,12,3,0,5,15
50780,360,161,118,9,72,288
50781,160,105,24,1,30,130
50782,52,17,21,4,10,42
50783,72,11,47,1,13,59
50784,40,12,21,1,6,34
50785,422,273,60,4,85,337
50786,81,30,28,7,16,65
50787,9,2,5,0,2,7
50788,54,26,17,0,11,43
50789,75,30,31,0,14,61
50790,77,27,28,6,16,61
50791,72,41,18,0,13,59
50792,389,127,161,12,89,300
50793,29,3,19,0,7,22
50794,18,10,5,0,3,15
50795,36,16,10,1,9,27
50796,23,9,8,2,4,19
50797,21,7,12,0,2,19
50798,525,281,117,16,111,414
50799,52,16,22,3,11,41
50800,125,53,41,4,27,98
50801,73,36,18,0,19,54
50802,353,181,103,3,66,287
50803,125,85,19,0,21,104
50804,74,42,22,2,8,66
50805,53,12,25,1,15,38
50806,46,18,20,0,8,38
50807,41,3,31,0,7,34
50808,148,95,36,11,6,142
50809,177,101,31,0,45,132
50810,91,38,16,19,18,73
50811,5,5,0,0,0,5
50812,12,0,10,0,2,10
50813,54,38,5,1,10,44
50814,35,21,8,1,5,30
50815,51,24,7,7,13,38
50816,11,6,5,0,0,11
50817,80,22,41,2,15,65
50818,413,106,175,42,90,323
50819,52,14,29,0,9,43
50820,18,9,6,0,3,15
50821,199,41,54,65,39,160
50822,284,69,160,4,51,233
50823,32,18,6,1,7,25
50824,111,32,42,10,27,84
50825,81,40,27,1,13,68
50826,102,52,23,0,27,75
50827,20,10,5,0,5,15
50828,49,23,17,0,9,40
50829,201,138,46,2,15,186
50830,125,59,26,4,36,89
50831,287,136,74,20,57,230
50832,39,21,8,1,9,30
50833,135,54,40,15,26,109
50834,63,47,5,4,7,56
50835,113,44,24,21,24,89
50836,18,8,9,0,1,17
50837,283,97,127,14,45,238
50838,32,19,6,0,7,25
50839,84,37,32,1,14,70
50840,30,3,19,2,6,24
50841,60,16,22,12,10,50
50842,52,13,27,0,12,40
50843,152,37,81,4,30,122
50844,155,53,32,34,36,119
50845,132,50,34,15,33,99
50846,583,329,143,19,92,491
50847,18,9,8,0,1,17
50848,71,30,31,1,9,62
50849,70,28,30,0,12,58
50850,80,37,28,0,15,65
50851,67,34,19,0,14,53
50852,41,11,10,14,6,35
50853,29,8,13,0,8,21
50854,65,23,30,1,11,54
50855,6,2,2,0,2,4
50856,54,2,43,0,9,45
50857,42,22,10,0,10,32
50858,47,34,4,0,9,38
50859,12,7,4,0,1,11
50860,468,138,187,38,105,363
50861,93,60,21,1,11,82
50862,42,24,12,0,6,36
50863,425,122,161,47,95,330
50864,31,18,6,0,7,24
50865,5,1,3,0,1,4
50866,46,10,5,22,9,37
50867,18,6,9,0,3,15
50868,256,150,21,33,52,204
50869,144,93,29,0,22,122
50870,6,3,2,0,1,5
50871,104,56,22,7,19,85
50872,55,33,10,0,12,43
50873,47,13,16,9,9,38
50874,125,40,46,6,33,92
50875,67,35,14,4,14,53
50876,184,131,15,1,37,147
50877,33,3,22,1,7,26
50878,32,13,9,1,9,23
50879,79,45,11,0,23,56
50880,85,17,42,9,17,68
50881,423,202,132,13,76,347
50882,42,7,25,2,8,34
50883,105,54,24,0,27,78
50884,13,3,5,1,4,9
50885,165,70,54,3,38,127
50886,18,4,7,1,6,12
50887,55,27,14,3,11,44
50888,133,77,30,0,26,107
50889,19,10,8,0,1,18
50890,18,5,9,0,4,14
50891,143,96,22,0,25,118
50892,178,101,32,0,45,133
50893,92,45,34,2,11,81
50894,201,146,15,1,39,162
50895,37,21,5,1,10,27
50896,273,206,17,0,50,223
50897,62,17,33,3,9,53
50898,39,10,24,0,5,34
50899,0,0,0,0,0,0
50900,123,63,22,12,26,97
50901,25,12,6,3,4,21
50902,11,4,7,0,0,11
50903,85,49,15,10,11,74
50904,59,43,5,4,7,52
50905,18,9,4,2,3,15
50906,8,1,4,0,3,5
50907,8,6,1,0,1,7
50908,33,22,4,0,7,26
50909,76,58,6,1,11,65
50910,61,1,34,19,7,54
50911,83,41,22,1,19,64
50912,35,11,14,0,10,25
50913,165,98,37,1,29,136
50914,51,17,14,5,15,36
50915,78,51,7,2,18,60
50916,32,21,9,0,2,30
50917,151,24,98,1,28,123
50918,570,319,118,13,120,450
50919,343,148,122,11,62,281
50920,49,6,35,0,8,41
50921,14,8,0,0,6,8
50922,209,149,11,7,42,167
50923,3,2,0,0,1,2
50924,337,85,164,5,83,254
50925,85,41,23,0,21,64
50926,164,9,94,28,33,131
50927,47,33,4,0,10,37
50928,30,15,6,1,8,22
50929,50,12,26,1,11,39
50930,102,55,28,1,18,84
50931,27,8,13,0,6,21
50932,193,88,47,20,38,155
50933,46,18,20,0,8,38
50934,19,3,13,0,3,16
50935,5,5,0,0,0,5
50936,23,19,2,0,2,21
50937,230,175,9,1,45,185
50938,128,65,12,23,28,100
50939,181,79,30,28,44,137
50940,69,32,23,1,13,56
50941,46,28,10,0,8,38
50942,19,1,13,0,5,14
50943,76,28,30,3,15,61
50944,12,1,6,0,5,7
50945,79,24,33,9,13,66
50946,19,14,3,0,2,17
50947,129,93,18,0,18,111
50948,38,18,11,1,8,30
50949,26,19,3,1,3,23
50950,14,5,7,0,2,12
50951,70,33,19,7,11,59
50952,31,19,6,0,6,25
50953,66,41,6,7,12,54
50954,49,33,5,2,9,40
50955,16,5,7,1,3,13
50956,47,18,22,1,6,41
50957,75,8,43,5,19,56
50958,78,39,7,13,19,59
50959,202,108,61,0,33,169
50960,63,41,13,0,9,54
50961,310,231,12,2,65,245
50962,91,20,44,16,11,80
50963,66,17,32,0,17,49
50964,220,149,30,0,41,179
50965,94,28,50,1,15,79
50966,153,86,19,21,27,126
50967,50,19,17,1,13,37
50968,37,22,7,0,8,29
50969,19,7,10,0,2,17
50970,26,12,9,0,5,21
50971,334,146,113,6,69,265
50972,42,10,12,9,11,31
50973,32,13,11,2,6,26
50974,110,40,45,9,16,94
50975,286,137,95,4,50,236
50976,71,34,12,7,18,53
50977,86,39,29,4,14,72
50978,118,81,11,2,24,94
50979,66,26,30,0,10,56
50980,17,6,9,1,1,16
50981,46,25,15,0,6,40
50982,466,138,185,36,107,359
50983,6,0,4,0,2,4
50984,169,82,50,3,34,135
50985,144,62,53,7,22,122
50986,32,6,18,3,5,27
50987,78,44,20,0,14,64
50988,147,81,14,24,28,119
50989,61,34,11,0,16,45
50990,37,6,25,1,5,32
50991,27,14,10,2,1,26
50992,57,39,11,5,2,55
50993,50,28,14,0,8,42
50994,87,67,0,4,16,71
50995,82,51,13,0,18,64
50996,586,329,144,20,93,493
50997,53,23,17,1,12,41
50998,3,2,1,0,0,3
50999,45,7,24,5,9,36
51000,121,38,42,15,26,95
51001,6,4,2,0,0,6
51002,4,1,2,0,1,3
51003,48,21,18,2,7,41
51004,11,1,4,0,6,5
51005,93,52,27,11,3,90
51006,22,9,10,1,2,20
51007,95,31,5,45,14,81
51008,60,17,26,6,11,49
51009,11,1,7,0,3,8
51010,24,2,17,0,5,19
51011,29,7,15,3,4,25
51012,85,42,5,25,13,72
51013,46,18,20,0,8,38
51014,99,51,29,1,18,81
51015,50,29,13,0,8,42
51016,56,38,11,0,7,49
51017,32,21,9,0,2,30
51018,97,58,19,4,16,81
51019,254,179,23,0,52,202
51020,138,49,54,0,35,103
51021,88,39,32,1,16,72
51022,10,4,5,0,1,9
51023,280,190,65,3,22,258
51024,32,21,9,0,2,30
51025,193,88,47,20,38,155
51026,49,24,16,0,9,40
51027,311,161,97,0,53,258
51028,11,10,0,0,1,10
51029,89,53,10,0,26,63
51030,60,30,4,15,11,49
51031,17,7,2,3,5,12
51032,63,37,13,1,12,51
51033,83,50,17,4,12,71
51034,91,49,11,10,21,70
51035,193,94,35,32,32,161
51036,18,6,10,0,2,16
51037,99,23,53,3,20,79
51038,24,9,7,4,4,20
51039,126,75,20,3,28,98
51040,3,0,2,0,1,2
51041,40,31,3,2,4,36
51042,58,19,24,3,12,46
51043,94,61,14,11,8,86
51044,344,144,126,6,68,276
51045,526,227,132,48,119,407
51046,69,44,12,1,12,57
51047,123,58,28,13,24,99
51048,42,9,21,0,12,30
51049,143,116,7,2,18,125
51050,33,5,23,1,4,29
51051,5,0,3,0,2,3
51052,8,2,3,1,2,6
51053,9,3,4,0,2,7
51054,101,52,18,8,23,78
51055,39,2,19,12,6,33
51056,78,25,27,14,12,66
51057,30,18,7,1,4,26
51058,122,50,44,15,13,109
51059,37,14,15,1,7,30
51060,16,4,11,0,1,15
51061,83,55,18,0,10,73
51062,60,29,15,3,13,47
51063,101,47,15,24,15,86
51064,61,24,26,0,11,50
51065,68,33,12,7,16,52
51066,43,20,12,3,8,35
51067,116,41,42,7,26,90
51068,103,67,6,8,22,81
51069,158,26,101,1,30,128
51070,43,21,15,0,7,36
51071,65,9,48,0,8,57
51072,192,87,47,20,38,154
51073,52,19,15,9,9,43
51074,126,80,29,0,17,109
51075,211,58,103,14,36,175
51076,36,24,7,1,4,32
51077,60,31,16,3,10,50
51078,107,81,4,2,20,87
51079,20,9,8,1,2,18
51080,7,0,7,0,0,7
51081,74,44,17,0,13,61
51082,149,42,48,24,35,114
51083,37,16,14,0,7,30
51084,20,9,6,3,2,18
51085,43,24,15,0,4,39
51086,112,40,52,1,19,93
51087,60,32,16,0,12,48
51088,122,63,16,14,29,93
51089,76,29,29,1,17,59
51090,9,0,8,0,1,8
51091,41,24,11,0,6,35
51092,31,4,21,0,6,25
51093,418,311,20,0,87,331
51094,65,45,8,0,12,53
51095,600,431,43,1,125,475
51096,1,1,0,0,0,1
51097,28,7,15,2,4,24
51098,105,51,27,4,23,82
51099,83,57,6,7,13,70
51100,28,7,10,3,8,20
51101,51,16,23,2,10,41
51102,66,15,34,7,10,56
51103,64,2,37,18,7,57
51104,58,20,20,5,13,45
51105,65,24,6,22,13,52
51106,46,18,20,0,8,38
51107,65,51,0,0,14,51
51108,111,105,0,6,0,111
51109,3,1,0,0,2,1
51110,49,9,26,5,9,40
51111,15,5,4,0,6,9
51112,23,8,10,0,5,18
51113,69,38,18,0,13,56
51114,448,278,71,3,96,352
51115,27,13,8,0,6,21
51116,10,5,4,0,1,9
51117,91,41,31,4,15,76
51118,16,11,3,0,2,14
51119,35,21,6,1,7,28
51120,283,160,31,33,59,224
51121,261,115,95,2,49,212
51122,80,57,8,0,15,65
51123,40,9,20,1,10,30
51124,7,1,3,0,3,4
51125,19,5,8,0,6,13
51126,58,30,20,0,8,50
51127,21,1,17,0,3,18
51128,51,22,18,3,8,43
51129,23,4,8,3,8,15
51130,147,92,27,0,28,119
51131,42,23,9,0,10,32
51132,48,24,11,2,11,37
51133,39,20,6,1,12,27
51134,104,87,3,3,11,93
51135,62,16,30,1,15,47
51136,167,85,40,0,42,125
51137,18,3,10,0,5,13
51138,281,185,69,4,23,258
51139,53,19,21,0,13,40
51140,53,15,33,0,5,48
51141,580,426,36,1,117,463
51142,2,0,0,0,2,0
51143,474,343,28,1,102,372
51144,16,2,13,0,1,15
51145,195,76,35,34,50,145
51146,36,16,12,0,8,28
51147,64,19,32,1,12,52
51148,68,38,16,0,14,54
51149,115,56,21,19,19,96
51150,22,11,2,4,5,17
51151,64,41,5,0,18,46
51152,19,10,4,1,4,15
51153,150,90,29,0,31,119
51154,81,52,9,1,19,62
51155,227,98,45,26,58,169
51156,99,51,27,2,19,80
51157,155,122,11,1,21,134
51158,85,36,31,0,18,67
51159,25,14,7,0,4,21
51160,106,56,27,4,19,87
51161,22,13,2,0,7,15
51162,171,129,6,1,35,136
51163,196,77,36,32,51,145
51164,89,9,51,6,23,66
51165,71,36,16,0,19,52
51166,48,30,7,6,5,43
51167,204,62,20,91,31,173
51168,15,2,2,9,2,13
51169,74,29,30,1,14,60
51170,9,1,5,1,2,7
51171,6,3,2,0,1,5
51172,247,188,13,0,46,201
51173,57,25,23,2,7,50
51174,32,14,11,0,7,25
51175,47,23,13,0,11,36
51176,181,69,46,27,39,142
51177,47,20,13,4,10,37
51178,23,17,5,1,0,23
51179,105,32,51,0,22,83
51180,136,80,30,0,26,110
51181,14,0,9,0,5,9
51182,91,42,28,5,16,75
51183,46,18,20,0,8,38
51184,8,4,4,0,0,8
51185,10,3,4,1,2,8
51186,1,1,0,0,0,1
51187,13,5,5,2,1,12
51188,21,13,1,3,4,17
51189,323,140,109,6,68,255
51190,26,7,13,0,6,20
51191,96,61,18,2,15,81
51192,379,208,102,0,69,310
51193,56,25,14,2,15,41
51194,30,17,8,0,5,25
51195,109,53,36,0,20,89
51196,276,67,159,1,49,227
51197,440,324,20,0,96,344
51198,32,21,9,0,2,30
51199,510,277,113,13,107,403
51200,18,10,1,1,6,12
51201,72,37,14,8,13,59
51202,10,5,5,0,0,10
51203,66,5,47,1,13,53
51204,144,88,28,0,28,116
51205,6,4,0,2,0,6
51206,37,7,10,15,5,32
51207,152,51,42,31,28,124
51208,2,1,0,0,1,1
51209,5,1,2,0,2,3
51210,92,51,15,9,17,75
51211,8,4,1,2,1,7
51212,20,7,4,4,5,15
51213,90,61,6,0,23,67
51214,265,180,62,3,20,245
51215,11,3,8,0,0,11
51216,45,6,29,0,10,35
51217,53,27,10,7,9,44
51218,60,49,0,1,10,50
51219,91,35,30,2,24,67
51220,44,16,17,3,8,36
51221,471,221,145,12,93,378
51222,90,32,27,11,20,70
51223,165,12,93,27,33,132
51224,56,5,36,1,14,42
51225,35,13,4,9,9,26
51226,43,28,8,0,7,36
51227,175,77,48,10,40,135
51228,183,146,9,0,28,155
51229,53,18,22,0,13,40
51230,78,54,10,0,14,64
51231,76,4,53,1,18,58
51232,67,23,29,1,14,53
51233,27,12,12,0,3,24
51234,75,41,20,0,14,61
51235,86,38,31,1,16,70
51236,567,406,44,1,116,451
51237,96,64,7,9,16,80
51238,34,10,17,1,6,28
51239,61,48,0,0,13,48
51240,14,2,8,0,4,10
51241,63,22,14,17,10,53
51242,46,25,11,3,7,39
51243,39,12,14,3,10,29
51244,39,16,14,1,8,31
51245,130,65,39,0,26,104
51246,22,2,14,0,6,16
51247,49,18,19,1,11,38
51248,72,35,13,12,12,60
51249,40,15,17,0,8,32
51250,30,12,13,2,3,27
51251,447,253,86,15,93,354
51252,76,38,17,2,19,57
51253,105,30,46,6,23,82
51254,90,64,15,1,10,80
51255,47,25,11,0,11,36
51256,56,37,12,0,7,49
51257,428,239,100,0,89,339
51258,258,99,115,4,40,218
51259,48,18,16,1,13,35
51260,63,32,10,9,12,51
51261,86,17,46,9,14,72
51262,8,3,2,0,3,5
51263,33,8,17,4,4,29
51264,60,39,10,1,10,50
51265,67,34,16,3,14,53
51266,48,28,12,0,8,40
51267,24,6,14,0,4,20
51268,12,1,7,0,4,8
51269,50,2,36,0,12,38
51270,237,125,71,0,41,196
51271,60,11,31,6,12,48
51272,110,35,36,15,24,86
51273,247,96,97,5,49,198
51274,197,153,8,0,36,161
51275,31,13,11,0,7,24
51276,59,36,11,0,12,47
51277,280,96,126,15,43,237
51278,32,21,9,0,2,30
51279,18,9,8,0,1,17
51280,10,4,3,0,3,7
51281,146,64,54,1,27,119
51282,127,74,22,3,28,99
51283,537,318,115,13,91,446
51284,107,25,52,4,26,81
51285,72,29,25,6,12,60
51286,15,5,7,0,3,12
51287,29,14,9,0,6,23
51288,10,4,3,0,3,7
51289,3,2,0,0,1,2
51290,21,3,13,1,4,17
51291,447,237,115,18,77,370
51292,67,28,15,10,14,53
51293,14,7,1,3,3,11
51294,49,21,16,3,9,40
51295,92,41,20,8,23,69
51296,12,4,5,0,3,9
51297,48,22,14,4,8,40
51298,35,22,8,1,4,31
51299,8,1,5,0,2,6
51300,173,53,84,3,33,140
51301,46,18,20,0,8,38
51302,28,1,17,0,10,18
51303,58,40,7,0,11,47
51304,136,72,26,10,28,108
51305,21,14,5,0,2,19
51306,35,9,11,9,6,29
51307,66,50,11,0,5,61
51308,84,27,25,11,21,63
51309,46,18,20,0,8,38
51310,48,31,1,4,12,36
51311,90,29,19,22,20,70
51312,5,1,2,0,2,3
51313,74,17,42,0,15,59
51314,59,32,14,4,9,50
51315,131,40,34,22,35,96
51316,5,0,3,0,2,3
51317,7,2,2,0,3,4
51318,17,7,6,0,4,13
51319,30,13,8,1,8,22
51320,165,97,38,1,29,136
51321,82,38,5,16,23,59
51322,38,18,9,1,10,28
51323,26,17,2,0,7,19
51324,56,27,18,1,10,46
51325,583,423,40,1,119,464
51326,93,72,8,0,13,80
51327,220,73,83,15,49,171
51328,209,69,82,15,43,166
51329,32,21,9,0,2,30
51330,44,9,24,5,6,38
51331,60,36,15,0,9,51
51332,32,21,9,0,2,30
51333,40,21,13,0,6,34
51334,217,62,107,1,47,170
51335,418,103,182,44,89,329
51336,74,27,20,12,15,59
51337,25,16,3,1,5,20
51338,83,57,11,0,15,68
51339,42,8,19,0,15,27
51340,104,44,18,15,27,77
51341,39,14,20,1,4,35
51342,55,15,18,9,13,42
51343,597,412,54,1,130,467
51344,216,118,32,22,44,172
51345,47,31,9,1,6,41
51346,394,96,163,44,91,303
51347,122,52,43,3,24,98
51348,68,30,20,2,16,52
51349,86,51,11,11,13,73
51350,82,44,22,4,12,70
51351,34,24,3,0,7,27
51352,4,2,2,0,0,4
51353,10,3,3,0,4,6
51354,20,6,8,1,5,15
51355,148,98,26,6,18,130
51356,149,43,48,24,34,115
51357,64,24,21,6,13,51
51358,38,17,13,1,7,31
51359,58,15,25,7,11,47
51360,10,5,3,0,2,8
51361,48,34,4,0,10,38
51362,43,22,13,0,8,35
51363,354,189,91,15,59,295
51364,104,68,15,3,18,86
51365,80,21,43,2,14,66
51366,118,99,2,0,17,101
51367,63,15,27,7,14,49
51368,94,75,2,3,14,80
51369,6,3,1,0,2,4
51370,110,76,12,2,20,90
51371,46,18,20,0,8,38
51372,78,30,30,0,18,60
51373,69,35,24,0,10,59
51374,99,35,39,11,14,85
51375,32,21,9,0,2,30
51376,22,14,3,2,3,19
51377,61,32,16,1,12,49
51378,49,22,20,0,7,42
51379,29,15,7,3,4,25
51380,56,31,8,0,17,39
51381,60,30,17,0,13,47
51382,10,7,0,0,3,7
51383,96,48,19,4,25,71
51384,198,64,60,27,47,151
51385,75,46,17,0,12,63
51386,223,115,62,0,46,177
51387,435,138,158,48,91,344
51388,8,5,2,0,1,7
51389,71,19,40,1,11,60
51390,166,110,25,1,30,136
51391,26,6,10,2,8,18
51392,37,22,4,1,10,27
51393,35,24,4,0,7,28
51394,58,6,40,0,12,46
51395,36,12,16,0,8,28
51396,15,4,9,0,2,13
51397,7,4,1,0,2,5
51398,50,34,7,0,9,41
51399,76,40,25,3,8,68
51400,40,8,24,0,8,32
51401,38,21,15,0,2,36
51402,52,32,6,1,13,39
51403,2,0,1,0,1,1
51404,190,138,18,0,34,156
51405,35,19,4,3,9,26
51406,38,2,22,0,14,24
51407,34,4,19,0,11,23
51408,24,14,5,0,5,19
51409,36,23,5,7,1,35
51410,237,89,21,82,45,192
51411,74,40,15,8,11,63
51412,269,110,57,38,64,205
51413,3,1,0,0,2,1
51414,58,38,3,6,11,47
51415,87,18,39,13,17,70
51416,82,40,16,4,22,60
51417,99,60,24,12,3,96
51418,98,34,25,15,24,74
51419,123,46,31,19,27,96
51420,21,6,9,0,6,15
51421,38,21,8,0,9,29
51422,76,38,20,9,9,67
51423,33,4,24,1,4,29
51424,69,54,1,0,14,55
51425,38,6,24,0,8,30
51426,20,15,0,0,5,15
51427,111,59,31,0,21,90
51428,20,4,11,2,3,17
51429,15,6,5,0,4,11
51430,32,13,5,4,10,22
51431,28,11,7,0,10,18
51432,525,251,122,37,115,410
51433,20,9,8,0,3,17
51434,43,16,11,8,8,35
51435,41,15,13,5,8,33
51436,41,22,10,1,8,33
51437,92,53,20,0,19,73
51438,9,1,6,0,2,7
51439,259,57,66,83,53,206
51440,73,19,25,17,12,61
51441,93,54,21,1,17,76
51442,32,21,9,0,2,30
51443,46,18,20,0,8,38
51444,82,20,44,6,12,70
51445,199,82,31,40,46,153
51446,39,25,6,1,7,32
51447,105,26,42,14,23,82
51448,80,29,29,5,17,63
51449,203,104,33,33,33,170
51450,116,56,28,8,24,92
51451,32,21,9,0,2,30
51452,193,130,19,0,44,149
51453,22,16,1,5,0,22
51454,132,42,51,16,23,109
51455,21,11,5,0,5,16
51456,85,23,37,9,16,69
51457,70,46,8,2,14,56
51458,22,8,13,0,1,21
51459,126,58,30,10,28,98
51460,44,22,16,1,5,39
51461,126,74,21,3,28,98
51462,46,17,18,3,8,38
51463,284,95,127,16,46,238
51464,50,15,18,4,13,37
51465,6,5,1,0,0,6
51466,42,10,24,1,7,35
51467,92,52,24,12,4,88
51468,4,0,3,0,1,3
51469,22,15,3,1,3,19
51470,205,112,31,22,40,165
51471,68,42,14,0,12,56
51472,69,27,25,4,13,56
51473,9,4,2,0,3,6
51474,25,4,1,16,4,21
51475,36,17,11,0,8,28
51476,167,71,55,3,38,129
51477,46,18,20,0,8,38
51478,32,21,9,0,2,30
51479,46,25,2,11,8,38
51480,59,30,19,0,10,49
51481,584,324,144,19,97,487
51482,65,1,56,0,8,57
51483,6,2,4,0,0,6
51484,36,18,10,3,5,31
51485,380,106,179,7,88,292
51486,71,38,11,4,18,53
51487,22,14,3,0,5,17
51488,283,178,42,0,63,220
51489,3,0,3,0,0,3
51490,162,68,34,20,40,122
51491,30,10,14,0,6,24
51492,39,22,10,0,7,32
51493,54,26,9,4,15,39
51494,36,9,23,0,4,32
51495,25,9,11,0,5,20
51496,60,42,7,0,11,49
51497,42,17,18,0,7,35
51498,146,56,31,27,32,114
51499,65,32,20,3,10,55
51500,73,63,2,0,8,65
51501,18,12,5,1,0,18
51502,171,73,52,6,40,131
51503,337,138,123,6,70,267
51504,146,60,56,7,23,123
51505,281,128,102,5,46,235
51506,488,263,123,20,82,406
51507,38,7,24,1,6,32
51508,118,58,21,16,23,95
51509,200,139,19,0,42,158
51510,214,57,54,62,41,173
51511,174,84,24,25,41,133
51512,411,231,96,0,84,327
51513,113,58,27,6,22,91
51514,198,55,48,57,38,160
51515,71,42,12,3,14,57
51516,640,384,124,20,112,528
51517,138,93,17,2,26,112
51518,178,101,32,0,45,133
51519,30,12,13,0,5,25
51520,211,46,32,96,37,174
51521,138,80,13,18,27,111
51522,59,7,42,5,5,54
51523,32,21,9,0,2,30
51524,243,105,62,27,49,194
51525,49,16,19,3,11,38
51526,109,25,42,20,22,87
51527,111,45,40,3,23,88
51528,237,51,57,85,44,193
51529,32,21,9,0,2,30
51530,32,10,2,15,5,27
51531,58,26,21,1,10,48
51532,20,3,11,0,6,14
51533,246,110,76,17,43,203
51534,27,10,11,2,4,23
51535,26,14,9,0,3,23
51536,30,14,7,4,5,25
51537,654,383,141,17,113,541
51538,127,28,59,18,22,105
51539,50,30,1,3,16,34
51540,29,9,12,2,6,23
51541,40,25,7,2,6,34
51542,15,4,7,0,4,11
51543,89,43,31,0,15,74
51544,123,95,6,0,22,101
51545,385,223,81,0,81,304
51546,89,59,8,0,22,67
51547,209,128,30,3,48,161
51548,24,7,10,0,7,17
51549,56,16,16,8,16,40
51550,65,53,0,1,11,54
51551,8,2,2,0,4,4
51552,48,31,7,0,10,38
51553,393,120,162,31,80,313
51554,88,23,47,2,16,72
51555,3,2,1,0,0,3
51556,52,26,17,0,9,43
51557,22,8,6,1,7,15
51558,6,2,1,0,3,3
51559,20,7,4,1,8,12
51560,104,57,32,4,11,93
51561,54,15,31,0,8,46
51562,160,71,52,7,30,130
51563,36,15,11,3,7,29
51564,28,14,4,2,8,20
51565,216,145,30,0,41,175
51566,32,21,9,0,2,30
51567,28,7,10,5,6,22
51568,39,24,7,0,8,31
51569,82,44,16,4,18,64
51570,123,76,25,1,21,102
51571,32,21,9,0,2,30
51572,30,5,13,1,11,19
51573,123,39,37,15,32,91
51574,159,108,26,0,25,134
51575,80,22,39,11,8,72
51576,5,4,0,0,1,4
51577,22,16,5,0,1,21
51578,69,30,27,1,11,58
51579,60,42,7,0,11,49
51580,35,22,6,0,7,28
51581,44,8,16,8,12,32
51582,37,12,19,0,6,31
51583,102,25,45,17,15,87
51584,85,23,36,9,17,68
51585,38,20,12,0,6,32
51586,13,6,4,0,3,10
51587,37,22,6,1,8,29
51588,134,104,11,0,19,115
51589,64,35,3,14,12,52
51590,43,30,2,0,11,32
51591,109,44,47,3,15,94
51592,76,18,43,0,15,61
51593,95,28,35,9,23,72
51594,100,46,15,24,15,85
51595,178,122,40,2,14,164
51596,19,11,5,0,3,16
51597,279,114,107,9,49,230
51598,79,23,25,15,16,63
51599,39,7,13,8,11,28
51600,98,42,34,4,18,80
51601,272,131,88,4,49,223
51602,96,52,27,1,16,80
51603,72,21,34,3,14,58
51604,15,4,10,0,1,14
51605,49,25,11,2,11,38
51606,56,35,7,3,11,45
51607,8,1,7,0,0,8
51608,51,16,20,1,14,37
51609,58,19,13,12,14,44
51610,19,6,1,7,5,14
51611,88,56,14,0,18,70
51612,26,8,10,0,8,18
51613,337,202,65,0,70,267
51614,14,8,3,0,3,11
51615,52,24,19,1,8,44
51616,274,74,112,20,68,206
51617,101,31,29,22,19,82
51618,199,109,57,0,33,166
51619,34,6,7,10,11,23
51620,36,23,7,0,6,30
51621,61,23,28,0,10,51
51622,55,34,14,5,2,53
51623,89,59,10,0,20,69
51624,37,16,8,5,8,29
51625,30,17,6,0,7,23
51626,50,20,19,1,10,40
51627,15,4,6,0,5,10
51628,18,14,1,0,3,15
51629,79,54,10,0,15,64
51630,103,47,24,6,26,77
51631,160,110,36,2,12,148
51632,126,74,21,3,28,98
51633,27,10,11,0,6,21
51634,79,31,21,17,10,69
51635,29,6,13,3,7,22
51636,48,19,23,0,6,42
51637,68,29,29,0,10,58
51638,173,101,26,9,37,136
51639,110,53,36,0,21,89
51640,156,75,48,1,32,124
51641,65,44,9,2,10,55
51642,42,28,9,0,5,37
51643,94,42,32,4,16,78
51644,46,18,20,0,8,38
51645,90,27,35,3,25,65
51646,17,6,10,0,1,16
51647,86,78,0,8,0,86
51648,183,82,58,13,30,153
51649,127,73,27,0,27,100
51650,83,41,26,1,15,68
51651,107,22,51,15,19,88
51652,305,166,69,0,70,235
51653,56,26,7,10,13,43
51654,92,30,45,1,16,76
51655,77,35,29,0,13,64
51656,218,48,114,3,53,165
51657,83,46,21,4,12,71
51658,72,34,29,0,9,63
51659,73,63,2,0,8,65
51660,164,71,49,5,39,125
51661,60,14,29,2,15,45
51662,34,13,12,0,9,25
51663,181,107,37,8,29,152
51664,7,4,2,0,1,6
51665,72,43,13,3,13,59
51666,80,34,21,11,14,66
51667,52,18,18,6,10,42
51668,64,24,11,8,21,43
51669,44,18,10,5,11,33
51670,552,393,43,1,115,437
51671,431,241,101,0,89,342
51672,17,5,5,0,7,10
51673,39,13,14,2,10,29
51674,12,2,7,1,2,10
51675,90,20,43,16,11,79
51676,71,31,27,0,13,58
51677,54,21,22,0,11,43
51678,346,188,88,15,55,291
51679,50,29,13,0,8,42
51680,54,12,35,0,7,47
51681,14,9,3,2,0,14
51682,36,7,22,0,7,29
51683,68,45,13,0,10,58
51684,12,4,5,0,3,9
51685,51,15,24,2,10,41
51686,218,155,25,1,37,181
51687,103,58,19,4,22,81
51688,37,11,20,0,6,31
51689,393,213,63,34,83,310
51690,111,8,56,24,23,88
51691,174,79,56,3,36,138
51692,169,82,51,3,33,136
51693,122,48,30,15,29,93
51694,73,22,32,2,17,56
51695,4,1,3,0,0,4
51696,319,157,100,5,57,262
51697,12,7,2,0,3,9
51698,102,53,25,4,20,82
51699,36,9,20,0,7,29
51700,62,32,22,2,6,56
51701,132,27,69,1,35,97
51702,138,100,9,0,29,109
51703,10,3,4,2,1,9
51704,19,15,2,0,2,17
51705,32,14,10,0,8,24
51706,6,3,3,0,0,6
51707,148,59,31,28,30,118
51708,58,31,9,2,16,42
51709,25,5,15,0,5,20
51710,188,50,30,74,34,154
51711,100,46,15,24,15,85
51712,92,50,19,1,22,70
51713,15,11,3,0,1,14
51714,217,149,47,3,18,199
51715,16,2,13,0,1,15
51716,77,46,20,0,11,66
51717,67,34,10,7,16,51
51718,4,1,3,0,0,4
51719,35,8,15,4,8,27
51720,15,5,10,0,0,15
51721,222,85,89,4,44,178
51722,36,12,14,0,10,26
51723,68,34,20,0,14,54
51724,17,6,8,1,2,15
51725,11,6,2,0,3,8
51726,12,7,2,0,3,9
51727,105,37,25,20,23,82
51728,88,15,47,4,22,66
51729,21,11,2,5,3,18
51730,33,11,11,1,10,23
51731,96,49,31,2,14,82
51732,55,16,26,0,13,42
51733,105,29,58,0,18,87
51734,24,9,3,8,4,20
51735,23,10,6,3,4,19
51736,42,17,16,0,9,33
51737,35,4,26,0,5,30
51738,25,12,10,0,3,22
51739,628,352,155,19,102,526
51740,21,15,3,1,2,19
51741,104,38,27,12,27,77
51742,298,143,75,20,60,238
51743,418,119,162,47,90,328
51744,41,21,11,0,9,32
51745,23,15,3,0,5,18
51746,56,20,19,4,13,43
51747,75,40,22,0,13,62
51748,24,6,11,1,6,18
51749,31,12,11,0,8,23
51750,377,233,49,23,72,305
51751,6,0,5,0,1,5
51752,25,10,11,0,4,21
51753,360,271,20,0,69,291
51754,203,114,46,10,33,170
51755,145,36,77,1,31,114
51756,224,150,33,0,41,183
51757,56,5,35,6,10,46
51758,40,7,21,0,12,28
51759,51,22,15,2,12,39
51760,73,29,25,3,16,57
51761,21,2,14,0,5,16
51762,504,300,103,9,92,412
51763,51,27,12,0,12,39
51764,23,10,7,0,6,17
51765,140,63,41,0,36,104
51766,36,9,14,1,12,24
51767,170,123,21,0,26,144
51768,7,2,3,1,1,6
51769,9,0,6,1,2,7
51770,12,1,9,0,2,10
51771,206,97,58,13,38,168
51772,193,88,47,20,38,155
51773,6,4,1,0,1,5
51774,66,15,35,7,9,57
51775,29,13,13,0,3,26
51776,46,18,20,0,8,38
51777,102,66,15,3,18,84
51778,52,9,30,7,6,46
51779,339,150,101,22,66,273
51780,43,15,21,1,6,37
51781,12,9,0,0,3,9
51782,20,9,6,3,2,18
51783,90,46,17,10,17,73
51784,45,6,24,3,12,33
51785,148,28,91,1,28,120
51786,65,15,34,7,9,56
51787,90,56,19,0,15,75
51788,11,8,0,0,3,8
51789,157,67,42,21,27,130
51790,61,23,28,1,9,52
51791,424,200,137,11,76,348
51792,49,15,17,9,8,41
51793,40,27,4,0,9,31
51794,30,5,21,2,2,28
51795,15,3,7,3,2,13
51796,205,77,89,3,36,169
51797,124,62,39,0,23,101
51798,42,26,1,9,6,36
51799,48,26,15,0,7,41
51800,148,53,37,28,30,118
51801,67,22,26,4,15,52
51802,42,16,10,9,7,35
51803,125,88,15,0,22,103
51804,87,51,11,0,25,62
51805,264,81,123,17,43,221
51806,37,21,7,0,9,28
51807,56,19,23,3,11,45
51808,123,37,55,7,24,99
51809,71,34,12,7,18,53
51810,15,2,7,0,6,9
51811,19,3,11,1,4,15
51812,8,1,6,0,1,7
51813,28,2,11,8,7,21
51814,13,13,0,0,0,13
51815,13,9,3,0,1,12
51816,15,1,2,10,2,13
51817,27,6,15,2,4,23
51818,228,97,45,29,57,171
51819,21,7,10,3,1,20
51820,72,26,20,6,20,52
51821,55,21,16,1,17,38
51822,98,42,34,4,18,80
51823,92,41,31,4,16,76
51824,120,58,37,4,21,99
51825,110,33,55,1,21,89
51826,298,83,37,131,47,251
51827,612,398,72,6,136,476
51828,169,81,25,23,40,129
51829,164,55,73,0,36,128
51830,21,9,8,1,3,18
51831,75,9,42,5,19,56
51832,76,51,7,0,18,58
51833,59,7,39,1,12,47
51834,25,8,13,1,3,22
51835,379,219,83,15,62,317
51836,174,66,44,30,34,140
51837,18,12,2,0,4,14
51838,50,30,10,0,10,40
51839,25,6,14,0,5,20
51840,54,14,28,2,10,44
51841,63,34,13,1,15,48
51842,152,67,28,20,37,115
51843,29,16,6,0,7,22
51844,146,112,4,2,28,118
51845,38,5,25,0,8,30
51846,74,57,2,0,15,59
51847,114,47,28,16,23,91
51848,100,35,40,10,15,85
51849,83,12,37,15,19,64
51850,127,58,37,0,32,95
51851,88,46,24,0,18,70
51852,83,57,5,7,14,69
51853,55,18,26,0,11,44
51854,11,9,0,0,2,9
51855,143,105,9,0,29,114
51856,38,13,17,1,7,31
51857,162,68,34,21,39,123
51858,73,56,2,0,15,58
51859,21,4,10,0,7,14
51860,76,35,22,2,17,59
51861,74,30,8,17,19,55
51862,8,3,3,0,2,6
51863,63,37,9,4,13,50
51864,127,96,2,1,28,99
51865,66,38,11,1,16,50
51866,142,97,17,2,26,116
51867,21,10,5,0,6,15
51868,97,49,23,5,20,77
51869,23,20,1,0,2,21
51870,486,356,30,0,100,386
51871,5,3,0,1,1,4
51872,59,17,16,9,17,42
51873,97,51,28,1,17,80
51874,22,8,7,2,5,17
51875,14,9,1,0,4,10
51876,109,58,25,4,22,87
51877,31,11,6,7,7,24
51878,110,33,56,0,21,89
51879,246,102,15,82,47,199
51880,5,4,1,0,0,5
51881,19,9,6,0,4,15
51882,23,8,11,0,4,19
51883,36,14,11,2,9,27
51884,66,24,23,3,16,50
51885,25,15,5,0,5,20
51886,48,24,14,0,10,38
51887,8,1,5,0,2,6
51888,82,24,26,9,23,59
51889,110,52,37,0,21,89
51890,14,7,5,0,2,12
51891,54,0,38,0,16,38
51892,57,40,11,5,1,56
51893,9,2,5,1,1,8
51894,57,20,25,0,12,45
51895,81,49,15,1,16,65
51896,14,9,4,0,1,13
51897,24,9,7,2,6,18
51898,22,2,14,0,6,16
51899,74,40,19,0,15,59
51900,64,32,14,4,14,50
51901,377,208,107,0,62,315
51902,46,7,22,9,8,38
51903,233,156,31,0,46,187
51904,303,124,122,3,54,249
51905,169,72,56,0,41,128
51906,9,4,1,1,3,6
51907,15,5,8,0,2,13
51908,57,24,24,0,9,48
51909,16,7,8,0,1,15
51910,32,6,14,4,8,24
51911,46,18,20,0,8,38
51912,202,79,11,74,38,164
51913,57,14,5,28,10,47
51914,88,44,25,2,17,71
51915,9,3,6,0,0,9
51916,138,51,39,21,27,111
51917,58,28,17,0,13,45
51918,70,41,14,0,15,55
51919,15,6,3,3,3,12
51920,166,132,5,3,26,140
51921,41,13,17,2,9,32
51922,46,18,20,0,8,38
51923,36,25,3,2,6,30
51924,74,31,15,9,19,55
51925,14,3,2,6,3,11
51926,97,44,23,3,27,70
51927,5,3,0,2,0,5
51928,85,21,25,26,13,72
51929,61,19,17,16,9,52
51930,50,29,13,0,8,42
51931,25,11,10,0,4,21
51932,194,12,144,0,38,156
51933,40,22,12,0,6,34
51934,74,30,8,17,19,55
51935,78,39,19,2,18,60
51936,12,3,2,2,5,7
51937,87,47,18,6,16,71
51938,167,31,103,1,32,135
51939,7,0,5,2,0,7
51940,101,27,48,8,18,83
51941,62,43,8,4,7,55
51942,129,38,50,20,21,108
51943,23,12,6,1,4,19
51944,54,37,8,1,8,46
51945,110,62,14,10,24,86
51946,70,36,12,5,17,53
51947,89,32,19,8,30,59
51948,105,67,9,13,16,89
51949,54,34,7,0,13,41
51950,63,38,16,3,6,57
51951,39,30,1,0,8,31
51952,29,16,9,0,4,25
51953,28,5,5,10,8,20
51954,159,10,91,26,32,127
51955,56,18,26,3,9,47
51956,462,225,91,45,101,361
51957,51,25,10,7,9,42
51958,79,25,42,1,11,68
51959,95,25,54,2,14,81
51960,8,3,5,0,0,8
51961,25,14,5,1,5,20
51962,58,41,11,4,2,56
51963,5,1,3,0,1,4
51964,27,4,20,0,3,24
51965,12,9,1,0,2,10
51966,52,31,13,0,8,44
51967,245,102,15,82,46,199
51968,46,18,20,0,8,38
51969,60,30,11,2,17,43
51970,501,268,84,47,102,399
51971,127,53,26,25,23,104
51972,7,2,3,1,1,6
51973,227,125,65,0,37,190
51974,145,109,4,2,30,115
51975,138,50,56,14,18,120
51976,160,114,11,0,35,125
51977,80,37,5,15,23,57
51978,63,6,40,0,17,46
51979,151,24,98,1,28,123
51980,38,15,13,1,9,29
51981,74,19,36,11,8,66
51982,56,25,17,5,9,47
51983,2,0,2,0,0,2
51984,431,124,165,46,96,335
51985,32,21,9,0,2,30
51986,354,180,100,1,73,281
51987,103,21,49,14,19,84
51988,43,15,14,3,11,32
51989,125,42,45,6,32,93
51990,44,12,25,0,7,37
51991,53,23,19,1,10,43
51992,150,111,5,2,32,118
51993,123,57,31,10,25,98
51994,24,5,13,2,4,20
51995,176,116,24,4,32,144
51996,46,18,20,0,8,38
51997,58,12,30,0,16,42
51998,40,3,29,2,6,34
51999,71,44,16,0,11,60
52000,68,34,17,4,13,55
52001,36,9,13,5,9,27
52002,31,6,24,0,1,30
52003,113,40,38,7,28,85
52004,10,4,4,0,2,8
52005,57,15,26,0,16,41
52006,78,36,5,15,22,56
52007,26,10,6,1,9,17
52008,316,189,58,0,69,247
52009,66,38,15,0,13,53
52010,63,38,14,1,10,53
52011,473,255,78,40,100,373
52012,77,36,22,0,19,58
52013,71,21,29,4,17,54
52014,67,46,6,0,15,52
52015,22,1,16,0,5,17
52016,18,1,10,5,2,16
52017,56,25,14,2,15,41
52018,31,13,9,1,8,23
52019,57,16,32,1,8,49
52020,45,18,17,0,10,35
52021,12,3,5,0,4,8
52022,54,21,24,1,8,46
52023,16,3,7,3,3,13
52024,15,4,9,0,2,13
52025,114,64,17,11,22,92
52026,43,7,24,6,6,37
52027,32,21,9,0,2,30
52028,18,5,5,4,4,14
52029,115,25,50,14,26,89
52030,49,10,26,5,8,41
52031,7,1,5,1,0,7
52032,442,112,183,45,102,340
52033,375,170,128,5,72,303
52034,73,20,27,1,25,48
52035,28,11,9,2,6,22
52036,106,58,9,19,20,86
52037,58,29,18,1,10,48
52038,413,182,123,26,82,331
52039,106,61,18,5,22,84
52040,28,2,12,7,7,21
52041,166,83,32,19,32,134
52042,94,39,30,11,14,80
52043,29,1,24,0,4,25
52044,261,131,79,0,51,210
52045,46,39,0,1,6,40
52046,202,52,26,94,30,172
52047,32,21,2,0,9,23
52048,81,34,36,1,10,71
52049,611,408,67,4,132,479
52050,39,24,7,0,8,31
52051,61,15,29,2,15,46
52052,39,11,18,0,10,29
52053,60,11,39,0,10,50
52054,27,5,9,4,9,18
52055,32,11,13,0,8,24
52056,90,56,19,0,15,75
52057,24,11,7,0,6,18
52058,28,10,15,1,2,26
52059,86,31,38,4,13,73
52060,17,6,7,0,4,13
52061,132,102,9,0,21,111
52062,120,66,12,14,28,92
52063,85,53,13,3,16,69
52064,88,35,41,1,11,77
52065,75,35,27,1,12,63
52066,14,4,5,2,3,11
52067,21,7,10,0,4,17
52068,94,49,13,17,15,79
52069,134,71,33,5,25,109
52070,448,238,108,14,88,360
52071,70,40,17,0,13,57
52072,15,9,0,6,0,15
52073,38,18,15,0,5,33
52074,530,235,131,45,119,411
52075,59,31,16,0,12,47
52076,46,18,20,0,8,38
52077,29,10,15,0,4,25
52078,187,113,55,4,15,172
52079,164,114,13,0,37,127
52080,73,28,9,16,20,53
52081,623,347,155,21,100,523
52082,117,42,30,14,31,86
52083,88,27,37,2,22,66
52084,138,59,40,14,25,113
52085,340,141,126,6,67,273
52086,75,9,42,5,19,56
52087,57,28,14,0,15,42
52088,190,91,34,32,33,157
52089,58,14,35,0,9,49
52090,34,16,12,0,6,28
52091,31,17,4,0,10,21
52092,77,42,18,3,14,63
52093,60,19,21,11,9,51
52094,38,9,22,1,6,32
52095,143,75,40,5,23,120
52096,166,97,39,1,29,137
52097,80,38,30,1,11,69
52098,318,152,91,14,61,257
52099,41,21,15,0,5,36
52100,29,5,14,4,6,23
52101,106,72,11,0,23,83
52102,31,10,8,2,11,20
52103,80,36,23,3,18,62
52104,50,9,26,5,10,40
52105,30,15,7,0,8,22
52106,12,2,8,0,2,10
52107,25,7,9,1,8,17
52108,439,242,65,38,94,345
52109,16,8,4,1,3,13
52110,74,50,11,4,9,65
52111,110,34,35,14,27,83
52112,104,54,30,0,20,84
52113,15,3,7,2,3,12
52114,38,25,5,1,7,31
52115,38,14,10,3,11,27
52116,116,36,65,0,15,101
52117,180,107,15,18,40,140
52118,37,9,9,7,12,25
52119,14,7,2,0,5,9
52120,19,3,11,1,4,15
52121,41,16,5,10,10,31
52122,27,13,8,0,6,21
52123,30,13,13,0,4,26
52124,53,10,19,12,12,41
52125,460,127,189,37,107,353
52126,73,36,20,6,11,62
52127,22,5,13,0,4,18
52128,43,20,7,0,16,27
52129,255,194,15,0,46,209
52130,169,113,22,4,30,139
52131,10,3,4,0,3,7
52132,70,29,20,3,18,52
52133,66,33,16,0,17,49
52134,53,26,17,1,9,44
52135,79,51,9,4,15,64
52136,9,4,3,0,2,7
52137,46,13,24,0,9,37
52138,64,19,32,1,12,52
52139,14,4,4,3,3,11
52140,113,9,56,24,24,89
52141,77,10,44,4,19,58
52142,12,1,9,0,2,10
52143,185,133,14,2,36,149
52144,31,15,7,1,8,23
52145,54,5,34,1,14,40
52146,51,30,7,0,14,37
52147,153,59,38,22,34,119
52148,142,109,9,1,23,119
52149,10,3,7,0,0,10
52150,97,32,25,21,19,78
52151,108,44,37,5,22,86
52152,12,9,2,0,1,11
52153,86,61,6,0,19,67
52154,140,66,42,10,22,118
52155,24,4,10,5,5,19
52156,46,18,20,0,8,38
52157,28,10,11,0,7,21
52158,26,19,3,0,4,22
52159,39,20,8,2,9,30
52160,63,22,26,1,14,49
52161,56,20,15,6,15,41
52162,39,22,7,2,8,31
52163,56,34,12,0,10,46
52164,159,108,26,0,25,134
52165,33,19,8,0,6,27
52166,86,33,34,4,15,71
52167,66,33,21,0,12,54
52168,218,157,14,0,47,171
52169,144,80,32,0,32,112
52170,43,7,24,6,6,37
52171,43,6,30,0,7,36
52172,16,11,3,0,2,14
52173,97,71,9,1,16,81
52174,108,41,44,6,17,91
52175,31,22,3,0,6,25
52176,38,23,9,0,6,32
52177,57,31,3,10,13,44
52178,140,84,30,0,26,114
52179,116,46,28,16,26,90
52180,78,11,51,0,16,62
52181,60,17,26,2,15,45
52182,46,18,20,0,8,38
52183,92,58,18,4,12,80
52184,62,34,10,5,13,49
52185,222,75,83,15,49,173
52186,29,20,5,4,0,29
52187,28,11,8,0,9,19
52188,64,18,3,30,13,51
52189,120,69,20,6,25,95
52190,269,179,21,3,66,203
52191,8,1,4,1,2,6
52192,155,64,52,16,23,132
52193,41,7,17,6,11,30
52194,158,109,18,0,31,127
52195,84,28,42,0,14,70
52196,46,34,0,0,12,34
52197,237,97,14,82,44,193
52198,61,27,13,10,11,50
52199,137,49,55,0,33,104
52200,171,130,16,1,24,147
52201,32,12,6,7,7,25
52202,80,38,26,0,16,64
52203,22,9,8,0,5,17
52204,78,22,36,5,15,63
52205,295,79,32,135,49,246
52206,89,53,18,4,14,75
52207,29,10,10,0,9,20
52208,28,5,14,5,4,24
52209,75,23,25,6,21,54
52210,149,86,24,10,29,120
52211,6,3,0,2,1,5
52212,82,40,23,5,14,68
52213,89,66,9,1,13,76
52214,15,11,1,0,3,12
52215,165,97,38,1,29,136
52216,26,16,5,1,4,22
52217,20,4,14,0,2,18
52218,83,47,18,4,14,69
52219,46,13,16,11,6,40
52220,54,11,21,8,14,40
52221,15,7,2,4,2,13
52222,441,324,20,0,97,344
52223,268,62,139,7,60,208
52224,40,4,26,2,8,32
52225,49,30,9,0,10,39
52226,428,205,113,20,90,338
52227,50,0,40,0,10,40
52228,49,28,15,1,5,44
52229,185,71,60,7,47,138
52230,86,25,30,11,20,66
52231,111,38,43,11,19,92
52232,197,80,50,22,45,152
52233,17,6,8,0,3,14
52234,12,8,4,0,0,12
52235,156,56,38,29,33,123
52236,19,9,6,3,1,18
52237,44,13,13,7,11,33
52238,161,92,29,1,39,122
52239,140,76,41,12,11,129
52240,25,16,5,0,4,21
52241,70,48,9,0,13,57
52242,82,50,17,2,13,69
52243,23,11,6,0,6,17
52244,93,46,15,2,30,63
52245,73,38,12,7,16,57
52246,136,53,46,14,23,113
52247,46,18,20,0,8,38
52248,63,22,34,0,7,56
52249,81,30,18,12,21,60
52250,11,3,3,0,5,6
52251,123,83,18,0,22,101
52252,22,14,2,3,3,19
52253,45,16,15,1,13,32
52254,72,39,10,10,13,59
52255,27,1,17,0,9,18
52256,32,21,9,0,2,30
52257,110,48,30,5,27,83
52258,35,2,25,0,8,27
52259,55,30,16,0,9,46
52260,202,89,55,20,38,164
52261,13,6,7,0,0,13
52262,420,190,109,34,87,333
52263,145,36,77,1,31,114
52264,97,40,41,0,16,81
52265,463,245,103,13,102,361
52266,36,10,21,0,5,31
52267,20,5,9,1,5,15
52268,76,39,28,1,8,68
52269,90,33,36,4,17,73
52270,452,258,103,0,91,361
52271,77,42,18,3,14,63
52272,513,259,95,53,106,407
52273,35,17,10,2,6,29
52274,8,2,3,0,3,5
52275,60,42,4,1,13,47
52276,44,15,20,1,8,36
52277,27,14,10,2,1,26
52278,158,100,28,0,30,128
52279,125,65,25,12,23,102
52280,27,8,13,0,6,21
52281,79,39,23,1,16,63
52282,445,143,181,21,100,345
52283,288,195,69,3,21,267
52284,347,149,124,6,68,279
52285,101,65,15,3,18,83
52286,63,36,18,0,9,54
52287,40,21,13,0,6,34
52288,125,43,57,1,24,101
52289,46,8,30,0,8,38
52290,56,0,39,0,17,39
52291,61,14,23,2,22,39
52292,91,19,31,22,19,72
52293,121,96,5,0,20,101
52294,20,7,7,2,4,16
52295,43,4,30,2,7,36
52296,198,77,37,33,51,147
52297,67,2,53,0,12,55
52298,16,4,9,2,1,15
52299,78,44,18,2,14,64
52300,35,17,13,0,5,30
52301,77,47,7,3,20,57
52302,50,14,25,0,11,39
52303,105,10,62,10,23,82
52304,65,15,35,0,15,50
52305,125,59,32,0,34,91
52306,100,54,21,1,24,76
52307,58,20,21,5,12,46
52308,28,1,23,0,4,24
52309,479,225,157,13,84,395
52310,34,12,17,2,3,31
52311,72,29,14,15,14,58
52312,28,7,15,0,6,22
52313,62,22,5,24,11,51
52314,16,5,9,1,1,15
52315,231,156,33,0,42,189
52316,77,39,18,8,12,65
52317,97,55,19,7,16,81
52318,24,9,7,3,5,19
52319,155,62,51,16,26,129
52320,129,43,49,8,29,100
52321,29,7,15,3,4,25
52322,35,16,9,0,10,25
52323,37,21,6,2,8,29
52324,35,19,13,0,3,32
52325,51,36,11,4,0,51
52326,14,10,4,0,0,14
52327,56,29,12,5,10,46
52328,675,378,162,24,111,564
52329,76,40,16,8,12,64
52330,35,10,19,0,6,29
52331,118,42,35,21,20,98
52332,10,5,5,0,0,10
52333,8,3,3,0,2,6
52334,37,20,9,1,7,30
52335,95,56,15,1,23,72
52336,19,9,9,0,1,18
52337,124,47,30,19,28,96
52338,436,211,117,20,88,348
52339,194,61,80,14,39,155
52340,15,3,6,0,6,9
52341,13,3,7,0,3,10
52342,187,104,25,23,35,152
52343,382,175,126,6,75,307
52344,19,8,9,0,2,17
52345,105,52,34,0,19,86
52346,32,21,9,0,2,30
52347,179,124,37,2,16,163
52348,27,9,12,2,4,23
52349,16,3,10,0,3,13
52350,83,39,30,4,10,73
52351,49,26,5,8,10,39
52352,25,15,3,4,3,22
52353,28,0,20,0,8,20
52354,284,142,81,5,56,228
52355,45,19,5,16,5,40
52356,49,25,6,4,14,35
52357,13,6,5,0,2,11
52358,0,0,0,0,0,0
52359,15,2,8,3,2,13
52360,51,1,39,0,11,40
52361,119,55,22,11,31,88
52362,16,6,6,0,4,12
52363,19,4,6,4,5,14
52364,86,56,14,0,16,70
52365,72,39,10,10,13,59
52366,391,182,77,48,84,307
52367,36,15,14,1,6,30
52368,94,54,23,1,16,78
52369,79,40,19,2,18,61
52370,182,104,21,23,34,148
52371,30,6,19,0,5,25
52372,0,0,0,0,0,0
52373,65,19,23,10,13,52
52374,38,18,11,3,6,32
52375,38,22,5,3,8,30
52376,34,11,14,0,9,25
52377,32,21,9,0,2,30
52378,56,41,5,0,10,46
52379,53,8,33,0,12,41
52380,14,6,3,0,5,9
52381,11,2,8,0,1,10
52382,9,3,2,0,4,5
52383,38,7,11,15,5,33
52384,32,21,9,0,2,30
52385,69,36,24,0,9,60
52386,362,188,105,4,65,297
52387,67,31,20,0,16,51
52388,249,95,55,39,60,189
52389,58,16,34,1,7,51
52390,127,57,36,8,26,101
52391,257,175,60,3,19,238
52392,41,13,19,3,6,35
52393,117,43,4,51,19,98
52394,403,102,164,46,91,312
52395,52,41,1,0,10,42
52396,350,188,92,15,55,295
52397,132,40,35,23,34,98
52398,89,46,17,8,18,71
52399,135,55,52,2,26,109
52400,34,21,1,7,5,29
52401,76,47,15,0,14,62
52402,76,41,19,0,16,60
52403,192,140,17,0,35,157
52404,90,39,18,8,25,65
52405,158,67,34,26,31,127
52406,193,128,28,5,32,161
52407,32,21,9,0,2,30
52408,91,23,42,2,24,67
52409,62,21,29,2,10,52
52410,48,24,7,8,9,39
52411,38,7,21,3,7,31
52412,42,30,4,0,8,34
52413,74,22,34,0,18,56
52414,200,117,67,2,14,186
52415,40,16,15,0,9,31
52416,1060,389,424,46,201,859
52417,31,13,13,0,5,26
52418,85,46,23,0,16,69
52419,46,18,20,0,8,38
52420,40,9,26,1,4,36
52421,110,37,43,11,19,91
52422,544,298,116,13,117,427
52423,131,67,13,23,28,103
52424,25,16,5,0,4,21
52425,50,2,39,0,9,41
52426,61,24,21,3,13,48
52427,350,180,106,5,59,291
52428,161,84,37,6,34,127
52429,32,21,9,0,2,30
52430,661,387,141,17,116,545
52431,113,64,16,9,24,89
52432,32,21,9,0,2,30
52433,73,38,3,16,16,57
52434,47,30,5,0,12,35
52435,62,13,36,3,10,52
52436,15,2,11,0,2,13
52437,398,223,59,37,79,319
52438,42,16,9,6,11,31
52439,64,41,5,0,18,46
52440,145,36,77,1,31,114
52441,110,53,38,1,18,92
52442,58,23,21,5,9,49
52443,72,30,22,3,17,55
52444,46,29,8,0,9,37
52445,1024,384,400,46,194,830
52446,182,121,18,0,43,139
52447,171,82,38,14,37,134
52448,408,230,96,0,82,326
52449,97,44,28,5,20,77
52450,108,104,0,4,0,108
52451,106,42,14,16,34,72
52452,153,51,46,21,35,118
52453,59,30,14,3,12,47
52454,18,6,9,0,3,15
52455,41,32,0,0,9,32
52456,51,34,8,0,9,42
52457,25,11,8,1,5,20
52458,46,18,20,0,8,38
52459,200,142,12,7,39,161
52460,101,56,20,7,18,83
52461,38,17,13,0,8,30
52462,20,9,6,1,4,16
52463,66,31,12,10,13,53
52464,494,349,42,1,102,392
52465,218,166,8,0,44,174
52466,176,71,37,27,41,135
52467,189,52,31,71,35,154
52468,75,40,19,0,16,59
52469,106,48,33,0,25,81
52470,504,297,112,13,82,422
52471,196,83,81,5,27,169
52472,106,93,2,0,11,95
52473,197,86,64,17,30,167
52474,227,159,51,3,14,213
52475,59,33,13,0,13,46
52476,135,100,15,0,20,115
52477,81,37,5,16,23,58
52478,168,121,5,2,40,128
52479,21,3,13,0,5,16
52480,3,2,0,0,1,2
52481,46,18,20,0,8,38
52482,30,13,10,2,5,25
52483,426,201,105,33,87,339
52484,163,109,27,0,27,136
52485,53,35,2,2,14,39
52486,482,241,90,50,101,381
52487,115,88,4,1,22,93
52488,107,83,8,0,16,91
52489,76,47,10,1,18,58
52490,227,77,87,12,51,176
52491,49,30,9,0,10,39
52492,43,2,25,12,4,39
52493,82,60,8,1,13,69
52494,34,4,20,4,6,28
52495,69,44,12,1,12,57
52496,51,22,18,3,8,43
52497,65,20,25,8,12,53
52498,89,27,35,8,19,70
52499,8,4,1,1,2,6
52500,108,46,22,20,20,88
52501,222,14,166,0,42,180
52502,5,2,2,0,1,4
52503,25,18,3,1,3,22
52504,33,22,2,0,9,24
52505,26,17,3,0,6,20
52506,53,19,14,5,15,38
52507,35,13,17,0,5,30
52508,188,53,31,69,35,153
52509,64,36,9,6,13,51
52510,14,2,11,0,1,13
52511,24,16,3,0,5,19
52512,78,41,28,1,8,70
52513,55,33,10,0,12,43
52514,147,64,53,1,29,118
52515,172,127,5,2,38,134
52516,77,52,10,3,12,65
52517,24,6,11,1,6,18
52518,22,7,11,0,4,18
52519,178,59,52,25,42,136
52520,269,120,98,5,46,223
52521,45,29,1,3,12,33
52522,156,55,37,30,34,122
52523,70,15,37,7,11,59
52524,9,2,3,0,4,5
52525,36,15,15,0,6,30
52526,124,73,20,3,28,96
52527,164,114,13,0,37,127
52528,42,13,19,3,7,35
52529,75,54,6,3,12,63
52530,8,0,6,0,2,6
52531,32,21,9,0,2,30
52532,134,91,11,5,27,107
52533,41,15,12,3,11,30
52534,52,20,17,3,12,40
52535,220,149,30,0,41,179
52536,45,2,35,0,8,37
52537,49,18,19,1,11,38
52538,15,5,8,0,2,13
52539,149,62,32,21,34,115
52540,32,21,9,0,2,30
52541,100,44,34,1,21,79
52542,27,12,11,0,4,23
52543,12,0,8,0,4,8
52544,42,18,17,0,7,35
52545,357,159,123,6,69,288
52546,76,39,13,9,15,61
52547,41,23,3,4,11,30
52548,11,2,6,2,1,10
52549,70,31,12,13,14,56
52550,162,110,26,0,26,136
52551,40,21,1,3,15,25
52552,113,46,39,3,25,88
52553,93,43,35,0,15,78
52554,93,28,42,6,17,76
52555,93,18,53,0,22,71
52556,34,9,18,3,4,30
52557,32,21,9,0,2,30
52558,360,260,19,2,79,281
52559,120,82,16,1,21,99
52560,32,21,9,0,2,30
52561,76,38,23,0,15,61
52562,28,6,16,0,6,22
52563,246,59,37,107,43,203
52564,9,3,3,0,3,6
52565,32,23,3,0,6,26
52566,112,35,32,21,24,88
52567,137,92,21,1,23,114
52568,142,85,30,0,27,115
52569,49,8,29,0,12,37
52570,143,66,28,24,25,118
52571,137,52,48,8,29,108
52572,62,30,17,0,15,47
52573,126,43,47,11,25,101
52574,39,11,11,13,4,35
52575,55,23,17,3,12,43
52576,42,7,29,0,6,36
52577,35,24,7,0,4,31
52578,29,6,14,1,8,21
52579,61,11,36,4,10,51
52580,34,25,6,3,0,34
52581,86,45,15,8,18,68
52582,169,111,25,5,28,141
52583,225,75,85,15,50,175
52584,68,40,9,8,11,57
52585,154,88,38,1,27,127
52586,48,34,2,3,9,39
52587,14,4,7,0,3,11
52588,37,1,22,0,14,23
52589,64,26,16,8,14,50
52590,177,24,92,23,38,139
52591,46,18,20,0,8,38
52592,206,84,12,72,38,168
52593,44,22,11,2,9,35
52594,1306,529,182,338,257,1049
52595,78,52,15,1,10,68
52596,120,82,19,9,10,110
52597,32,16,2,6,8,24
52598,4,3,1,0,0,4
52599,48,21,17,2,8,40
52600,35,12,10,6,7,28
52601,20,7,8,0,5,15
52602,14,6,2,0,6,8
52603,266,140,78,0,48,218
52604,220,56,31,94,39,181
52605,121,100,3,3,15,106
52606,124,96,6,0,22,102
52607,22,1,12,1,8,14
52608,106,65,25,7,9,97
52609,49,21,19,0,9,40
52610,153,81,32,7,33,120
52611,37,18,7,5,7,30
52612,94,74,1,0,19,75
52613,84,36,20,5,23,61
52614,2,0,2,0,0,2
52615,94,52,24,4,14,80
52616,51,22,13,3,13,38
52617,51,30,14,0,7,44
52618,80,26,39,2,13,67
52619,70,35,20,0,15,55
52620,38,29,1,0,8,30
52621,124,51,47,1,25,99
52622,11,1,8,0,2,9
52623,24,6,13,1,4,20
52624,41,24,5,6,6,35
52625,11,3,6,0,2,9
52626,41,15,19,0,7,34
52627,30,12,11,3,4,26
52628,55,21,18,3,13,42
52629,128,57,32,11,28,100
52630,52,21,13,1,17,35
52631,258,151,46,9,52,206
52632,69,38,16,1,14,55
52633,130,43,50,11,26,104
52634,19,5,12,0,2,17
52635,0,0,0,0,0,0
52636,372,258,41,1,72,300
52637,168,31,104,1,32,136
52638,13,6,6,0,1,12
52639,40,13,19,2,6,34
52640,46,18,20,0,8,38
52641,52,26,10,7,9,43
52642,56,2,45,0,9,47
52643,74,30,14,8,22,52
52644,27,5,17,0,5,22
52645,4,1,3,0,0,4
52646,73,45,14,0,14,59
52647,9,5,2,0,2,7
52648,42,29,8,5,0,42
52649,32,21,9,0,2,30
52650,51,27,10,2,12,39
52651,93,24,38,14,17,76
52652,17,4,6,2,5,12
52653,65,42,7,1,15,50
52654,70,36,16,0,18,52
52655,26,19,4,0,3,23
52656,25,10,11,0,4,21
52657,17,3,11,0,3,14
52658,27,14,8,0,5,22
52659,16,8,4,0,4,12
52660,156,76,48,1,31,125
52661,14,11,1,0,2,12
52662,116,41,42,7,26,90
52663,41,20,5,7,9,32
52664,81,67,1,0,13,68
52665,276,85,132,14,45,231
52666,32,14,9,0,9,23
52667,45,15,20,1,9,36
52668,98,84,3,0,11,87
52669,46,18,20,0,8,38
52670,220,150,29,0,41,179
52671,207,112,34,22,39,168
52672,244,180,13,0,51,193
52673,32,21,9,0,2,30
52674,45,23,11,1,10,35
52675,85,37,20,13,15,70
52676,132,103,9,0,20,112
52677,121,50,30,18,23,98
52678,110,50,21,18,21,89
52679,61,14,31,1,15,46
52680,37,2,28,0,7,30
52681,36,16,13,1,6,30
52682,50,25,16,4,5,45
52683,60,39,5,2,14,46
52684,73,26,28,3,16,57
52685,59,36,9,1,13,46
52686,32,21,9,0,2,30
52687,14,1,10,1,2,12
52688,280,159,31,33,57,223
52689,59,20,31,0,8,51
52690,117,47,5,45,20,97
52691,21,5,11,1,4,17
52692,38,10,17,2,9,29
52693,66,32,18,1,15,51
52694,23,9,8,0,6,17
52695,73,37,17,0,19,54
52696,76,20,25,10,21,55
52697,113,40,38,0,35,78
52698,366,218,75,14,59,307
52699,85,38,31,0,16,69
52700,23,7,12,1,3,20
52701,52,25,15,1,11,41
52702,99,36,38,10,15,84
52703,154,118,9,1,26,128
52704,76,50,8,0,18,58
52705,95,26,49,0,20,75
52706,58,35,3,10,10,48
52707,62,34,18,0,10,52
52708,38,12,18,1,7,31
52709,158,92,36,1,29,129
52710,42,28,1,2,11,31
52711,7,7,0,0,0,7
52712,141,107,3,2,29,112
52713,77,30,34,3,10,67
52714,592,408,55,1,128,464
52715,17,8,2,1,6,11
52716,157,67,34,24,32,125
52717,6,3,0,0,3,3
52718,41,1,35,0,5,36
52719,632,352,158,21,101,531
52720,44,31,5,1,7,37
52721,8,1,6,0,1,7
52722,39,27,6,0,6,33
52723,29,13,11,0,5,24
52724,44,7,28,5,4,40
52725,67,27,5,21,14,53
52726,10,7,1,0,2,8
52727,63,25,22,0,16,47
52728,51,33,9,1,8,43
52729,84,49,14,3,18,66
52730,291,69,152,4,66,225
52731,142,56,29,27,30,112
52732,38,19,9,1,9,29
52733,25,10,5,6,4,21
52734,140,57,32,18,33,107
52735,170,83,51,3,33,137
52736,52,33,8,0,11,41
52737,27,19,4,1,3,24
52738,28,15,9,0,4,24
52739,237,179,11,0,47,190
52740,145,14,98,2,31,114
52741,126,59,14,26,27,99
52742,26,13,6,0,7,19
52743,6,3,3,0,0,6
52744,42,7,25,2,8,34
52745,59,40,4,6,9,50
52746,32,21,9,0,2,30
52747,66,44,14,0,8,58
52748,103,76,12,7,8,95
52749,56,43,6,0,7,49
52750,54,15,28,2,9,45
52751,78,35,29,2,12,66
52752,28,17,4,0,7,21
52753,32,21,9,0,2,30
52754,111,51,25,14,21,90
52755,64,49,11,0,4,60
52756,63,41,13,0,9,54
52757,19,8,5,2,4,15
52758,50,12,15,11,12,38
52759,95,50,25,4,16,79
52760,38,5,24,0,9,29
52761,166,114,18,0,34,132
52762,133,54,52,2,25,108
52763,110,72,28,1,9,101
52764,67,33,15,2,17,50
52765,689,397,160,20,112,577
52766,605,342,146,20,97,508
52767,50,12,26,1,11,39
52768,45,15,15,8,7,38
52769,124,54,19,18,33,91
52770,292,135,77,21,59,233
52771,132,40,35,22,35,97
52772,11,3,5,0,3,8
52773,138,74,26,6,32,106
52774,69,35,13,5,16,53
52775,140,54,29,27,30,110
52776,67,32,27,0,8,59
52777,43,5,29,0,9,34
52778,124,42,44,8,30,94
52779,19,8,8,0,3,16
52780,6,2,3,0,1,5
52781,135,99,5,2,29,106
52782,99,20,63,0,16,83
52783,46,18,20,0,8,38
52784,233,93,14,82,44,189
52785,81,23,32,0,26,55
52786,18,5,1,5,7,11
52787,67,44,5,3,15,52
52788,43,16,13,3,11,32
52789,15,9,5,0,1,14
52790,58,35,13,3,7,51
52791,49,23,16,0,10,39
52792,206,141,24,0,41,165
52793,44,6,29,3,6,38
52794,35,15,10,0,10,25
52795,107,58,35,5,9,98
52796,5,4,1,0,0,5
52797,13,5,4,0,4,9
52798,181,129,14,2,36,145
52799,85,39,32,0,14,71
52800,75,57,9,8,1,74
52801,113,67,17,4,25,88
52802,14,1,10,2,1,13
52803,28,15,5,1,7,21
52804,73,46,16,0,11,62
52805,78,47,10,7,14,64
52806,111,39,26,25,21,90
52807,33,22,3,1,7,26
52808,8,0,8,0,0,8
52809,123,29,56,17,21,102
52810,423,195,117,21,90,333
52811,137,54,29,24,30,107
52812,665,391,140,17,117,548
52813,56,35,13,0,8,48
52814,73,36,21,0,16,57
52815,31,20,4,1,6,25
52816,467,214,156,11,86,381
52817,72,31,21,1,19,53
52818,160,111,23,0,26,134
52819,195,88,49,20,38,157
52820,225,99,57,24,45,180
52821,29,11,14,0,4,25
52822,31,18,11,0,2,29
52823,10,6,1,0,3,7
52824,14,2,3,1,8,6
52825,112,46,37,8,21,91
52826,13,1,10,0,2,11
52827,37,10,16,0,11,26
52828,82,48,17,2,15,67
52829,98,42,34,4,18,80
52830,31,17,12,0,2,29
52831,242,115,71,4,52,190
52832,63,41,13,0,9,54
52833,46,26,9,4,7,39
52834,8,0,5,0,3,5
52835,40,6,24,2,8,32
52836,72,22,27,1,22,50
52837,309,139,110,2,58,251
52838,17,10,4,0,3,14
52839,172,83,53,3,33,139
52840,81,50,15,4,12,69
52841,149,62,32,24,31,118
52842,219,76,86,13,44,175
52843,143,10,82,19,32,111
52844,78,15,56,2,5,73
52845,360,159,126,6,69,291
52846,55,33,14,0,8,47
52847,28,10,3,5,10,18
52848,29,23,4,0,2,27
52849,191,77,50,23,41,150
52850,69,57,3,0,9,60
52851,113,92,3,0,18,95
52852,52,41,3,1,7,45
52853,126,50,41,20,15,111
52854,45,14,19,2,10,35
52855,429,131,191,12,95,334
52856,91,47,12,9,23,68
52857,96,23,31,25,17,79
52858,21,10,6,0,5,16
52859,215,48,115,2,50,165
52860,4,3,1,0,0,4
52861,17,6,7,1,3,14
52862,57,30,13,3,11,46
52863,360,197,90,15,58,302
52864,111,42,39,3,27,84
52865,92,38,33,1,20,72
52866,8,5,1,1,1,7
52867,123,75,27,1,20,103
52868,28,15,8,0,5,23
52869,37,7,23,0,7,30
52870,478,228,96,49,105,373
52871,228,153,34,0,41,187
52872,46,31,4,0,11,35
52873,65,43,6,1,15,50
52874,32,21,9,0,2,30
52875,145,91,29,3,22,123
52876,191,133,40,2,16,175
52877,42,26,5,5,6,36
52878,321,239,19,2,61,260
52879,228,126,64,0,38,190
52880,87,38,17,8,24,63
52881,7,5,0,0,2,5
52882,17,10,4,0,3,14
52883,43,5,29,0,9,34
52884,104,74,12,10,8,96
52885,43,11,18,1,13,30
52886,147,57,37,22,31,116
52887,98,43,27,1,27,71
52888,71,23,27,4,17,54
52889,7,2,3,0,2,5
52890,167,105,5,19,38,129
52891,62,12,39,1,10,52
52892,76,46,7,4,19,57
52893,46,18,20,0,8,38
52894,263,18,195,0,50,213
52895,76,26,34,1,15,61
52896,16,4,6,1,5,11
52897,24,19,2,0,3,21
52898,17,10,3,0,4,13
52899,12,6,4,0,2,10
52900,285,161,33,32,59,226
52901,98,34,43,1,20,78
52902,12,1,9,0,2,10
52903,232,79,90,13,50,182
52904,32,15,7,1,9,23
52905,74,28,22,6,18,56
52906,36,15,9,3,9,27
52907,74,27,22,8,17,57
52908,55,28,13,5,9,46
52909,436,310,36,0,90,346
52910,116,46,33,16,21,95
52911,86,63,1,0,22,64
52912,14,5,8,0,1,13
52913,77,33,8,16,20,57
52914,46,18,20,0,8,38
52915,35,8,18,0,9,26
52916,46,24,17,0,5,41
52917,70,18,28,10,14,56
52918,46,18,20,0,8,38
52919,101,25,52,3,21,80
52920,23,13,9,0,1,22
52921,6,6,0,0,0,6
52922,161,79,23,26,33,128
52923,81,20,36,4,21,60
52924,32,8,12,2,10,22
52925,215,107,36,34,38,177
52926,89,51,20,3,15,74
52927,84,49,17,1,17,67
52928,85,39,29,1,16,69
52929,503,256,92,51,104,399
52930,212,71,100,4,37,175
52931,3,2,1,0,0,3
52932,74,31,26,0,17,57
52933,55,2,28,18,7,48
52934,17,8,5,1,3,14
52935,27,8,11,2,6,21
52936,12,9,1,0,2,10
52937,48,31,10,0,7,41
52938,29,12,9,0,8,21
52939,50,32,9,1,8,42
52940,77,50,15,0,12,65
52941,43,10,22,4,7,36
52942,42,8,26,0,8,34
52943,23,13,6,0,4,19
52944,66,10,41,0,15,51
52945,4,0,4,0,0,4
52946,406,213,112,0,81,325
52947,29,17,7,0,5,24
52948,125,45,38,16,26,99
52949,128,37,65,0,26,102
52950,31,22,1,0,8,23
52951,59,19,22,3,15,44
52952,42,7,15,10,10,32
52953,35,23,5,1,6,29
52954,2,0,0,0,2,0
52955,33,12,18,0,3,30
52956,263,174,21,3,65,198
52957,7,6,0,0,1,6
52958,56,23,24,0,9,47
52959,58,33,17,0,8,50
52960,186,136,6,4,40,146
52961,72,17,42,1,12,60
52962,87,43,25,2,17,70
52963,55,22,22,0,11,44
52964,123,51,30,19,23,100
52965,115,79,16,9,11,104
52966,35,12,18,0,5,30
52967,46,18,20,0,8,38
52968,228,123,35,26,44,184
52969,343,144,124,6,69,274
52970,22,9,10,1,2,20
52971,52,24,12,1,15,37
52972,195,47,24,88,36,159
52973,147,42,38,37,30,117
52974,139,50,5,61,23,116
52975,89,56,16,2,15,74
52976,102,69,7,5,21,81
52977,166,120,16,2,28,138
52978,234,121,66,0,47,187
52979,88,61,5,9,13,75
52980,123,61,28,13,21,102
52981,78,25,41,1,11,67
52982,74,24,26,1,23,51
52983,132,72,23,4,33,99
52984,76,40,16,8,12,64
52985,91,44,34,0,13,78
52986,16,1,10,0,5,11
52987,73,49,7,1,16,57
52988,16,2,13,0,1,15
52989,25,9,12,0,4,21
52990,672,391,152,17,112,560
52991,29,19,6,1,3,26
52992,125,42,31,28,24,101
52993,439,217,104,30,88,351
52994,20,4,11,0,5,15
52995,51,40,1,0,10,41
52996,38,16,6,7,9,29
52997,283,78,106,37,62,221
52998,52,11,21,7,13,39
52999,91,31,5,42,13,78
53000,96,59,12,2,23,73
53001,39,14,14,4,7,32
53002,180,82,59,4,35,145
53003,32,21,9,0,2,30
53004,102,43,42,4,13,89
53005,73,63,2,0,8,65
53006,13,4,5,0,4,9
53007,2,0,1,0,1,1
53008,88,22,47,3,16,72
53009,156,65,46,10,35,121
53010,366,164,126,6,70,296
53011,39,22,12,0,5,34
53012,44,8,28,1,7,37
53013,120,56,25,16,23,97
53014,117,36,44,5,32,85
53015,102,58,17,4,23,79
53016,200,55,47,60,38,162
53017,106,58,34,6,8,98
53018,73,18,37,3,15,58
53019,44,7,25,4,8,36
53020,69,34,25,0,10,59
53021,79,29,30,3,17,62
53022,16,5,9,0,2,14
53023,102,55,12,16,19,83
53024,32,21,9,0,2,30
53025,45,0,32,0,13,32
53026,41,29,0,0,12,29
53027,84,50,19,3,12,72
53028,127,63,15,18,31,96
53029,47,22,14,0,11,36
53030,62,21,26,1,14,48
53031,33,20,6,0,7,26
53032,55,33,10,0,12,43
53033,3,2,0,0,1,2
53034,302,82,142,6,72,230
53035,139,47,54,8,30,109
53036,45,21,10,3,11,34
53037,109,44,47,3,15,94
53038,104,38,35,6,25,79
53039,135,46,42,22,25,110
53040,138,84,26,0,28,110
53041,211,160,7,3,41,170
53042,40,9,19,0,12,28
53043,41,6,24,0,11,30
53044,64,32,13,4,15,49
53045,37,7,18,3,9,28
53046,474,217,156,13,88,386
53047,91,61,11,11,8,83
53048,60,14,24,14,8,52
53049,333,143,115,6,69,264
53050,29,19,6,1,3,26
53051,262,195,15,0,52,210
53052,46,18,20,0,8,38
53053,26,10,6,0,10,16
53054,50,13,20,5,12,38
53055,52,42,0,1,9,43
53056,139,58,45,8,28,111
53057,73,21,38,0,14,59
53058,278,175,40,0,63,215
53059,86,53,17,4,12,74
53060,46,18,20,0,8,38
53061,160,112,22,0,26,134
53062,51,32,1,4,14,37
53063,17,8,6,0,3,14
53064,46,18,20,0,8,38
53065,168,85,40,0,43,125
53066,218,147,30,0,41,177
53067,64,42,9,1,12,52
53068,75,49,11,1,14,61
53069,69,42,8,3,16,53
53070,233,177,10,0,46,187
53071,39,17,15,0,7,32
53072,41,26,10,0,5,36
53073,56,25,18,1,12,44
53074,8,0,4,1,3,5
53075,53,19,24,2,8,45
53076,519,280,116,13,110,409
53077,414,197,128,13,76,338
53078,62,37,14,1,10,52
53079,49,19,24,0,6,43
53080,162,72,53,7,30,132
53081,172,69,38,23,42,130
53082,221,74,82,15,50,171
53083,13,4,8,0,1,12
53084,46,26,8,0,12,34
53085,41,15,13,5,8,33
53086,94,49,21,5,19,75
53087,80,63,4,1,12,68
53088,115,75,14,3,23,92
53089,42,24,10,0,8,34
53090,6,1,4,0,1,5
53091,38,9,19,0,10,28
53092,43,12,20,0,11,32
53093,26,9,12,1,4,22
53094,14,6,5,1,2,12
53095,67,16,37,2,12,55
53096,193,49,21,93,30,163
53097,58,13,24,8,13,45
53098,19,8,7,0,4,15
53099,61,27,21,1,12,49
53100,134,101,11,1,21,113
53101,68,5,44,1,18,50
53102,32,21,9,0,2,30
53103,36,17,12,0,7,29
53104,339,179,87,18,55,284
53105,12,0,10,0,2,10
53106,296,175,54,0,67,229
53107,190,57,94,2,37,153
53108,83,23,45,2,13,70
53109,31,11,14,0,6,25
53110,9,4,4,0,1,8
53111,40,19,11,1,9,31
53112,8,2,0,4,2,6
53113,154,64,45,10,35,119
53114,64,35,19,0,10,54
53115,176,91,46,0,39,137
53116,72,50,2,2,18,54
53117,82,55,13,0,14,68
53118,369,187,98,19,65,304
53119,268,181,20,4,63,205
53120,106,61,23,7,15,91
53121,58,30,14,1,13,45
53122,27,15,8,0,4,23
53123,43,2,34,0,7,36
53124,103,50,31,2,20,83
53125,38,21,12,0,5,33
53126,38,27,6,0,5,33
53127,95,55,28,8,4,91
53128,137,39,68,1,29,108
53129,32,11,3,14,4,28
53130,141,75,13,23,30,111
53131,45,10,15,8,12,33
53132,46,18,20,0,8,38
53133,50,21,20,0,9,41
53134,86,29,22,11,24,62
53135,344,190,72,13,69,275
53136,79,53,11,0,15,64
53137,61,15,28,4,14,47
53138,122,89,5,2,26,96
53139,26,9,12,1,4,22
53140,84,18,37,0,29,55
53141,101,33,36,14,18,83
53142,12,0,11,0,1,11
53143,246,134,71,0,41,205
53144,133,50,49,12,22,111
53145,46,18,20,0,8,38
53146,139,46,44,22,27,112
53147,178,101,32,0,45,133
53148,58,28,15,0,15,43
53149,55,35,12,4,4,51
53150,505,365,32,1,107,398
53151,41,24,8,0,9,32
53152,46,8,30,0,8,38
53153,40,23,12,2,3,37
53154,52,41,1,0,10,42
53155,42,29,6,1,6,36
53156,288,195,69,3,21,267
53157,12,7,4,0,1,11
53158,65,53,2,0,10,55
53159,120,58,23,17,22,98
53160,134,101,5,0,28,106
53161,324,223,35,1,65,259
53162,31,2,21,0,8,23
53163,48,12,23,0,13,35
53164,100,61,14,7,18,82
53165,335,138,120,6,71,264
53166,438,142,178,18,100,338
53167,42,23,5,7,7,35
53168,341,145,120,6,70,271
53169,54,18,25,0,11,43
53170,5,4,1,0,0,5
53171,78,38,25,0,15,63
53172,46,18,20,0,8,38
53173,7,1,4,0,2,5
53174,101,67,1,12,21,80
53175,97,61,19,2,15,82
53176,152,83,50,1,18,134
53177,67,46,6,0,15,52
53178,5,4,0,0,1,4
53179,84,22,37,11,14,70
53180,41,25,6,0,10,31
53181,73,28,34,0,11,62
53182,10,3,3,0,4,6
53183,31,12,15,0,4,27
53184,369,182,116,2,69,300
53185,32,21,9,0,2,30
53186,32,13,11,0,8,24
53187,362,195,100,3,64,298
53188,668,390,143,17,118,550
53189,108,36,42,6,24,84
53190,68,25,22,8,13,55
53191,79,23,41,2,13,66
53192,30,10,10,4,6,24
53193,11,5,2,0,4,7
53194,399,183,128,10,78,321
53195,36,6,16,5,9,27
53196,313,162,83,15,53,260
53197,12,5,5,0,2,10
53198,142,42,66,4,30,112
53199,21,15,2,1,3,18
53200,102,32,32,11,27,75
53201,116,85,13,0,18,98
53202,81,59,5,0,17,64
53203,202,88,56,20,38,164
53204,35,25,5,5,0,35
53205,38,15,18,0,5,33
53206,23,9,12,0,2,21
53207,30,11,14,0,5,25
53208,33,11,13,2,7,26
53209,69,48,4,6,11,58
53210,42,33,2,0,7,35
53211,50,22,14,4,10,40
53212,44,37,0,0,7,37
53213,58,22,20,2,14,44
53214,35,9,16,1,9,26
53215,170,84,51,3,32,138
53216,24,3,15,1,5,19
53217,158,122,14,1,21,137
53218,23,3,11,0,9,14
53219,51,17,22,5,7,44
53220,64,43,12,0,9,55
53221,8,2,4,2,0,8
53222,24,4,17,0,3,21
53223,36,18,7,3,8,28
53224,83,56,12,0,15,68
53225,37,14,10,0,13,24
53226,94,43,33,0,18,76
53227,52,20,10,16,6,46
53228,139,57,55,1,26,113
53229,128,57,44,3,24,104
53230,79,27,26,14,12,67
53231,240,109,92,5,34,206
53232,35,25,5,5,0,35
53233,67,49,4,0,14,53
53234,122,92,4,2,24,98
53235,94,69,6,0,19,75
53236,21,9,7,5,0,21
53237,55,33,10,0,12,43
53238,7,3,4,0,0,7
53239,32,21,9,0,2,30
53240,98,27,22,28,21,77
53241,250,184,13,1,52,198
53242,4,1,2,0,1,3
53243,79,39,28,0,12,67
53244,510,264,90,51,105,405
53245,266,103,101,15,47,219
53246,201,92,61,12,36,165
53247,32,21,9,0,2,30
53248,639,377,141,18,103,536
53249,371,212,85,15,59,312
53250,56,16,17,10,13,43
53251,36,0,27,0,9,27
53252,424,206,109,20,89,335
53253,120,98,3,3,16,104
53254,537,311,100,10,116,421
53255,364,164,121,6,73,291
53256,66,24,23,10,9,57
53257,152,4,122,0,26,126
53258,11,2,5,0,4,7
53259,39,4,29,0,6,33
53260,153,111,6,2,34,119
53261,46,26,10,0,10,36
53262,523,372,43,1,107,416
53263,87,40,28,4,15,72
53264,16,10,5,1,0,16
53265,137,71,21,18,27,110
53266,12,9,1,0,2,10
53267,137,104,7,2,24,113
53268,11,7,1,0,3,8
53269,54,18,23,7,6,48
53270,314,239,18,0,57,257
53271,6,4,0,0,2,4
53272,27,16,6,0,5,22
53273,35,17,9,1,8,27
53274,221,95,13,76,37,184
53275,396,296,20,0,80,316
53276,48,31,10,0,7,41
53277,80,40,14,5,21,59
53278,133,79,27,0,27,106
53279,294,127,103,6,58,236
53280,84,32,36,2,14,70
53281,103,74,10,10,9,94
53282,87,45,27,0,15,72
53283,110,33,63,0,14,96
53284,27,2,22,0,3,24
53285,87,32,28,16,11,76
53286,49,27,12,1,9,40
53287,62,37,10,5,10,52
53288,185,86,46,15,38,147
53289,224,146,59,4,15,209
53290,120,43,32,21,24,96
53291,73,24,35,6,8,65
53292,18,8,7,0,3,15
53293,46,18,20,0,8,38
53294,75,36,26,1,12,63
53295,118,58,18,18,24,94
53296,17,8,2,1,6,11
53297,40,9,23,0,8,32
53298,28,7,10,5,6,22
53299,23,2,19,0,2,21
53300,32,12,16,0,4,28
53301,42,5,26,0,11,31
53302,274,127,86,4,57,217
53303,86,42,29,0,15,71
53304,47,24,12,3,8,39
53305,70,21,27,6,16,54
53306,23,8,10,1,4,19
53307,25,6,9,6,4,21
53308,21,6,7,0,8,13
53309,59,36,14,7,2,57
53310,28,11,10,0,7,21
53311,210,139,23,0,48,162
53312,472,118,204,44,106,366
53313,15,3,10,0,2,13
53314,365,122,153,11,79,286
53315,8,2,5,0,1,7
53316,122,59,30,8,25,97
53317,88,30,33,4,21,67
53318,6,1,4,0,1,5
53319,39,16,12,3,8,31
53320,48,36,0,0,12,36
53321,22,5,8,2,7,15
53322,68,2,43,17,6,62
53323,37,11,19,0,7,30
53324,91,43,26,3,19,72
53325,52,25,16,0,11,41
53326,23,4,10,2,7,16
53327,73,26,34,3,10,63
53328,44,16,16,1,11,33
53329,100,37,46,3,14,86
53330,51,23,14,4,10,41
53331,346,193,84,0,69,277
53332,128,76,27,0,25,103
53333,111,66,21,7,17,94
53334,320,192,60,0,68,252
53335,362,210,76,11,65,297
53336,10,7,0,0,3,7
53337,338,139,124,6,69,269
53338,28,19,5,1,3,25
53339,143,85,29,5,24,119
53340,15,3,10,0,2,13
53341,50,26,7,8,9,41
53342,101,53,20,1,27,74
53343,198,40,55,63,40,158
53344,647,375,135,18,119,528
53345,39,16,18,0,5,34
53346,31,21,7,1,2,29
53347,62,43,8,4,7,55
53348,347,149,124,6,68,279
53349,422,196,121,13,92,330
53350,141,25,89,1,26,115
53351,8,5,2,0,1,7
53352,49,19,21,1,8,41
53353,201,111,29,22,39,162
53354,81,55,9,3,14,67
53355,17,3,10,0,4,13
53356,103,67,1,13,22,81
53357,212,53,108,14,37,175
53358,49,24,13,0,12,37
53359,53,21,15,9,8,45
53360,101,36,25,21,19,82
53361,36,16,10,0,10,26
53362,65,29,24,1,11,54
53363,103,58,8,18,19,84
53364,22,13,2,0,7,15
53365,204,112,29,22,41,163
53366,4,2,2,0,0,4
53367,79,23,41,2,13,66
53368,34,16,8,4,6,28
53369,283,30,197,2,54,229
53370,158,113,19,0,26,132
53371,49,32,6,2,9,40
53372,268,31,184,2,51,217
53373,48,13,21,1,13,35
53374,73,44,15,0,14,59
53375,25,17,1,0,7,18
53376,54,27,9,8,10,44
53377,64,33,18,0,13,51
53378,118,58,22,16,22,96
53379,48,18,24,0,6,42
53380,47,28,8,0,11,36
53381,36,27,3,5,1,35
53382,56,23,21,0,12,44
53383,68,41,14,3,10,58
53384,13,2,8,0,3,10
53385,8,6,0,0,2,6
53386,53,35,12,0,6,47
53387,143,88,21,4,30,113
53388,159,123,13,1,22,137
53389,56,24,19,1,12,44
53390,406,233,92,0,81,325
53391,158,80,38,0,40,118
53392,61,37,13,1,10,51
53393,83,57,5,7,14,69
53394,268,112,94,17,45,223
53395,21,9,7,0,5,16
53396,67,46,8,0,13,54
53397,9,4,2,1,2,7
53398,90,41,33,0,16,74
53399,16,10,4,0,2,14
53400,454,242,113,20,79,375
53401,59,47,2,0,10,49
53402,90,30,21,19,20,70
53403,385,287,21,2,75,310
53404,46,18,20,0,8,38
53405,53,15,27,0,11,42
53406,87,59,10,0,18,69
53407,8,1,5,0,2,6
53408,46,18,20,0,8,38
53409,167,116,14,0,37,130
53410,63,35,19,1,8,55
53411,24,7,15,0,2,22
53412,33,25,3,1,4,29
53413,67,19,18,16,14,53
53414,68,15,37,1,15,53
53415,57,25,10,14,8,49
53416,53,7,35,0,11,42
53417,47,17,4,18,8,39
53418,61,26,22,3,10,51
53419,202,111,30,21,40,162
53420,23,8,3,2,10,13
53421,24,12,8,0,4,20
53422,58,18,15,13,12,46
53423,29,21,2,0,6,23
53424,48,14,12,10,12,36
53425,38,10,15,6,7,31
53426,585,428,39,1,117,468
53427,172,83,53,3,33,139
53428,130,54,33,19,24,106
53429,53,37,6,2,8,45
53430,135,75,28,0,32,103
53431,56,24,21,1,10,46
53432,48,2,37,2,7,41
53433,89,27,44,4,14,75
53434,48,22,19,0,7,41
53435,32,21,9,0,2,30
53436,77,55,11,1,10,67
53437,192,90,65,2,35,157
53438,20,8,8,0,4,16
53439,52,15,33,0,4,48
53440,61,38,14,0,9,52
53441,46,18,20,0,8,38
53442,92,23,50,3,16,76
53443,78,37,28,1,12,66
53444,94,66,10,1,17,77
53445,86,38,32,1,15,71
53446,121,54,50,3,14,107
53447,32,16,11,0,5,27
53448,89,39,32,4,14,75
53449,13,13,0,0,0,13
53450,245,102,15,82,46,199
53451,334,137,122,6,69,265
53452,81,45,18,2,16,65
53453,65,23,32,1,9,56
53454,14,7,4,1,2,12
53455,80,60,5,1,14,66
53456,128,42,48,13,25,103
53457,78,44,18,2,14,64
53458,47,30,5,0,12,35
53459,129,23,57,19,30,99
53460,168,67,36,25,40,128
53461,212,115,62,0,35,177
53462,59,23,11,10,15,44
53463,137,67,51,4,15,122
53464,12,3,8,0,1,11
53465,54,32,12,0,10,44
53466,22,7,13,0,2,20
53467,82,27,41,0,14,68
53468,37,27,1,2,7,30
53469,190,78,46,22,44,146
53470,156,81,44,1,30,126
53471,497,259,117,15,106,391
53472,15,3,5,0,7,8
53473,50,19,14,7,10,40
53474,8,3,2,0,3,5
53475,57,20,25,0,12,45
53476,33,3,6,16,8,25
53477,16,10,4,0,2,14
53478,249,190,13,0,46,203
53479,100,44,28,1,27,73
53480,46,18,20,0,8,38
53481,129,83,17,3,26,103
53482,131,43,34,29,25,106
53483,270,55,143,3,69,201
53484,34,17,12,2,3,31
53485,25,15,7,0,3,22
53486,318,152,107,2,57,261
53487,141,72,16,23,30,111
53488,35,13,11,3,8,27
53489,32,12,3,10,7,25
53490,22,1,16,0,5,17
53491,164,123,3,1,37,127
53492,31,21,6,0,4,27
53493,1,0,1,0,0,1
53494,157,51,77,0,29,128
53495,187,59,91,0,37,150
53496,84,46,21,1,16,68
53497,55,34,12,3,6,49
53498,89,40,34,1,14,75
53499,91,43,26,3,19,72
53500,44,19,8,8,9,35
53501,13,3,7,0,3,10
53502,60,47,1,0,12,48
53503,19,9,6,1,3,16
53504,157,85,21,20,31,126
53505,58,28,21,0,9,49
53506,177,91,46,8,32,145
53507,191,74,44,30,43,148
53508,89,26,32,11,20,69
53509,13,5,2,1,5,8
53510,11,7,1,0,3,8
53511,81,58,4,2,17,64
53512,359,163,122,6,68,291
53513,34,16,13,0,5,29
53514,54,36,5,0,13,41
53515,151,100,22,1,28,123
53516,57,33,7,4,13,44
53517,24,13,4,0,7,17
53518,94,53,22,0,19,75
53519,32,22,2,0,8,24
53520,8,4,3,0,1,7
53521,477,217,162,12,86,391
53522,85,59,5,0,21,64
53523,163,85,36,7,35,128
53524,41,25,7,1,8,33
53525,0,0,0,0,0,0
53526,10,4,1,2,3,7
53527,105,47,8,24,26,79
53528,63,41,10,0,12,51
53529,43,9,25,0,9,34
53530,78,14,36,12,16,62
53531,99,65,17,0,17,82
53532,119,44,52,4,19,100
53533,152,114,8,4,26,126
53534,126,75,20,3,28,98
53535,15,6,6,0,3,12
53536,207,137,52,2,16,191
53537,65,41,9,0,15,50
53538,57,33,7,3,14,43
53539,32,13,13,2,4,28
53540,119,67,31,11,10,109
53541,49,12,27,2,8,41
53542,37,10,17,1,9,28
53543,34,21,7,0,6,28
53544,19,12,4,0,3,16
53545,41,24,8,0,9,32
53546,106,47,19,15,25,81
53547,52,44,1,0,7,45
53548,47,31,2,1,13,34
53549,32,2,25,0,5,27
53550,22,3,14,1,4,18
53551,41,18,9,5,9,32
53552,46,18,20,0,8,38
53553,650,384,134,18,114,536
53554,74,41,14,2,17,57
53555,38,14,16,2,6,32
53556,86,28,35,4,19,67
53557,42,13,13,7,9,33
53558,241,182,13,0,46,195
53559,28,15,8,0,5,23
53560,67,14,42,0,11,56
53561,24,12,5,3,4,20
53562,289,59,155,4,71,218
53563,13,8,2,0,3,10
53564,107,34,40,5,28,79
53565,144,48,70,0,26,118
53566,189,39,52,59,39,150
53567,24,10,6,4,4,20
53568,21,18,2,0,1,20
53569,4,2,1,0,1,3
53570,17,3,10,2,2,15
53571,115,78,14,2,21,94
53572,41,26,10,0,5,36
53573,46,5,29,1,11,35
53574,2,2,0,0,0,2
53575,25,12,9,0,4,21
53576,49,34,4,0,11,38
53577,99,55,24,3,17,82
53578,61,47,1,0,13,48
53579,56,30,12,3,11,45
53580,71,18,27,12,14,57
53581,26,12,8,1,5,21
53582,57,41,9,0,7,50
53583,136,11,78,18,29,107
53584,63,37,16,0,10,53
53585,55,33,12,0,10,45
53586,64,19,32,1,12,52
53587,109,59,24,4,22,87
53588,637,356,156,23,102,535
53589,348,151,123,6,68,280
53590,41,3,34,0,4,37
53591,338,142,119,6,71,267
53592,149,84,17,20,28,121
53593,119,94,3,2,20,99
53594,23,15,1,0,7,16
53595,61,26,19,3,13,48
53596,166,98,38,1,29,137
53597,153,51,40,30,32,121
53598,98,22,53,3,20,78
53599,47,26,13,0,8,39
53600,62,35,13,2,12,50
53601,10,0,8,0,2,8
53602,565,317,115,13,120,445
53603,359,158,125,6,70,289
53604,4,0,4,0,0,4
53605,297,165,47,25,60,237
53606,41,13,17,4,7,34
53607,109,58,25,4,22,87
53608,63,44,2,0,17,46
53609,13,3,7,0,3,10
53610,230,157,31,0,42,188
53611,85,38,31,0,16,69
53612,51,23,17,0,11,40
53613,0,0,0,0,0,0
53614,33,17,9,4,3,30
53615,110,71,22,4,13,97
53616,28,15,7,0,6,22
53617,25,13,5,0,7,18
53618,54,31,11,0,12,42
53619,59,31,17,1,10,49
53620,20,8,6,0,6,14
53621,33,7,18,4,4,29
53622,186,92,36,26,32,154
53623,55,38,6,1,10,45
53624,51,20,19,3,9,42
53625,78,20,17,30,11,67
53626,25,9,10,2,4,21
53627,11,5,4,1,1,10
53628,33,9,15,3,6,27
53629,33,12,10,1,10,23
53630,68,5,44,1,18,50
53631,87,50,21,3,13,74
53632,57,13,31,0,13,44
53633,14,2,5,2,5,9
53634,48,19,12,10,7,41
53635,9,6,0,0,3,6
53636,35,16,10,0,9,26
53637,108,78,5,1,24,84
53638,70,29,27,1,13,57
53639,32,21,9,0,2,30
53640,57,20,25,0,12,45
53641,653,371,155,22,105,548
53642,172,117,11,10,34,138
53643,23,13,6,1,3,20
53644,79,45,16,3,15,64
53645,45,0,32,0,13,32
53646,69,30,29,0,10,59
53647,8,3,1,2,2,6
53648,42,14,17,0,11,31
53649,403,303,20,0,80,323
53650,63,44,4,0,15,48
53651,18,4,9,0,5,13
53652,172,91,48,0,33,139
53653,45,23,3,11,8,37
53654,46,23,12,0,11,35
53655,111,47,14,16,34,77
53656,73,39,18,0,16,57
53657,64,18,25,2,19,45
53658,12,1,7,0,4,8
53659,17,0,10,1,6,11
53660,222,90,41,38,53,169
53661,230,156,32,0,42,188
53662,14,3,7,1,3,11
53663,68,24,30,1,13,55
53664,80,56,5,0,19,61
53665,34,25,7,2,0,34
53666,230,159,16,2,53,177
53667,208,145,16,2,45,163
53668,69,55,2,0,12,57
53669,246,121,64,13,48,198
53670,12,1,6,1,4,8
53671,19,7,8,0,4,15
53672,59,31,16,1,11,48
53673,29,18,8,0,3,26
53674,83,42,17,0,24,59
53675,102,24,55,3,20,82
53676,30,20,4,0,6,24
53677,111,105,0,6,0,111
53678,351,176,86,13,76,275
53679,102,50,26,5,21,81
53680,49,14,23,4,8,41
53681,51,34,7,2,8,43
53682,79,23,40,2,14,65
53683,32,21,9,0,2,30
53684,148,13,102,2,31,117
53685,35,19,11,0,5,30
53686,16,4,8,0,4,12
53687,113,34,40,15,24,89
53688,177,131,15,0,31,146
53689,380,203,102,3,72,308
53690,76,42,15,2,17,59
53691,16,6,5,0,5,11
53692,36,2,25,0,9,27
53693,73,11,42,1,19,54
53694,32,12,9,6,5,27
53695,8,1,7,0,0,8
53696,53,42,1,0,10,43
53697,430,304,40,1,85,345
53698,8,4,0,1,3,5
53699,480,130,204,39,107,373
53700,180,102,31,1,46,134
53701,65,18,29,10,8,57
53702,110,44,15,17,34,76
53703,27,10,12,1,4,23
53704,37,9,22,1,5,32
53705,19,4,8,0,7,12
53706,439,215,118,14,92,347
53707,176,135,16,1,24,152
53708,100,58,21,0,21,79
53709,20,12,4,1,3,17
53710,58,17,28,0,13,45
53711,82,21,27,18,16,66
53712,96,55,23,3,15,81
53713,52,24,14,1,13,39
53714,136,11,76,18,31,105
53715,123,57,43,3,20,103
53716,25,5,11,5,4,21
53717,42,2,27,5,8,34
53718,16,9,4,0,3,13
53719,96,49,29,1,17,79
53720,146,82,15,24,25,121
53721,32,21,9,0,2,30
53722,14,7,6,0,1,13
53723,45,23,15,1,6,39
53724,305,126,122,3,54,251
53725,30,4,23,0,3,27
53726,205,43,56,66,40,165
53727,25,19,2,4,0,25
53728,53,22,17,4,10,43
53729,119,45,36,17,21,98
53730,25,6,13,0,6,19
53731,15,6,6,0,3,12
53732,195,132,25,5,33,162
53733,25,11,8,5,1,24
53734,32,11,17,1,3,29
53735,30,2,22,0,6,24
53736,274,159,24,34,57,217
53737,137,55,46,8,28,109
53738,29,21,2,2,4,25
53739,175,111,25,7,32,143
53740,343,145,121,6,71,272
53741,11,6,4,0,1,10
53742,37,16,18,0,3,34
53743,13,1,8,1,3,10
53744,19,10,4,0,5,14
53745,77,28,36,1,12,65
53746,57,25,21,3,8,49
53747,31,5,19,0,7,24
53748,70,20,21,15,14,56
53749,61,36,9,3,13,48
53750,198,111,27,21,39,159
53751,20,0,15,2,3,17
53752,100,67,11,0,22,78
53753,101,47,30,5,19,82
53754,35,2,25,0,8,27
53755,343,173,94,2,74,269
53756,31,4,24,0,3,28
53757,17,3,12,1,1,16
53758,27,4,10,5,8,19
53759,54,38,5,1,10,44
53760,30,4,12,9,5,25
53761,32,21,9,0,2,30
53762,111,104,0,7,0,111
53763,126,30,70,0,26,100
53764,10,0,6,0,4,6
53765,45,22,15,3,5,40
53766,70,26,30,1,13,57
53767,278,155,61,0,62,216
53768,114,66,29,10,9,105
53769,15,3,8,1,3,12
53770,13,6,2,1,4,9
53771,19,3,14,0,2,17
53772,82,41,4,24,13,69
53773,83,41,20,1,21,62
53774,24,7,7,3,7,17
53775,94,33,34,2,25,69
53776,74,31,24,3,16,58
53777,59,27,23,0,9,50
53778,7,1,6,0,0,7
53779,13,5,6,0,2,11
53780,139,94,21,0,24,115
53781,527,373,42,1,111,416
53782,57,14,31,0,12,45
53783,16,8,4,0,4,12
53784,45,6,29,0,10,35
53785,117,54,23,17,23,94
53786,11,2,5,0,4,7
53787,49,19,12,9,9,40
53788,90,41,28,4,17,73
53789,16,1,7,2,6,10
53790,49,26,9,4,10,39
53791,159,98,19,7,35,124
53792,43,21,13,0,9,34
53793,109,32,40,15,22,87
53794,32,13,8,3,8,24
53795,53,40,8,5,0,53
53796,56,12,23,7,14,42
53797,31,13,14,0,4,27
53798,34,9,9,5,11,23
53799,64,17,30,4,13,51
53800,215,87,36,41,51,164
53801,52,0,41,2,9,43
53802,18,14,0,0,4,14
53803,78,36,23,0,19,59
53804,674,393,144,18,119,555
53805,56,14,20,13,9,47
53806,66,37,18,0,11,55
53807,22,12,7,2,1,21
53808,103,74,11,9,9,94
53809,438,143,179,17,99,339
53810,55,32,7,7,9,46
53811,16,3,7,3,3,13
53812,274,149,65,16,44,230
53813,67,35,23,0,9,58
53814,5,4,1,0,0,5
53815,79,34,31,2,12,67
53816,20,9,5,2,4,16
53817,38,19,6,8,5,33
53818,32,21,9,0,2,30
53819,655,383,142,16,114,541
53820,22,8,9,1,4,18
53821,170,117,38,2,13,157
53822,13,2,8,0,3,10
53823,55,39,5,1,10,45
53824,72,35,18,0,19,53
53825,179,126,14,1,38,141
53826,163,30,102,1,30,133
53827,52,41,1,0,10,42
53828,30,17,7,1,5,25
53829,71,35,22,0,14,57
53830,473,210,132,33,98,375
53831,253,130,74,0,49,204
53832,46,18,20,0,8,38
53833,159,72,51,5,31,128
53834,68,43,11,0,14,54
53835,58,21,12,17,8,50
53836,19,14,3,0,2,17
53837,142,86,28,0,28,114
53838,61,43,7,4,7,54
53839,124,52,37,15,20,104
53840,65,30,9,8,18,47
53841,105,25,58,2,20,85
53842,39,8,14,10,7,32
53843,287,195,67,3,22,265
53844,50,23,17,2,8,42
53845,89,46,12,2,29,60
53846,35,17,9,2,7,28
53847,55,32,13,0,10,45
53848,54,37,4,1,12,42
53849,41,13,18,4,6,35
53850,52,17,17,7,11,41
53851,223,143,60,3,17,206
53852,48,0,42,0,6,42
53853,61,45,5,4,7,54
53854,341,145,120,6,70,271
53855,222,73,84,15,50,172
53856,42,20,10,1,11,31
53857,27,14,10,2,1,26
53858,30,11,13,0,6,24
53859,38,13,20,1,4,34
53860,345,186,89,15,55,290
53861,12,3,8,0,1,11
53862,151,24,98,1,28,123
53863,58,18,19,6,15,43
53864,61,24,15,8,14,47
53865,90,55,15,5,15,75
53866,21,13,1,3,4,17
53867,142,48,53,8,33,109
53868,176,100,37,6,33,143
53869,109,37,42,11,19,90
53870,25,10,9,1,5,20
53871,425,212,109,11,93,332
53872,71,40,19,0,12,59
53873,2,0,1,0,1,1
53874,157,79,25,22,31,126
53875,25,15,5,1,4,21
53876,121,39,45,5,32,89
53877,199,116,42,6,35,164
53878,63,26,8,12,17,46
53879,5,1,4,0,0,5
53880,176,76,63,10,27,149
53881,39,27,5,2,5,34
53882,92,65,5,9,13,79
53883,29,9,15,1,4,25
53884,129,30,71,1,27,102
53885,27,14,6,3,4,23
53886,12,5,4,2,1,11
53887,127,28,41,23,35,92
53888,32,21,9,0,2,30
53889,57,34,9,4,10,47
53890,23,11,6,1,5,18
53891,75,32,19,1,23,52
53892,70,22,36,1,11,59
53893,23,15,2,0,6,17
53894,206,88,61,19,38,168
53895,48,34,4,0,10,38
53896,55,36,9,1,9,46
53897,27,6,16,0,5,22
53898,31,2,21,0,8,23
53899,344,143,127,6,68,276
53900,24,10,6,3,5,19
53901,77,30,23,7,17,60
53902,77,18,38,1,20,57
53903,46,23,9,0,14,32
53904,25,17,2,0,6,19
53905,178,46,56,40,36,142
53906,17,4,13,0,0,17
53907,3,2,1,0,0,3
53908,307,78,129,25,75,232
53909,58,14,22,8,14,44
53910,31,17,8,0,6,25
53911,65,21,29,1,14,51
53912,16,7,6,0,3,13
53913,44,36,2,0,6,38
53914,36,23,2,0,11,25
53915,128,96,8,1,23,105
53916,82,19,42,1,20,62
53917,53,20,5,14,14,39
53918,59,47,2,0,10,49
53919,230,156,32,0,42,188
53920,10,2,7,0,1,9
53921,132,69,40,0,23,109
53922,22,12,0,5,5,17
53923,47,11,19,5,12,35
53924,208,146,42,2,18,190
53925,9,5,0,0,4,5
53926,56,18,25,4,9,47
53927,52,19,6,14,13,39
53928,13,1,8,0,4,9
53929,15,2,5,4,4,11
53930,69,43,13,1,12,57
53931,142,49,33,28,32,110
53932,138,54,44,9,31,107
53933,37,21,6,2,8,29
53934,18,9,6,0,3,15
53935,30,10,12,4,4,26
53936,152,69,43,0,40,112
53937,75,18,33,11,13,62
53938,71,36,23,0,12,59
53939,77,47,7,3,20,57
53940,56,37,12,0,7,49
53941,95,64,7,9,15,80
53942,274,17,203,0,54,220
53943,55,11,38,0,6,49
53944,46,18,20,0,8,38
53945,221,90,41,38,52,169
53946,89,51,15,3,20,69
53947,110,24,36,27,23,87
53948,265,62,51,108,44,221
53949,36,18,12,0,6,30
53950,30,1,21,0,8,22
53951,118,42,35,21,20,98
53952,19,3,13,0,3,16
53953,170,112,27,1,30,140
53954,100,53,21,6,20,80
53955,35,4,21,4,6,29
53956,66,45,9,2,10,56
53957,265,124,77,11,53,212
53958,144,107,8,4,25,119
53959,188,92,73,4,19,169
53960,32,21,9,0,2,30
53961,25,6,9,0,10,15
53962,116,53,37,3,23,93
53963,35,23,5,0,7,28
53964,128,85,18,1,24,104
53965,46,18,20,0,8,38
53966,117,49,42,0,26,91
53967,222,119,67,0,36,186
53968,99,29,52,0,18,81
53969,67,4,52,1,10,57
53970,50,11,30,0,9,41
53971,120,57,23,17,23,97
53972,23,12,8,0,3,20
53973,6,0,4,0,2,4
53974,167,111,25,1,30,137
53975,40,18,16,0,6,34
53976,26,8,10,0,8,18
53977,31,9,12,0,10,21
53978,144,42,62,3,37,107
53979,231,100,15,77,39,192
53980,14,5,6,2,1,13
53981,72,30,35,1,6,66
53982,109,38,42,11,18,91
53983,50,19,14,4,13,37
53984,46,12,15,11,8,38
53985,264,111,93,16,44,220
53986,65,23,25,4,13,52
53987,128,89,14,0,25,103
53988,40,7,15,11,7,33
53989,75,36,17,8,14,61
53990,46,13,24,1,8,38
53991,57,45,1,0,11,46
53992,20,10,2,3,5,15
53993,39,0,27,0,12,27
53994,117,42,35,21,19,98
53995,24,4,14,1,5,19
53996,68,46,7,0,15,53
53997,46,18,20,0,8,38
53998,46,18,20,0,8,38
53999,6,1,2,0,3,3
54000,12,0,11,0,1,11
54001,29,11,14,0,4,25
54002,538,382,41,1,114,424
54003,448,330,20,0,98,350
54004,333,148,111,6,68,265
54005,6,3,2,0,1,5
54006,280,97,125,15,43,237
54007,146,51,32,31,32,114
54008,9,4,3,0,2,7
54009,33,14,10,2,7,26
54010,69,34,24,1,10,59
54011,45,27,8,4,6,39
54012,36,11,21,1,3,33
54013,55,32,15,2,6,49
54014,114,10,59,21,24,90
54015,4,1,2,0,1,3
54016,139,74,34,0,31,108
54017,99,23,53,3,20,79
54018,87,65,5,4,13,74
54019,48,19,16,2,11,37
54020,47,17,13,4,13,34
54021,49,18,25,0,6,43
54022,208,85,12,73,38,170
54023,72,18,29,0,25,47
54024,111,105,0,6,0,111
54025,424,240,84,15,85,339
54026,31,15,5,0,11,20
54027,12,4,5,1,2,10
54028,143,47,73,3,20,123
54029,71,20,31,11,9,62
54030,26,13,8,0,5,21
54031,49,23,11,3,12,37
54032,203,28,94,35,46,157
54033,107,45,38,3,21,86
54034,76,46,14,1,15,61
54035,4,0,1,2,1,3
54036,43,31,2,0,10,33
54037,51,31,8,3,9,42
54038,52,16,22,3,11,41
54039,48,25,14,4,5,43
54040,250,103,18,82,47,203
54041,205,13,153,0,39,166
54042,15,14,0,0,1,14
54043,6,2,1,0,3,3
54044,30,6,17,2,5,25
54045,42,29,8,1,4,38
54046,33,7,17,0,9,24
54047,29,22,2,0,5,24
54048,4,0,4,0,0,4
54049,32,23,1,0,8,24
54050,38,9,17,4,8,30
54051,60,21,31,0,8,52
54052,162,11,92,27,32,130
54053,22,9,10,2,1,21
54054,9,1,4,3,1,8
54055,46,18,20,0,8,38
54056,494,254,89,48,103,391
54057,76,34,23,2,17,59
54058,59,41,9,0,9,50
54059,53,20,18,3,12,41
54060,21,7,5,2,7,14
54061,27,13,8,1,5,22
54062,293,36,201,2,54,239
54063,10,6,1,0,3,7
54064,72,34,12,7,19,53
54065,59,31,15,1,12,47
54066,321,193,58,0,70,251
54067,470,217,147,14,92,378
54068,446,241,95,13,97,349
54069,27,8,13,0,6,21
54070,71,44,20,0,7,64
54071,26,16,2,0,8,18
54072,33,15,13,0,5,28
54073,28,11,9,2,6,22
54074,38,12,7,9,10,28
54075,321,92,155,5,69,252
54076,82,33,35,0,14,68
54077,64,4,44,4,12,52
54078,82,55,9,3,15,67
54079,40,10,17,4,9,31
54080,47,34,4,3,6,41
54081,110,37,33,11,29,81
54082,12,3,6,0,3,9
54083,70,17,26,9,18,52
54084,30,9,6,5,10,20
54085,208,161,14,1,32,176
54086,57,28,3,16,10,47
54087,39,6,27,0,6,33
54088,31,4,21,0,6,25
54089,22,0,16,0,6,16
54090,170,123,21,0,26,144
54091,156,55,39,30,32,124
54092,551,377,51,1,122,429
54093,61,20,25,7,9,52
54094,88,54,19,2,13,75
54095,35,26,2,0,7,28
54096,120,98,5,0,17,103
54097,195,76,35,34,50,145
54098,231,113,68,10,40,191
54099,50,28,12,2,8,42
54100,194,149,14,1,30,164
54101,431,237,95,11,88,343
54102,325,89,154,6,76,249
54103,278,191,20,4,63,215
54104,71,32,13,5,21,50
54105,6,2,3,0,1,5
54106,226,74,86,15,51,175
54107,52,3,39,0,10,42
54108,14,2,11,0,1,13
54109,38,1,7,23,7,31
54110,10,2,6,0,2,8
54111,151,24,98,1,28,123
54112,32,21,9,0,2,30
54113,30,10,12,4,4,26
54114,177,89,40,8,40,137
54115,68,44,12,0,12,56
54116,67,12,42,1,12,55
54117,159,68,33,19,39,120
54118,184,90,36,26,32,152
54119,62,24,25,1,12,50
54120,49,22,18,0,9,40
54121,108,53,35,0,20,88
54122,2,1,0,0,1,1
54123,72,29,30,4,9,63
54124,89,70,3,0,16,73
54125,84,40,25,2,17,67
54126,29,4,23,0,2,27
54127,37,5,23,0,9,28
54128,23,5,11,1,6,17
54129,110,86,3,0,21,89
54130,14,10,0,0,4,10
54131,92,30,32,14,16,76
54132,46,39,2,0,5,41
54133,53,16,21,0,16,37
54134,54,32,9,0,13,41
54135,57,20,25,0,12,45
54136,117,42,35,21,19,98
54137,69,32,16,12,9,60
54138,15,4,9,0,2,13
54139,423,130,153,44,96,327
54140,31,4,21,0,6,25
54141,63,22,25,4,12,51
54142,76,58,5,4,9,67
54143,23,10,9,0,4,19
54144,41,18,7,3,13,28
54145,25,5,1,15,4,21
54146,50,0,32,3,15,35
54147,58,42,7,2,7,51
54148,31,12,13,3,3,28
54149,113,50,20,18,25,88
54150,62,31,12,5,14,48
54151,29,19,5,0,5,24
54152,97,64,9,3,21,76
54153,31,21,2,0,8,23
54154,76,53,12,1,10,66
54155,228,126,65,0,37,191
54156,34,17,13,0,4,30
54157,151,100,22,1,28,123
54158,46,18,20,0,8,38
54159,653,377,150,19,107,546
54160,75,26,16,10,23,52
54161,100,46,15,24,15,85
54162,129,67,12,22,28,101
54163,21,16,3,0,2,19
54164,35,9,18,0,8,27
54165,83,29,41,0,13,70
54166,61,21,22,2,16,45
54167,3,1,2,0,0,3
54168,95,31,34,11,19,76
54169,26,17,3,0,6,20
54170,60,31,15,1,13,47
54171,128,39,48,20,21,107
54172,44,15,19,2,8,36
54173,48,19,20,0,9,39
54174,100,65,8,6,21,79
54175,22,14,3,0,5,17
54176,13,2,9,0,2,11
54177,50,1,39,0,10,40
54178,86,55,16,0,15,71
54179,10,2,6,0,2,8
54180,115,45,43,2,25,90
54181,253,190,11,1,51,202
54182,30,7,14,2,7,23
54183,38,7,16,4,11,27
54184,56,44,2,0,10,46
54185,42,14,17,0,11,31
54186,19,0,10,0,9,10
54187,120,49,16,19,36,84
54188,284,192,68,3,21,263
54189,38,19,8,1,10,28
54190,156,70,53,2,31,125
54191,3,0,3,0,0,3
54192,48,19,15,4,10,38
54193,32,21,9,0,2,30
54194,27,14,8,0,5,22
54195,67,40,15,0,12,55
54196,278,25,196,2,55,223
54197,164,114,24,0,26,138
54198,10,2,6,0,2,8
54199,14,4,7,2,1,13
54200,12,1,9,0,2,10
54201,45,6,29,0,10,35
54202,21,10,9,0,2,19
54203,38,15,14,0,9,29
54204,390,288,18,2,82,308
54205,276,207,15,0,54,222
54206,87,32,35,1,19,68
54207,21,11,3,1,6,15
54208,261,63,143,1,54,207
54209,329,185,68,0,76,253
54210,110,88,5,2,15,95
54211,37,15,16,0,6,31
54212,537,386,36,1,114,423
54213,266,185,18,4,59,207
54214,15,3,9,1,2,13
54215,181,85,40,19,37,144
54216,127,74,22,3,28,99
54217,107,103,0,4,0,107
54218,472,236,89,43,104,368
54219,36,6,23,0,7,29
54220,61,10,36,4,11,50
54221,40,3,29,2,6,34
54222,87,34,35,5,13,74
54223,44,28,6,2,8,36
54224,5,0,4,0,1,4
54225,145,14,98,2,31,114
54226,19,10,7,1,1,18
54227,25,7,13,0,5,20
54228,1040,388,413,46,193,847
54229,27,10,11,2,4,23
54230,89,23,25,28,13,76
54231,66,44,13,0,9,57
54232,76,30,30,1,15,61
54233,9,8,0,0,1,8
54234,32,12,16,0,4,28
54235,132,27,46,23,36,96
54236,67,8,43,2,14,53
54237,36,24,5,0,7,29
54238,88,61,5,9,13,75
54239,196,138,39,2,17,179
54240,92,42,13,12,25,67
54241,36,10,20,0,6,30
54242,20,9,8,0,3,17
54243,66,25,27,2,12,54
54244,16,9,1,4,2,14
54245,26,15,3,6,2,24
54246,82,34,24,3,21,61
54247,32,21,9,0,2,30
54248,28,8,11,2,7,21
54249,110,69,21,0,20,90
54250,99,62,12,1,24,75
54251,17,9,3,0,5,12
54252,206,80,89,4,33,173
54253,88,30,42,5,11,77
54254,15,11,2,1,1,14
54255,144,103,14,0,27,117
54256,167,82,33,21,31,136
54257,28,19,1,0,8,20
54258,216,152,50,2,12,204
54259,513,281,114,17,101,412
54260,10,1,7,1,1,9
54261,79,41,14,5,19,60
54262,69,29,23,0,17,52
54263,80,55,9,3,13,67
54264,76,12,49,0,15,61
54265,108,45,38,1,24,84
54266,46,18,20,0,8,38
54267,4,3,0,0,1,3
54268,38,15,17,0,6,32
54269,433,323,24,0,86,347
54270,95,24,55,2,14,81
54271,12,5,4,3,0,12
54272,170,36,88,1,45,125
54273,85,55,14,0,16,69
54274,82,23,37,3,19,63
54275,209,68,83,15,43,166
54276,25,20,2,0,3,22
54277,209,58,114,3,34,175
54278,80,43,12,5,20,60
54279,86,44,16,9,17,69
54280,25,14,7,0,4,21
54281,150,58,39,20,33,117
54282,33,16,8,3,6,27
54283,334,137,122,6,69,265
54284,98,40,33,6,19,79
54285,142,103,6,5,28,114
54286,7,2,5,0,0,7
54287,106,41,28,14,23,83
54288,89,33,23,13,20,69
54289,52,25,15,5,7,45
54290,32,21,9,0,2,30
54291,64,29,21,0,14,50
54292,67,19,32,1,15,52
54293,98,32,35,13,18,80
54294,20,5,8,0,7,13
54295,84,32,33,1,18,66
54296,33,9,16,0,8,25
54297,39,17,8,7,7,32
54298,55,31,17,0,7,48
54299,100,83,3,2,12,88
54300,11,8,0,0,3,8
54301,443,158,145,46,94,349
54302,96,56,24,13,3,93
54303,105,48,35,4,18,87
54304,54,14,21,10,9,45
54305,8,1,6,0,1,7
54306,72,14,38,4,16,56
54307,348,183,91,15,59,289
54308,7,2,2,2,1,6
54309,60,12,39,1,8,52
54310,435,322,20,0,93,342
54311,129,28,46,29,26,103
54312,109,29,61,0,19,90
54313,71,36,24,0,11,60
54314,504,266,90,45,103,401
54315,40,16,14,0,10,30
54316,41,20,5,7,9,32
54317,3,0,2,0,1,2
54318,15,10,1,0,4,11
54319,121,49,33,14,25,96
54320,85,36,33,1,15,70
54321,59,18,23,10,8,51
54322,160,97,41,13,9,151
54323,47,20,20,0,7,40
54324,16,4,8,0,4,12
54325,39,7,4,23,5,34
54326,81,40,30,2,9,72
54327,90,66,5,0,19,71
54328,127,74,22,3,28,99
54329,45,2,36,0,7,38
54330,54,22,12,9,11,43
54331,89,35,35,1,18,71
54332,343,145,121,6,71,272
54333,135,68,31,9,27,108
54334,103,56,10,14,23,80
54335,203,88,61,18,36,167
54336,40,6,23,0,11,29
54337,373,208,89,15,61,312
54338,17,11,1,4,1,16
54339,236,143,40,6,47,189
54340,115,43,26,24,22,93
54341,81,33,34,2,12,69
54342,32,21,9,0,2,30
54343,127,74,22,3,28,99
54344,25,0,21,0,4,21
54345,77,31,23,5,18,59
54346,43,14,22,1,6,37
54347,58,22,27,1,8,50
54348,162,115,11,0,36,126
54349,56,31,13,3,9,47
54350,32,21,9,0,2,30
54351,225,170,8,1,46,179
54352,119,38,50,6,25,94
54353,93,21,31,22,19,74
54354,181,85,46,15,35,146
54355,53,27,9,7,10,43
54356,92,39,16,19,18,74
54357,204,150,17,2,35,169
54358,38,18,15,0,5,33
54359,70,27,28,0,15,55
54360,16,5,8,2,1,15
54361,69,23,27,4,15,54
54362,69,19,32,1,17,52
54363,37,27,1,2,7,30
54364,10,3,1,2,4,6
54365,2,2,0,0,0,2
54366,89,53,17,4,15,74
54367,199,80,42,31,46,153
54368,56,20,14,5,17,39
54369,51,30,11,0,10,41
54370,48,21,14,2,11,37
54371,144,39,65,3,37,107
54372,319,194,54,0,71,248
54373,69,45,4,10,10,59
54374,15,3,8,0,4,11
54375,163,110,26,0,27,136
54376,30,3,19,2,6,24
54377,56,23,22,0,11,45
54378,30,9,15,1,5,25
54379,13,6,7,0,0,13
54380,52,19,27,1,5,47
54381,35,1,26,1,7,28
54382,42,1,31,0,10,32
54383,20,6,11,0,3,17
54384,32,21,9,0,2,30
54385,104,25,48,7,24,80
54386,317,160,89,15,53,264
54387,38,9,17,4,8,30
54388,67,48,10,1,8,59
54389,86,48,19,1,18,68
54390,68,30,15,5,18,50
54391,295,36,202,2,55,240
54392,51,25,3,13,10,41
54393,79,23,41,2,13,66
54394,12,8,2,1,1,11
54395,137,55,53,5,24,113
54396,32,12,9,3,8,24
54397,42,9,13,7,13,29
54398,12,3,9,0,0,12
54399,35,0,28,2,5,30
54400,473,342,28,1,102,371
54401,46,18,20,0,8,38
54402,203,78,14,73,38,165
54403,547,390,44,1,112,435
54404,33,4,23,0,6,27
54405,30,5,20,3,2,28
54406,67,33,13,5,16,51
54407,369,157,131,11,70,299
54408,108,44,45,1,18,90
54409,94,26,48,0,20,74
54410,154,120,9,3,22,132
54411,38,7,17,5,9,29
54412,28,15,5,0,8,20
54413,40,19,5,7,9,31
54414,32,21,9,0,2,30
54415,466,262,94,13,97,369
54416,29,14,7,1,7,22
54417,13,1,6,0,6,7
54418,88,45,24,2,17,71
54419,137,63,43,10,21,116
54420,46,12,27,0,7,39
54421,51,18,18,2,13,38
54422,150,64,54,1,31,119
54423,667,390,142,17,118,549
54424,46,18,20,0,8,38
54425,85,35,33,1,16,69
54426,284,161,32,32,59,225
54427,54,11,28,0,15,39
54428,11,4,7,0,0,11
54429,174,84,55,7,28,146
54430,6,1,4,0,1,5
54431,115,77,23,3,12,103
54432,13,5,6,0,2,11
54433,46,18,20,0,8,38
54434,82,24,39,11,8,74
54435,53,26,15,2,10,43
54436,323,168,90,0,65,258
54437,241,129,69,0,43,198
54438,31,9,12,0,10,21
54439,55,30,17,0,8,47
54440,100,31,43,6,20,80
54441,122,94,6,0,22,100
54442,259,195,12,0,52,207
54443,75,51,15,6,3,72
54444,66,28,24,0,14,52
54445,106,48,18,15,25,81
54446,31,7,15,2,7,24
54447,180,134,9,7,30,150
54448,119,74,32,0,13,106
54449,63,26,9,12,16,47
54450,508,268,88,47,105,403
54451,16,8,5,0,3,13
54452,31,19,3,0,9,22
54453,96,55,23,3,15,81
54454,110,72,2,13,23,87
54455,110,51,34,3,22,88
54456,13,8,5,0,0,13
54457,1,1,0,0,0,1
54458,29,10,12,1,6,23
54459,365,201,91,15,58,307
54460,82,61,5,0,16,66
54461,23,9,6,1,7,16
54462,20,9,6,2,3,17
54463,95,20,52,3,20,75
54464,35,11,14,0,10,25
54465,161,74,46,8,33,128
54466,11,0,7,2,2,9
54467,24,3,19,0,2,22
54468,285,209,18,2,56,229
54469,382,199,97,20,66,316
54470,408,213,105,20,70,338
54471,192,138,15,2,37,155
54472,64,29,22,3,10,54
54473,89,59,16,0,14,75
54474,26,5,13,0,8,18
54475,67,25,26,0,16,51
54476,62,13,43,0,6,56
54477,74,40,18,1,15,59
54478,15,10,2,0,3,12
54479,50,22,17,3,8,42
54480,26,13,6,0,7,19
54481,114,30,43,15,26,88
54482,40,16,17,2,5,35
54483,30,2,22,0,6,24
54484,76,45,15,0,16,60
54485,50,1,39,0,10,40
54486,198,137,14,0,47,151
54487,25,14,4,0,7,18
54488,45,26,9,4,6,39
54489,56,31,13,1,11,45
54490,58,17,15,14,12,46
54491,42,23,2,7,10,32
54492,127,75,22,2,28,99
54493,22,3,0,10,9,13
54494,98,42,34,4,18,80
54495,34,0,29,0,5,29
54496,10,6,2,0,2,8
54497,103,67,1,13,22,81
54498,30,13,9,0,8,22
54499,153,117,9,3,24,129
54500,35,19,11,0,5,30
54501,41,31,1,0,9,32
54502,35,5,25,1,4,31
54503,36,2,24,0,10,26
54504,3,1,2,0,0,3
54505,16,12,3,0,1,15
54506,179,135,7,1,36,143
54507,187,53,22,84,28,159
54508,52,26,15,1,10,42
54509,49,3,34,8,4,45
54510,67,16,26,9,16,51
54511,86,17,54,0,15,71
54512,89,47,20,2,20,69
54513,34,14,15,0,5,29
54514,64,52,3,0,9,55
54515,125,82,20,0,23,102
54516,26,16,6,0,4,22
54517,84,38,32,0,14,70
54518,89,19,39,11,20,69
54519,128,41,49,13,25,103
54520,22,7,10,1,4,18
54521,64,29,21,1,13,51
54522,36,4,20,0,12,24
54523,151,23,99,1,28,123
54524,122,67,35,1,19,103
54525,8,3,3,2,0,8
54526,43,15,18,0,10,33
54527,114,59,32,4,19,95
54528,10,2,4,0,4,6
54529,232,56,33,104,39,193
54530,88,70,2,2,14,74
54531,38,18,15,0,5,33
54532,16,7,6,0,3,13
54533,40,30,1,2,7,33
54534,42,25,10,0,7,35
54535,66,32,16,6,12,54
54536,50,27,11,2,10,40
54537,75,10,42,5,18,57
54538,166,82,47,4,33,133
54539,151,101,22,0,28,123
54540,121,33,64,0,24,97
54541,74,31,23,1,19,55
54542,42,22,11,0,9,33
54543,81,50,16,4,11,70
54544,85,38,19,14,14,71
54545,50,24,10,7,9,41
54546,10,8,1,0,1,9
54547,15,3,5,1,6,9
54548,33,15,6,0,12,21
54549,17,5,12,0,0,17
54550,257,131,76,0,50,207
54551,139,44,64,6,25,114
54552,5,1,3,0,1,4
54553,9,3,3,0,3,6
54554,8,6,0,1,1,7
54555,17,0,13,0,4,13
54556,58,1,50,0,7,51
54557,249,69,126,2,52,197
54558,32,21,9,0,2,30
54559,33,13,14,2,4,29
54560,74,26,21,9,18,56
54561,48,22,13,1,12,36
54562,6,4,1,0,1,5
54563,52,36,6,0,10,42
54564,154,62,37,22,33,121
54565,140,83,30,0,27,113
54566,71,44,13,0,14,57
54567,12,4,3,1,4,8
54568,61,33,10,6,12,49
54569,360,261,18,2,79,281
54570,307,187,52,0,68,239
54571,84,16,51,0,17,67
54572,119,80,12,3,24,95
54573,60,45,2,0,13,47
54574,152,26,64,21,41,111
54575,66,39,12,2,13,53
54576,26,16,6,1,3,23
54577,75,46,12,2,15,60
54578,171,113,27,1,30,141
54579,21,10,5,2,4,17
54580,26,0,15,0,11,15
54581,6,0,4,0,2,4
54582,34,15,8,2,9,25
54583,49,32,6,2,9,40
54584,175,119,40,2,14,161
54585,41,15,13,5,8,33
54586,49,19,25,0,5,44
54587,8,0,6,0,2,6
54588,28,22,3,0,3,25
54589,46,18,20,0,8,38
54590,30,12,11,3,4,26
54591,22,1,16,0,5,17
54592,38,2,28,1,7,31
54593,41,16,18,2,5,36
54594,40,27,5,0,8,32
54595,117,79,11,3,24,93
54596,510,348,54,1,107,403
54597,26,12,8,0,6,20
54598,37,2,28,0,7,30
54599,14,6,5,0,3,11
54600,19,8,8,1,2,17
54601,11,4,3,0,4,7
54602,111,38,29,17,27,84
54603,41,8,15,11,7,34
54604,86,33,26,10,17,69
54605,211,139,23,0,49,162
54606,33,23,4,0,6,27
54607,105,35,46,9,15,90
54608,28,10,10,1,7,21
54609,16,5,8,2,1,15
54610,96,58,14,6,18,78
54611,29,10,10,2,7,22
54612,22,9,5,2,6,16
54613,226,56,116,3,51,175
54614,36,17,11,0,8,28
54615,18,11,5,1,1,17
54616,355,155,124,6,70,285
54617,44,4,31,2,7,37
54618,438,216,109,20,93,345
54619,53,17,23,3,10,43
54620,54,42,1,0,11,43
54621,13,6,5,0,2,11
54622,40,21,3,6,10,30
54623,44,15,23,0,6,38
54624,36,28,2,0,6,30
54625,128,53,33,18,24,104
54626,496,296,100,11,89,407
54627,187,109,21,22,35,152
54628,38,26,6,0,6,32
54629,28,9,14,2,3,25
54630,113,67,27,10,9,104
54631,25,16,2,0,7,18
54632,33,17,7,2,7,26
54633,30,12,2,13,3,27
54634,46,34,0,0,12,34
54635,60,31,8,7,14,46
54636,11,7,0,0,4,7
54637,75,40,18,4,13,62
54638,27,7,17,1,2,25
54639,40,3,26,5,6,34
54640,148,37,76,1,34,114
54641,218,147,30,0,41,177
54642,90,49,19,6,16,74
54643,41,9,18,2,12,29
54644,51,34,5,0,12,39
54645,47,29,8,1,9,38
54646,71,20,27,12,12,59
54647,80,41,15,5,19,61
54648,24,9,12,0,3,21
54649,2,1,0,0,1,1
54650,31,5,19,0,7,24
54651,52,8,32,0,12,40
54652,17,6,8,0,3,14
54653,78,32,32,3,11,67
54654,10,1,7,0,2,8
54655,30,17,3,1,9,21
54656,672,373,165,24,110,562
54657,47,16,17,3,11,36
54658,465,255,70,41,99,366
54659,29,6,9,3,11,18
54660,102,38,23,20,21,81
54661,260,20,189,2,49,211
54662,97,55,18,1,23,74
54663,38,23,7,1,7,31
54664,43,16,15,0,12,31
54665,221,90,41,38,52,169
54666,45,24,11,0,10,35
54667,45,15,13,5,12,33
54668,32,21,2,0,9,23
54669,15,3,5,3,4,11
54670,53,24,18,0,11,42
54671,101,39,24,24,14,87
54672,97,59,22,11,5,92
54673,177,22,93,24,38,139
54674,32,29,0,0,3,29
54675,37,19,9,1,8,29
54676,10,2,3,2,3,7
54677,25,11,8,1,5,20
54678,6,3,0,0,3,3
54679,9,4,0,1,4,5
54680,343,96,166,5,76,267
54681,66,29,22,2,13,53
54682,100,66,1,12,21,79
54683,306,69,159,6,72,234
54684,95,39,35,0,21,74
54685,37,19,8,1,9,28
54686,123,46,4,53,20,103
54687,49,30,12,0,7,42
54688,43,24,8,3,8,35
54689,55,27,11,1,16,39
54690,47,22,13,2,10,37
54691,65,31,20,1,13,52
54692,156,52,43,31,30,126
54693,71,14,35,7,15,56
54694,210,49,22,103,36,174
54695,159,79,23,26,31,128
54696,32,4,18,3,7,25
54697,12,3,8,0,1,11
54698,344,144,126,6,68,276
54699,72,29,23,0,20,52
54700,156,78,41,6,31,125
54701,565,402,43,1,119,446
54702,32,21,9,0,2,30
54703,37,15,19,1,2,35
54704,25,2,19,1,3,22
54705,38,8,21,1,8,30
54706,71,39,15,0,17,54
54707,74,56,2,0,16,58
54708,8,1,7,0,0,8
54709,44,8,21,0,15,29
54710,109,36,44,1,28,81
54711,64,5,44,0,15,49
54712,54,25,18,1,10,44
54713,39,21,7,3,8,31
54714,23,16,1,0,6,17
54715,117,51,33,0,33,84
54716,75,45,12,3,15,60
54717,99,46,14,19,20,79
54718,319,141,119,5,54,265
54719,60,20,17,13,10,50
54720,31,5,23,1,2,29
54721,23,2,15,0,6,17
54722,59,40,13,3,3,56
54723,32,21,9,0,2,30
54724,135,91,19,1,24,111
54725,11,4,3,1,3,8
54726,63,31,12,4,16,47
54727,134,49,53,0,32,102
54728,23,12,8,0,3,20
54729,56,35,13,0,8,48
54730,49,38,1,0,10,39
54731,4,1,1,1,1,3
54732,31,4,16,1,10,21
54733,27,21,2,0,4,23
54734,49,18,21,1,9,40
54735,14,2,8,3,1,13
54736,8,7,1,0,0,8
54737,39,23,8,0,8,31
54738,32,11,14,2,5,27
54739,75,9,42,5,19,56
54740,17,4,7,0,6,11
54741,378,189,111,2,76,302
54742,95,54,27,10,4,91
54743,141,60,29,21,31,110
54744,139,38,43,22,36,103
54745,56,24,19,1,12,44
54746,60,41,5,1,13,47
54747,61,26,19,2,14,47
54748,293,146,86,12,49,244
54749,17,4,11,0,2,15
54750,31,10,11,2,8,23
54751,100,35,34,11,20,80
54752,45,14,20,0,11,34
54753,68,29,13,10,16,52
54754,248,169,32,3,44,204
54755,15,10,0,0,5,10
54756,21,5,8,0,8,13
54757,36,5,23,0,8,28
54758,57,29,14,3,11,46
54759,55,18,27,0,10,45
54760,68,31,11,6,20,48
54761,31,20,3,0,8,23
54762,48,32,7,3,6,42
54763,692,394,161,23,114,578
54764,445,211,142,11,81,364
54765,58,30,15,0,13,45
54766,28,6,10,5,7,21
54767,76,39,16,2,19,57
54768,58,28,6,9,15,43
54769,39,8,21,2,8,31
54770,41,20,13,2,6,35
54771,157,8,91,27,31,126
54772,594,355,115,16,108,486
54773,31,13,10,0,8,23
54774,40,21,3,5,11,29
54775,52,36,6,2,8,44
54776,682,381,164,23,114,568
54777,46,18,20,0,8,38
54778,140,55,44,9,32,108
54779,122,65,10,23,24,98
54780,5,1,2,0,2,3
54781,53,17,27,1,8,45
54782,38,19,5,4,10,28
54783,162,118,18,0,26,136
54784,32,21,9,0,2,30
54785,33,14,10,0,9,24
54786,26,14,4,4,4,22
54787,82,19,42,1,20,62
54788,103,55,29,1,18,85
54789,4,2,1,1,0,4
54790,77,26,31,5,15,62
54791,78,25,33,7,13,65
54792,5,0,5,0,0,5
54793,85,41,18,11,15,70
54794,37,22,6,1,8,29
54795,19,4,7,3,5,14
54796,8,1,6,0,1,7
54797,16,5,5,0,6,10
54798,14,3,8,0,3,11
54799,23,9,7,2,5,18
54800,62,20,35,0,7,55
54801,46,18,20,0,8,38
54802,47,5,18,12,12,35
54803,168,59,47,26,36,132
54804,54,30,11,8,5,49
54805,75,27,32,0,16,59
54806,94,55,20,0,19,75
54807,81,24,10,32,15,66
54808,112,6,59,24,23,89
54809,120,58,22,17,23,97
54810,17,7,6,0,4,13
54811,35,13,8,2,12,23
54812,224,169,11,0,44,180
54813,4,0,2,0,2,2
54814,42,33,4,0,5,37
54815,69,24,29,6,10,59
54816,16,5,11,0,0,16
54817,4,1,2,0,1,3
54818,3,1,0,0,2,1
54819,220,149,30,0,41,179
54820,363,199,91,15,58,305
54821,55,34,9,0,12,43
54822,101,23,47,4,27,74
54823,75,38,25,0,12,63
54824,95,59,12,1,23,72
54825,41,13,20,3,5,36
54826,28,2,12,7,7,21
54827,62,39,12,1,10,52
54828,37,11,13,1,12,25
54829,33,9,18,0,6,27
54830,32,21,9,0,2,30
54831,38,17,12,2,7,31
54832,0,0,0,0,0,0
54833,53,32,14,4,3,50
54834,11,7,2,1,1,10
54835,12,3,6,0,3,9
54836,117,41,40,12,24,93
54837,516,260,97,49,110,406
54838,13,8,2,2,1,12
54839,43,19,8,0,16,27
54840,133,99,7,2,25,108
54841,4,0,3,1,0,4
54842,78,60,6,1,11,67
54843,10,2,8,0,0,10
54844,87,40,26,2,19,68
54845,243,48,151,1,43,200
54846,2,2,0,0,0,2
54847,22,17,0,0,5,17
54848,21,2,17,0,2,19
54849,9,4,2,0,3,6
54850,37,18,8,1,10,27
54851,20,7,4,2,7,13
54852,224,132,18,26,48,176
54853,17,5,6,1,5,12
54854,91,52,16,1,22,69
54855,3,0,3,0,0,3
54856,102,47,14,25,16,86
54857,35,24,3,0,8,27
54858,82,38,25,2,17,65
54859,11,8,1,1,1,10
54860,75,48,8,3,16,59
54861,23,10,7,2,4,19
54862,1064,391,425,46,202,862
54863,157,122,5,6,24,133
54864,63,33,19,2,9,54
54865,46,18,20,0,8,38
54866,14,4,4,3,3,11
54867,366,162,128,6,70,296
54868,69,17,37,1,14,55
54869,109,37,27,25,20,89
54870,35,12,16,0,7,28
54871,40,13,13,6,8,32
54872,76,39,13,9,15,61
54873,119,59,13,18,29,90
54874,66,31,17,0,18,48
54875,184,102,33,1,48,136
54876,163,117,21,0,25,138
54877,44,19,14,3,8,36
54878,10,1,7,0,2,8
54879,46,18,20,0,8,38
54880,111,24,41,26,20,91
54881,117,39,44,7,27,90
54882,53,9,33,3,8,45
54883,44,19,17,1,7,37
54884,177,101,31,0,45,132
54885,159,58,50,23,28,131
54886,31,14,7,1,9,22
54887,6,3,0,2,1,5
54888,41,5,6,20,10,31
54889,38,7,15,8,8,30
54890,158,4,127,0,27,131
54891,140,85,21,4,30,110
54892,119,50,28,14,27,92
54893,62,14,33,0,15,47
54894,24,8,12,1,3,21
54895,15,9,1,0,5,10
54896,93,58,11,2,22,71
54897,30,13,7,0,10,20
54898,151,87,34,16,14,137
54899,75,45,17,0,13,62
54900,157,46,54,23,34,123
54901,116,71,22,0,23,93
54902,10,1,8,1,0,10
54903,50,16,23,4,7,43
54904,16,10,1,2,3,13
54905,42,24,5,7,6,36
54906,30,14,5,4,7,23
54907,88,37,26,3,22,66
54908,119,53,23,22,21,98
54909,97,41,34,3,19,78
54910,83,54,11,4,14,69
54911,13,0,9,0,4,9
54912,471,200,119,46,106,365
54913,129,70,36,13,10,119
54914,64,22,27,1,14,50
54915,61,32,14,1,14,47
54916,90,48,16,3,23,67
54917,67,23,23,5,16,51
54918,33,19,7,1,6,27
54919,67,28,27,4,8,59
54920,63,14,28,6,15,48
54921,67,19,31,4,13,54
54922,17,11,2,0,4,13
54923,26,19,3,1,3,23
54924,39,22,14,0,3,36
54925,71,43,20,1,7,64
54926,111,84,7,0,20,91
54927,49,27,11,0,11,38
54928,32,21,9,0,2,30
54929,30,5,20,3,2,28
54930,24,10,11,0,3,21
54931,19,5,9,3,2,17
54932,134,104,8,0,22,112
54933,173,72,35,25,41,132
54934,46,18,20,0,8,38
54935,271,63,67,87,54,217
54936,14,3,10,0,1,13
54937,58,35,8,0,15,43
54938,51,15,22,0,14,37
54939,48,10,29,0,9,39
54940,272,76,137,4,55,217
54941,10,3,7,0,0,10
54942,52,31,10,4,7,45
54943,6,2,3,0,1,5
54944,45,15,15,3,12,33
54945,106,40,28,15,23,83
54946,232,61,124,7,40,192
54947,69,26,20,8,15,54
54948,357,259,19,2,77,280
54949,5,2,1,1,1,4
54950,260,120,91,0,49,211
54951,38,17,5,6,10,28
54952,97,46,15,21,15,82
54953,121,83,13,2,23,98
54954,3,1,1,0,1,2
54955,132,69,13,22,28,104
54956,64,17,34,3,10,54
54957,52,23,17,6,6,46
54958,178,101,32,0,45,133
54959,472,224,97,47,104,368
54960,32,21,9,0,2,30
54961,77,28,29,4,16,61
54962,130,59,44,3,24,106
54963,6,0,4,0,2,4
54964,43,28,7,1,7,36
54965,35,18,10,0,7,28
54966,548,395,40,1,112,436
54967,49,10,30,0,9,40
54968,63,38,14,0,11,52
54969,224,139,40,3,42,182
54970,33,3,23,0,7,26
54971,98,60,8,8,22,76
54972,76,43,11,0,22,54
54973,139,58,40,15,26,113
54974,213,117,32,23,41,172
54975,12,5,4,0,3,9
54976,94,58,11,2,23,71
54977,24,10,7,1,6,18
54978,42,8,20,2,12,30
54979,20,13,6,1,0,20
54980,8,5,0,1,2,6
54981,133,27,48,30,28,105
54982,382,192,97,22,71,311
54983,2,0,1,0,1,1
54984,109,65,18,7,19,90
54985,19,0,16,1,2,17
54986,36,20,8,0,8,28
54987,121,76,26,0,19,102
54988,11,7,2,0,2,9
54989,105,42,35,6,22,83
54990,77,48,8,1,20,57
54991,1,1,0,0,0,1
54992,116,37,56,0,23,93
54993,13,1,10,0,2,11
54994,213,115,62,0,36,177
54995,86,44,28,3,11,75
54996,423,312,21,0,90,333
54997,84,13,42,8,21,63
54998,78,24,17,22,15,63
54999,126,58,33,11,24,102
55000,30,8,10,8,4,26
55001,117,55,32,0,30,87
55002,30,7,14,2,7,23
55003,64,5,44,0,15,49
55004,127,64,15,18,30,97
55005,62,11,40,1,10,52
55006,14,3,7,3,1,13
55007,82,79,0,3,0,82
55008,43,33,8,2,0,43
55009,39,18,8,0,13,26
55010,42,31,0,0,11,31
55011,95,53,20,7,15,80
55012,32,21,9,0,2,30
55013,30,0,24,0,6,24
55014,229,99,15,76,39,190
55015,47,17,18,2,10,37
55016,39,29,5,1,4,35
55017,68,46,8,4,10,58
55018,4,1,2,0,1,3
55019,52,21,19,0,12,40
55020,179,112,53,1,13,166
55021,90,42,27,5,16,74
55022,36,27,0,2,7,29
55023,30,4,15,1,10,20
55024,44,17,23,0,4,40
55025,252,185,16,0,51,201
55026,43,27,8,0,8,35
55027,156,72,30,17,37,119
55028,82,25,34,8,15,67
55029,77,43,19,0,15,62
55030,46,18,20,0,8,38
55031,139,68,41,2,28,111
55032,109,59,24,4,22,87
55033,86,38,31,1,16,70
55034,38,5,25,0,8,30
55035,89,47,20,9,13,76
55036,153,90,30,0,33,120
55037,381,166,133,11,71,310
55038,34,6,20,0,8,26
55039,260,128,63,16,53,207
55040,16,8,8,0,0,16
55041,5,4,1,0,0,5
55042,80,27,38,4,11,69
55043,76,40,12,8,16,60
55044,200,51,38,77,34,166
55045,255,62,129,7,57,198
55046,396,229,87,0,80,316
55047,66,36,12,0,18,48
55048,103,57,24,4,18,85
55049,177,132,3,1,41,136
55050,101,40,34,6,21,80
55051,356,272,20,0,64,292
55052,32,21,9,0,2,30
55053,32,21,9,0,2,30
55054,11,4,4,0,3,8
55055,26,20,2,1,3,23
55056,336,201,64,0,71,265
55057,63,24,30,1,8,55
55058,221,148,31,0,42,179
55059,10,0,9,0,1,9
55060,3,2,1,0,0,3
55061,402,196,116,13,77,325
55062,70,24,32,2,12,58
55063,129,93,17,0,19,110
55064,22,11,2,5,4,18
55065,140,115,6,0,19,121
55066,1,0,1,0,0,1
55067,31,19,5,1,6,25
55068,46,18,20,0,8,38
55069,36,6,22,0,8,28
55070,93,21,31,22,19,74
55071,47,5,28,5,9,38
55072,73,6,24,32,11,62
55073,62,13,43,0,6,56
55074,257,136,80,0,41,216
55075,200,108,31,22,39,161
55076,193,59,93,2,39,154
55077,200,79,37,33,51,149
55078,250,183,16,0,51,199
55079,36,12,9,6,9,27
55080,54,36,10,0,8,46
55081,34,13,15,1,5,29
55082,76,54,11,0,11,65
55083,31,17,11,1,2,29
55084,102,45,31,3,23,79
55085,178,46,29,75,28,150
55086,43,3,33,4,3,40
55087,111,81,6,2,22,89
55088,78,59,6,1,12,66
55089,233,57,127,7,42,191
55090,86,40,26,1,19,67
55091,47,20,9,5,13,34
55092,35,14,14,2,5,30
55093,618,343,153,24,98,520
55094,23,2,17,0,4,19
55095,107,57,30,3,17,90
55096,69,26,5,23,15,54
55097,32,21,9,0,2,30
55098,35,12,14,1,8,27
55099,21,9,8,0,4,17
55100,7,4,0,0,3,4
55101,32,21,9,0,2,30
55102,68,13,38,1,16,52
55103,6,6,0,0,0,6
55104,33,14,10,0,9,24
55105,51,11,31,0,9,42
55106,171,83,35,21,32,139
55107,51,27,9,2,13,38
55108,30,10,5,8,7,23
55109,6,3,3,0,0,6
55110,128,59,44,4,21,107
55111,102,48,21,2,31,71
55112,15,1,12,0,2,13
55113,227,133,22,25,47,180
55114,32,15,10,0,7,25
55115,35,8,15,4,8,27
55116,4,0,2,0,2,2
55117,532,299,115,17,101,431
55118,378,199,104,3,72,306
55119,12,1,9,1,1,11
55120,646,380,137,16,113,533
55121,84,43,26,4,11,73
55122,71,39,18,0,14,57
55123,124,66,14,14,30,94
55124,103,58,8,18,19,84
55125,17,9,2,0,6,11
55126,206,83,38,33,52,154
55127,23,4,16,0,3,20
55128,37,18,15,1,3,34
55129,136,51,27,23,35,101
55130,20,7,2,10,1,19
55131,59,23,20,3,13,46
55132,58,28,17,1,12,46
55133,35,17,13,0,5,30
55134,234,177,11,0,46,188
55135,23,1,13,1,8,15
55136,165,98,37,1,29,136
55137,25,15,6,1,3,22
55138,50,22,13,3,12,38
55139,29,11,12,0,6,23
55140,4,0,4,0,0,4
55141,15,3,7,3,2,13
55142,59,18,15,14,12,47
55143,428,120,193,14,101,327
55144,63,16,30,0,17,46
55145,50,26,10,3,11,39
55146,98,22,31,19,26,72
55147,21,5,13,1,2,19
55148,52,14,24,3,11,41
55149,187,100,24,25,38,149
55150,165,74,53,6,32,133
55151,28,14,4,4,6,22
55152,89,49,24,4,12,77
55153,158,60,52,21,25,133
55154,435,135,159,46,95,340
55155,38,9,16,6,7,31
55156,189,87,48,16,38,151
55157,37,10,16,4,7,30
55158,42,9,21,5,7,35
55159,21,8,9,0,4,17
55160,42,25,12,0,5,37
55161,47,33,4,0,10,37
55162,10,3,4,0,3,7
55163,280,93,127,14,46,234
55164,138,63,46,5,24,114
55165,219,120,51,0,48,171
55166,70,34,19,1,16,54
55167,38,19,8,1,10,28
55168,100,69,15,0,16,84
55169,238,71,116,4,47,191
55170,137,72,34,0,31,106
55171,22,14,3,0,5,17
55172,6,4,0,2,0,6
55173,71,19,34,5,13,58
55174,95,25,54,2,14,81
55175,12,4,2,2,4,8
55176,42,18,12,6,6,36
55177,291,140,97,3,51,240
55178,157,75,49,6,27,130
55179,68,8,32,8,20,48
55180,40,10,15,3,12,28
55181,51,19,12,7,13,38
55182,71,13,45,3,10,61
55183,44,23,2,11,8,36
55184,38,8,21,0,9,29
55185,52,1,18,25,8,44
55186,0,0,0,0,0,0
55187,75,30,29,1,15,60
55188,33,11,14,3,5,28
55189,83,38,24,0,21,62
55190,83,56,11,5,11,72
55191,39,9,19,0,11,28
55192,51,42,1,0,8,43
55193,32,21,9,0,2,30
55194,36,4,24,0,8,28
55195,88,36,26,4,22,66
55196,3,0,1,1,1,2
55197,26,8,12,0,6,20
55198,23,9,6,4,4,19
55199,49,17,22,0,10,39
55200,109,36,43,11,19,90
55201,83,19,43,1,20,63
55202,32,21,9,0,2,30
55203,4,1,3,0,0,4
55204,149,62,32,21,34,115
55205,61,31,10,0,20,41
55206,115,70,23,2,20,95
55207,41,14,17,4,6,35
55208,89,63,15,1,10,79
55209,28,10,11,1,6,22
55210,34,24,0,2,8,26
55211,200,48,31,87,34,166
55212,139,49,61,0,29,110
55213,77,35,22,3,17,60
55214,27,17,7,1,2,25
55215,47,23,20,0,4,43
55216,43,27,8,0,8,35
55217,161,122,9,3,27,134
55218,34,18,11,0,5,29
55219,66,32,23,2,9,57
55220,34,13,12,0,9,25
55221,271,164,43,0,64,207
55222,28,17,5,0,6,22
55223,63,15,22,3,23,40
55224,128,60,46,1,21,107
55225,242,56,25,121,40,202
55226,7,3,2,1,1,6
55227,14,5,5,0,4,10
55228,83,51,5,12,15,68
55229,73,23,24,14,12,61
55230,101,51,28,2,20,81
55231,25,11,12,1,1,24
55232,446,328,20,0,98,348
55233,187,114,39,19,15,172
55234,84,41,25,2,16,68
55235,16,8,5,0,3,13
55236,31,7,16,1,7,24
55237,25,4,17,0,4,21
55238,70,18,27,11,14,56
55239,186,120,12,13,41,145
55240,34,16,10,2,6,28
55241,65,12,40,0,13,52
55242,128,58,45,3,22,106
55243,80,18,47,0,15,65
55244,52,0,41,2,9,43
55245,147,36,76,1,34,113
55246,51,16,25,1,9,42
55247,654,385,142,16,111,543
55248,36,29,2,1,4,32
55249,133,89,13,4,27,106
55250,59,24,21,5,9,50
55251,33,10,6,9,8,25
55252,48,30,10,0,8,40
55253,67,22,26,7,12,55
55254,32,19,8,1,4,28
55255,630,369,135,19,107,523
55256,74,60,4,0,10,64
55257,105,41,36,6,22,83
55258,117,37,48,7,25,92
55259,9,3,3,1,2,7
55260,290,117,111,16,46,244
55261,131,94,6,2,29,102
55262,19,7,9,0,3,16
55263,134,56,29,21,28,106
55264,52,17,15,5,15,37
55265,80,37,5,16,22,58
55266,197,53,37,70,37,160
55267,94,75,3,0,16,78
55268,33,9,16,0,8,25
55269,69,18,31,2,18,51
55270,125,28,59,15,23,102
55271,37,20,10,1,6,31
55272,11,5,5,0,1,10
55273,53,37,9,1,6,47
55274,87,21,48,3,15,72
55275,102,47,35,4,16,86
55276,197,77,36,33,51,146
55277,46,12,25,0,9,37
55278,89,24,45,7,13,76
55279,21,18,0,0,3,18
55280,10,4,4,0,2,8
55281,467,254,105,15,93,374
55282,46,18,20,0,8,38
55283,107,34,31,15,27,80
55284,551,319,112,18,102,449
55285,35,15,10,3,7,28
55286,19,6,6,4,3,16
55287,32,21,9,0,2,30
55288,353,204,73,0,76,277
55289,21,1,13,1,6,15
55290,18,6,4,1,7,11
55291,67,13,41,0,13,54
55292,66,46,9,0,11,55
55293,67,35,10,7,15,52
55294,473,124,202,37,110,363
55295,61,43,9,0,9,52
55296,58,36,14,0,8,50
55297,26,15,6,1,4,22
55298,35,19,4,3,9,26
55299,80,35,20,5,20,60
55300,30,21,2,2,5,25
55301,48,18,11,4,15,33
55302,212,84,25,65,38,174
55303,38,17,16,0,5,33
55304,64,23,32,1,8,56
55305,12,2,9,0,1,11
55306,91,44,31,3,13,78
55307,55,17,27,0,11,44
55308,55,17,22,2,14,41
55309,123,66,37,1,19,104
55310,23,11,2,7,3,20
55311,100,83,3,2,12,88
55312,388,224,83,16,65,323
55313,235,54,124,3,54,181
55314,32,21,9,0,2,30
55315,74,26,23,11,14,60
55316,350,186,92,15,57,293
55317,28,10,11,1,6,22
55318,50,5,37,1,7,43
55319,16,9,6,0,1,15
55320,16,7,5,0,4,12
55321,23,16,3,1,3,20
55322,39,23,8,0,8,31
55323,541,257,126,42,116,425
55324,47,33,4,0,10,37
55325,653,374,154,17,108,545
55326,20,11,8,0,1,19
55327,448,222,116,15,95,353
55328,74,38,25,0,11,63
55329,148,61,33,19,35,113
55330,52,10,30,2,10,42
55331,90,33,43,1,13,77
55332,74,54,8,4,8,66
55333,148,72,28,21,27,121
55334,22,9,5,2,6,16
55335,110,27,31,29,23,87
55336,12,4,5,0,3,9
55337,54,16,25,0,13,41
55338,79,61,3,0,15,64
55339,95,70,7,1,17,78
55340,15,8,3,2,2,13
55341,32,3,19,0,10,22
55342,47,32,1,0,14,33
55343,90,51,18,3,18,72
55344,47,33,4,0,10,37
55345,72,11,48,0,13,59
55346,54,30,13,2,9,45
55347,78,32,31,5,10,68
55348,119,79,18,1,21,98
55349,10,5,4,0,1,9
55350,406,119,184,10,93,313
55351,101,68,1,11,21,80
55352,40,7,14,8,11,29
55353,96,53,24,4,15,81
55354,165,83,48,1,33,132
55355,61,17,28,2,14,47
55356,27,17,7,1,2,25
55357,37,16,13,1,7,30
55358,37,27,1,0,9,28
55359,38,1,31,0,6,32
55360,39,13,19,2,5,34
55361,302,38,208,2,54,248
55362,110,85,3,0,22,88
55363,388,189,111,14,74,314
55364,7,0,4,0,3,4
55365,78,33,30,0,15,63
55366,75,25,36,1,13,62
55367,123,46,33,15,29,94
55368,15,8,3,2,2,13
55369,516,372,34,1,109,407
55370,28,17,3,0,8,20
55371,7,3,4,0,0,7
55372,245,185,15,0,45,200
55373,228,153,34,0,41,187
55374,58,22,18,6,12,46
55375,5,2,3,0,0,5
55376,116,36,42,13,25,91
55377,105,67,11,4,23,82
55378,185,142,17,1,25,160
55379,50,10,31,0,9,41
55380,37,27,1,2,7,30
55381,49,10,28,1,10,39
55382,15,1,12,0,2,13
55383,55,33,16,0,6,49
55384,88,62,17,0,9,79
55385,132,86,18,3,25,107
55386,483,247,88,44,104,379
55387,71,7,46,5,13,58
55388,54,33,14,0,7,47
55389,47,6,34,0,7,40
55390,471,221,152,13,85,386
55391,9,4,3,1,1,8
55392,10,7,1,0,2,8
55393,61,40,13,0,8,53
55394,46,18,19,1,8,38
55395,37,27,1,2,7,30
55396,65,44,9,0,12,53
55397,32,21,9,0,2,30
55398,76,15,32,12,17,59
55399,2,1,1,0,0,2
55400,42,17,12,4,9,33
55401,280,95,126,15,44,236
55402,187,71,62,7,47,140
55403,59,14,39,0,6,53
55404,218,147,30,0,41,177
55405,37,19,9,0,9,28
55406,66,30,14,9,13,53
55407,32,21,9,0,2,30
55408,60,41,5,1,13,47
55409,80,60,1,0,19,61
55410,60,44,3,3,10,50
55411,91,41,27,3,20,71
55412,20,2,10,1,7,13
55413,23,10,10,1,2,21
55414,193,40,66,46,41,152
55415,43,16,22,1,4,39
55416,57,5,37,1,14,43
55417,50,9,29,2,10,40
55418,359,115,155,17,72,287
55419,7,2,3,0,2,5
55420,117,40,36,16,25,92
55421,27,10,10,0,7,20
55422,4,2,0,1,1,3
55423,11,4,3,2,2,9
55424,106,79,13,3,11,95
55425,186,75,43,22,46,140
55426,42,25,7,1,9,33
55427,31,4,24,0,3,28
55428,69,48,12,0,9,60
55429,10,3,4,0,3,7
55430,87,40,19,11,17,70
55431,117,43,52,5,17,100
55432,79,30,26,3,20,59
55433,41,28,4,1,8,33
55434,42,8,17,4,13,29
55435,63,15,34,2,12,51
55436,87,11,42,17,17,70
55437,88,32,35,0,21,67
55438,421,200,103,32,86,335
55439,236,103,74,16,43,193
55440,125,51,32,18,24,101
55441,101,31,41,10,19,82
55442,98,52,13,17,16,82
55443,212,114,47,0,51,161
55444,64,17,22,6,19,45
55445,57,27,13,4,13,44
55446,55,20,16,5,14,41
55447,78,39,20,4,15,63
55448,32,21,9,0,2,30
55449,24,3,19,0,2,22
55450,3,3,0,0,0,3
55451,64,32,7,5,20,44
55452,32,21,9,0,2,30
55453,76,43,20,0,13,63
55454,6,4,0,2,0,6
55455,145,78,14,23,30,115
55456,456,216,100,43,97,359
55457,27,0,15,0,12,15
55458,22,0,16,0,6,16
55459,67,45,4,2,16,51
55460,116,66,29,10,11,105
55461,115,64,16,8,27,88
55462,407,191,117,13,86,321
55463,81,38,24,0,19,62
55464,197,48,103,13,33,164
55465,31,0,11,15,5,26
55466,18,2,12,1,3,15
55467,39,26,3,3,7,32
55468,121,64,38,9,10,111
55469,354,207,72,0,75,279
55470,37,18,15,1,3,34
55471,37,7,21,2,7,30
55472,40,4,30,0,6,34
55473,33,14,10,0,9,24
55474,37,15,14,0,8,29
55475,16,5,8,2,1,15
55476,2,0,1,0,1,1
55477,51,10,27,3,11,40
55478,112,39,43,11,19,93
55479,15,3,7,3,2,13
55480,8,3,2,0,3,5
55481,281,107,115,7,52,229
55482,80,16,9,36,19,61
55483,9,6,0,0,3,6
55484,46,33,9,4,0,46
55485,46,0,37,0,9,37
55486,117,64,26,6,21,96
55487,105,47,42,1,15,90
55488,82,45,20,1,16,66
55489,38,22,11,0,5,33
55490,71,41,15,0,15,56
55491,107,65,17,2,23,84
55492,68,36,13,0,19,49
55493,68,36,17,0,15,53
55494,78,47,19,0,12,66
55495,168,30,104,1,33,135
55496,126,96,5,7,18,108
55497,56,3,40,1,12,44
55498,181,75,41,21,44,137
55499,41,15,20,0,6,35
55500,26,5,14,1,6,20
55501,275,141,93,0,41,234
55502,40,30,7,3,0,40
55503,58,32,11,0,15,43
55504,70,41,16,0,13,57
55505,152,80,21,20,31,121
55506,33,10,15,0,8,25
55507,57,2,39,0,16,41
55508,9,4,5,0,0,9
55509,72,33,15,9,15,57
55510,21,7,3,6,5,16
55511,3,1,1,0,1,2
55512,5,1,3,0,1,4
55513,27,15,5,4,3,24
55514,17,6,7,0,4,13
55515,46,18,20,0,8,38
55516,65,49,11,0,5,60
55517,54,27,13,5,9,45
55518,95,53,26,0,16,79
55519,123,54,18,18,33,90
55520,20,10,5,3,2,18
55521,129,73,35,2,19,110
55522,48,20,12,1,15,33
55523,13,1,6,0,6,7
55524,223,68,107,12,36,187
55525,19,6,10,0,3,16
55526,50,20,15,4,11,39
55527,130,67,12,23,28,102
55528,8,5,0,0,3,5
55529,83,23,32,0,28,55
55530,50,33,9,0,8,42
55531,145,90,29,3,23,122
55532,83,23,35,7,18,65
55533,2,0,1,0,1,1
55534,92,47,13,2,30,62
55535,43,5,29,0,9,34
55536,135,47,47,18,23,112
55537,57,42,5,1,9,48
55538,37,17,14,0,6,31
55539,60,44,12,0,4,56
55540,213,92,87,5,29,184
55541,36,21,3,0,12,24
55542,42,9,13,9,11,31
55543,288,140,96,3,49,239
55544,88,20,50,0,18,70
55545,0,0,0,0,0,0
55546,10,1,6,0,3,7
55547,407,304,23,0,80,327
55548,37,26,5,0,6,31
55549,381,96,154,47,84,297
55550,167,83,30,25,29,138
55551,11,4,4,0,3,8
55552,122,2,101,0,19,103
55553,20,3,7,4,6,14
55554,10,8,0,0,2,8
55555,27,10,10,1,6,21
55556,325,137,119,10,59,266
55557,92,47,25,1,19,73
55558,270,168,38,12,52,218
55559,50,5,37,0,8,42
55560,70,35,7,12,16,54
55561,35,7,15,1,12,23
55562,59,7,34,2,16,43
55563,166,73,53,3,37,129
55564,31,15,7,3,6,25
55565,7,4,3,0,0,7
55566,77,24,30,7,16,61
55567,110,42,34,7,27,83
55568,39,11,20,0,8,31
55569,39,14,16,0,9,30
55570,448,254,83,24,87,361
55571,33,23,2,0,8,25
55572,108,72,15,1,20,88
55573,142,109,6,0,27,115
55574,108,34,61,0,13,95
55575,11,3,6,1,1,10
55576,18,8,4,1,5,13
55577,671,391,144,17,119,552
55578,56,29,4,3,20,36
55579,133,103,11,0,19,114
55580,149,64,30,22,33,116
55581,38,3,29,1,5,33
55582,30,14,14,0,2,28
55583,73,39,7,6,21,52
55584,265,33,179,2,51,214
55585,34,17,6,3,8,26
55586,41,23,9,2,7,34
55587,32,13,12,0,7,25
55588,25,14,7,0,4,21
55589,111,34,32,21,24,87
55590,207,145,46,2,14,193
55591,46,18,20,0,8,38
55592,511,270,86,49,106,405
55593,33,1,25,1,6,27
55594,109,45,36,4,24,85
55595,24,10,11,0,3,21
55596,63,31,23,1,8,55
55597,116,52,31,8,25,91
55598,12,7,3,0,2,10
55599,81,25,34,9,13,68
55600,129,66,12,23,28,101
55601,107,89,3,3,12,95
55602,20,5,11,0,4,16
55603,147,109,6,0,32,115
55604,70,35,19,4,12,58
55605,71,5,49,1,16,55
55606,42,27,6,4,5,37
55607,188,132,12,7,37,151
55608,67,19,29,4,15,52
55609,24,10,3,7,4,20
55610,156,59,40,21,36,120
55611,30,4,17,3,6,24
55612,39,16,11,2,10,29
55613,77,28,24,9,16,61
55614,20,2,8,6,4,16
55615,46,18,20,0,8,38
55616,23,6,11,1,5,18
55617,33,16,10,0,7,26
55618,146,96,27,0,23,123
55619,670,369,166,24,111,559
55620,80,55,8,2,15,65
55621,55,33,11,0,11,44
55622,205,103,59,0,43,162
55623,8,1,5,0,2,6
55624,65,14,33,4,14,51
55625,45,27,8,0,10,35
55626,10,7,1,0,2,8
55627,54,43,1,0,10,44
55628,68,24,22,9,13,55
55629,48,10,29,0,9,39
55630,66,33,16,3,14,52
55631,149,67,52,1,29,120
55632,472,239,88,42,103,369
55633,25,4,17,0,4,21
55634,564,395,50,1,118,446
55635,126,89,9,2,26,100
55636,138,82,20,2,34,104
55637,133,61,41,4,27,106
55638,193,76,34,33,50,143
55639,29,13,7,0,9,20
55640,163,85,36,7,35,128
55641,14,6,5,0,3,11
55642,79,40,13,6,20,59
55643,104,49,23,3,29,75
55644,637,354,159,21,103,534
55645,182,55,92,0,35,147
55646,171,85,34,21,31,140
55647,358,168,100,15,75,283
55648,29,4,22,0,3,26
55649,91,26,38,9,18,73
55650,302,145,86,12,59,243
55651,63,31,14,5,13,50
55652,33,19,6,0,8,25
55653,46,18,20,0,8,38
55654,34,10,18,4,2,32
55655,12,7,2,0,3,9
55656,21,5,10,0,6,15
55657,61,26,13,9,13,48
55658,60,23,12,10,15,45
55659,45,26,14,0,5,40
55660,16,5,4,0,7,9
55661,174,48,58,33,35,139
55662,120,58,37,4,21,99
55663,20,10,6,2,2,18
55664,40,3,30,1,6,34
55665,25,4,17,0,4,21
55666,69,38,16,0,15,54
55667,107,83,3,0,21,86
55668,9,1,6,1,1,8
55669,4,0,3,0,1,3
55670,47,4,35,0,8,39
55671,266,84,126,13,43,223
55672,49,32,6,2,9,40
55673,28,2,11,8,7,21
55674,110,49,32,0,29,81
55675,47,14,16,1,16,31
55676,51,33,3,0,15,36
55677,9,2,6,0,1,8
55678,82,21,31,10,20,62
55679,23,10,9,0,4,19
55680,288,44,187,4,53,235
55681,24,3,12,2,7,17
55682,86,61,7,0,18,68
55683,101,45,37,4,15,86
55684,14,1,3,7,3,11
55685,32,21,9,0,2,30
55686,61,25,23,2,11,50
55687,39,19,9,0,11,28
55688,16,6,6,1,3,13
55689,47,28,11,0,8,39
55690,181,71,47,22,41,140
55691,38,24,4,5,5,33
55692,83,30,34,1,18,65
55693,30,9,11,1,9,21
55694,40,9,16,7,8,32
55695,64,21,11,21,11,53
55696,7,2,2,0,3,4
55697,102,80,3,0,19,83
55698,19,5,11,0,3,16
55699,133,55,34,19,25,108
55700,123,56,32,10,25,98
55701,58,28,13,0,17,41
55702,19,7,8,1,3,16
55703,16,11,3,0,2,14
55704,74,36,15,6,17,57
55705,63,32,9,7,15,48
55706,35,13,15,1,6,29
55707,438,107,184,46,101,337
55708,123,46,43,8,26,97
55709,42,19,16,0,7,35
55710,45,18,14,0,13,32
55711,52,34,5,2,11,41
55712,40,27,8,1,4,36
55713,137,92,26,0,19,118
55714,15,6,6,0,3,12
55715,5,2,0,1,2,3
55716,100,54,28,14,4,96
55717,54,11,8,24,11,43
55718,37,2,28,0,7,30
55719,88,37,22,12,17,71
55720,69,4,53,0,12,57
55721,122,47,49,12,14,108
55722,97,31,45,7,14,83
55723,47,24,16,0,7,40
55724,10,6,3,0,1,9
55725,28,1,21,0,6,22
55726,201,140,45,2,14,187
55727,30,13,13,0,4,26
55728,55,25,12,6,12,43
55729,72,29,24,3,16,56
55730,148,60,57,8,23,125
55731,54,28,14,3,9,45
55732,37,24,5,2,6,31
55733,55,40,2,0,13,42
55734,49,10,25,2,12,37
55735,19,3,13,0,3,16
55736,445,129,185,36,95,350
55737,47,33,4,0,10,37
55738,59,37,12,0,10,49
55739,55,4,40,0,11,44
55740,40,21,10,1,8,32
55741,35,14,15,2,4,31
55742,37,10,18,1,8,29
55743,74,50,7,0,17,57
55744,112,74,23,3,12,100
55745,82,38,29,0,15,67
55746,27,9,10,4,4,23
55747,79,45,10,9,15,64
55748,471,220,143,12,96,375
55749,53,12,23,0,18,35
55750,499,258,87,49,105,394
55751,12,2,5,0,5,7
55752,113,49,30,13,21,92
55753,81,40,21,3,17,64
55754,11,1,7,0,3,8
55755,126,43,25,23,35,91
55756,111,59,10,20,22,89
55757,455,158,154,46,97,358
55758,66,49,12,0,5,61
55759,94,34,18,11,31,63
55760,14,5,5,2,2,12
55761,85,52,17,4,12,73
55762,168,31,103,1,33,135
55763,266,119,75,26,46,220
55764,26,17,2,0,7,19
55765,45,8,20,4,13,32
55766,22,1,17,0,4,18
55767,409,236,87,16,70,339
55768,28,13,6,2,7,21
55769,27,6,10,4,7,20
55770,41,24,9,3,5,36
55771,159,71,52,5,31,128
55772,6,1,4,0,1,5
55773,10,4,3,0,3,7
55774,65,30,23,0,12,53
55775,16,8,5,0,3,13
55776,140,103,5,2,30,110
55777,61,20,24,3,14,47
55778,24,6,10,4,4,20
55779,56,16,17,7,16,40
55780,233,155,32,0,46,187
55781,77,10,43,5,19,58
55782,65,14,25,3,23,42
55783,49,42,1,0,6,43
55784,73,27,33,3,10,63
55785,47,12,21,0,14,33
55786,544,271,116,41,116,428
55787,580,402,53,1,124,456
55788,9,3,3,1,2,7
55789,29,6,12,4,7,22
55790,76,32,28,1,15,61
55791,72,42,13,4,13,59
55792,32,21,9,0,2,30
55793,160,63,67,4,26,134
55794,451,146,161,47,97,354
55795,78,46,18,0,14,64
55796,30,3,18,0,9,21
55797,95,23,30,25,17,78
55798,148,28,91,1,28,120
55799,428,202,106,34,86,342
55800,56,41,8,1,6,50
55801,22,0,19,1,2,20
55802,50,27,12,2,9,41
55803,44,14,13,7,10,34
55804,46,18,20,0,8,38
55805,32,21,9,0,2,30
55806,14,6,5,0,3,11
55807,53,27,10,7,9,44
55808,149,79,33,9,28,121
55809,13,6,2,0,5,8
55810,30,3,21,0,6,24
55811,45,20,9,7,9,36
55812,55,24,20,1,10,45
55813,61,31,16,1,13,48
55814,63,32,12,8,11,52
55815,191,87,51,13,40,151
55816,80,45,12,5,18,62
55817,71,42,7,8,14,57
55818,279,96,126,14,43,236
55819,24,3,17,0,4,20
55820,45,28,10,0,7,38
55821,156,66,54,7,29,127
55822,455,261,92,16,86,369
55823,126,48,42,8,28,98
55824,50,26,8,3,13,37
55825,63,13,38,0,12,51
55826,154,89,36,1,28,126
55827,66,36,16,3,11,55
55828,83,67,2,0,14,69
55829,139,3,116,0,20,119
55830,38,21,7,1,9,29
55831,130,40,35,22,33,97
55832,358,204,77,0,77,281
55833,7,4,0,0,3,4
55834,89,9,51,6,23,66
55835,9,4,1,0,4,5
55836,75,38,16,2,19,56
55837,55,33,10,0,12,43
55838,61,32,17,1,11,50
55839,0,0,0,0,0,0
55840,8,4,2,0,2,6
55841,32,21,9,0,2,30
55842,43,26,9,0,8,35
55843,61,36,12,2,11,50
55844,10,8,0,0,2,8
55845,6,1,4,0,1,5
55846,109,59,24,4,22,87
55847,46,18,20,0,8,38
55848,30,7,15,3,5,25
55849,589,408,52,1,128,461
55850,466,218,144,12,92,374
55851,29,7,15,1,6,23
55852,133,49,38,17,29,104
55853,13,9,3,0,1,12
55854,3,0,1,0,2,1
55855,433,129,196,13,95,338
55856,210,116,47,0,47,163
55857,46,10,5,21,10,36
55858,78,46,12,3,17,61
55859,15,0,11,0,4,11
55860,76,53,13,0,10,66
55861,8,5,0,0,3,5
55862,277,187,68,2,20,257
55863,497,251,92,51,103,394
55864,164,68,34,22,40,124
55865,141,66,44,11,20,121
55866,27,12,7,0,8,19
55867,43,23,9,0,11,32
55868,74,34,26,0,14,60
55869,63,27,25,0,11,52
55870,46,18,20,0,8,38
55871,58,28,18,0,12,46
55872,65,42,11,2,10,55
55873,249,62,98,33,56,193
55874,46,18,20,0,8,38
55875,25,9,4,8,4,21
55876,181,45,65,28,43,138
55877,201,89,54,20,38,163
55878,33,3,22,0,8,25
55879,32,21,9,0,2,30
55880,57,23,21,1,12,45
55881,120,55,34,2,29,91
55882,171,82,36,16,37,134
55883,166,110,25,1,30,136
55884,6,2,2,0,2,4
55885,119,42,41,12,24,95
55886,40,20,11,1,8,32
55887,24,12,7,0,5,19
55888,46,18,20,0,8,38
55889,96,50,28,1,17,79
55890,34,7,17,2,8,26
55891,43,24,14,0,5,38
55892,46,18,20,0,8,38
55893,68,28,30,1,9,59
55894,11,2,2,3,4,7
55895,211,139,23,0,49,162
55896,197,112,26,20,39,158
55897,48,13,24,0,11,37
55898,16,4,4,3,5,11
55899,629,363,145,17,104,525
55900,52,15,26,0,11,41
55901,28,15,5,0,8,20
55902,33,21,7,2,3,30
55903,190,99,35,22,34,156
55904,78,56,11,1,10,68
55905,85,49,19,0,17,68
55906,133,73,23,3,34,99
55907,176,106,37,17,16,160
55908,29,11,14,0,4,25
55909,112,61,9,20,22,90
55910,65,49,6,0,10,55
55911,32,18,6,1,7,25
55912,333,187,71,0,75,258
55913,46,18,20,0,8,38
55914,56,12,20,6,18,38
55915,33,12,7,6,8,25
55916,43,27,8,0,8,35
55917,67,33,15,2,17,50
55918,60,23,26,1,10,50
55919,27,13,11,1,2,25
55920,9,4,2,1,2,7
55921,45,25,17,0,3,42
55922,47,33,1,2,11,36
55923,75,37,22,3,13,62
55924,667,391,142,17,117,550
55925,27,10,10,0,7,20
55926,79,44,23,1,11,68
55927,53,27,9,8,9,44
55928,123,75,24,0,24,99
55929,10,8,1,0,1,9
55930,96,82,3,0,11,85
55931,11,0,7,2,2,9
55932,34,19,7,0,8,26
55933,30,17,4,8,1,29
55934,62,4,48,2,8,54
55935,29,15,6,4,4,25
55936,363,195,100,3,65,298
55937,94,52,24,4,14,80
55938,38,11,22,0,5,33
55939,23,3,17,0,3,20
55940,130,42,55,7,26,104
55941,69,39,20,4,6,63
55942,58,31,14,0,13,45
55943,98,24,28,19,27,71
55944,147,114,7,2,24,123
55945,106,55,10,16,25,81
55946,25,14,8,0,3,22
55947,25,13,5,4,3,22
55948,36,6,6,19,5,31
55949,16,10,1,5,0,16
55950,99,39,26,12,22,77
55951,50,38,9,3,0,50
55952,106,44,44,1,17,89
55953,90,31,41,1,17,73
55954,98,52,26,0,20,78
55955,53,24,18,0,11,42
55956,29,7,16,2,4,25
55957,46,18,20,0,8,38
55958,67,27,16,9,15,52
55959,49,14,18,4,13,36
55960,9,4,2,0,3,6
55961,236,117,47,25,47,189
55962,29,9,17,0,3,26
55963,35,15,10,0,10,25
55964,27,9,15,1,2,25
55965,10,0,9,0,1,9
55966,107,36,50,7,14,93
55967,94,73,1,0,20,74
55968,9,1,4,1,3,6
55969,149,96,3,16,34,115
55970,288,39,196,2,51,237
55971,387,201,110,4,72,315
55972,79,39,20,2,18,61
55973,68,38,18,2,10,58
55974,26,12,9,0,5,21
55975,5,4,1,0,0,5
55976,6,1,3,0,2,4
55977,40,24,9,0,7,33
55978,28,15,8,0,5,23
55979,23,4,14,1,4,19
55980,11,0,9,0,2,9
55981,97,62,6,6,23,74
55982,54,43,1,0,10,44
55983,73,30,20,1,22,51
55984,195,118,11,23,43,152
55985,11,1,8,1,1,10
55986,190,73,34,34,49,141
55987,0,0,0,0,0,0
55988,10,8,1,0,1,9
55989,101,26,48,3,24,77
55990,436,200,106,40,90,346
55991,23,0,20,0,3,20
55992,345,159,87,28,71,274
55993,35,15,10,0,10,25
55994,8,4,2,0,2,6
55995,12,0,10,0,2,10
55996,70,16,37,1,16,54
55997,382,191,97,13,81,301
55998,76,40,23,0,13,63
55999,92,25,47,7,13,79
56000,125,54,39,6,26,99
56001,403,185,134,11,73,330
56002,119,67,21,3,28,91
56003,7,1,3,1,2,5
56004,46,18,20,0,8,38
56005,27,6,10,3,8,19
56006,36,7,22,0,7,29
56007,217,90,68,20,39,178
56008,22,8,3,2,9,13
56009,32,20,0,6,6,26
56010,39,3,26,0,10,29
56011,81,41,24,0,16,65
56012,27,10,10,0,7,20
56013,61,29,16,4,12,49
56014,68,26,22,8,12,56
56015,97,48,16,2,31,66
56016,49,33,10,0,6,43
56017,12,4,5,0,3,9
56018,53,35,6,0,12,41
56019,87,16,45,6,20,67
56020,2,2,0,0,0,2
56021,9,0,8,0,1,8
56022,27,10,11,0,6,21
56023,10,3,7,0,0,10
56024,15,8,3,0,4,11
56025,159,108,26,0,25,134
56026,8,3,1,3,1,7
56027,189,38,51,61,39,150
56028,87,56,10,2,19,68
56029,24,9,11,1,3,21
56030,99,36,33,6,24,75
56031,47,3,30,3,11,36
56032,79,23,35,7,14,65
56033,168,86,22,27,33,135
56034,42,20,6,2,14,28
56035,7,3,4,0,0,7
56036,425,195,131,14,85,340
56037,23,5,11,3,4,19
56038,146,63,31,17,35,111
56039,139,84,31,0,24,115
56040,49,15,23,3,8,41
56041,105,66,22,4,13,92
56042,72,52,10,1,9,63
56043,77,47,18,1,11,66
56044,16,7,2,1,6,10
56045,15,1,13,0,1,14
56046,324,158,107,3,56,268
56047,100,50,17,12,21,79
56048,297,172,55,13,57,240
56049,144,89,27,0,28,116
56050,46,18,20,0,8,38
56051,13,8,3,1,1,12
56052,37,17,12,1,7,30
56053,23,9,11,0,3,20
56054,79,55,4,0,20,59
56055,46,18,20,0,8,38
56056,160,72,52,7,29,131
56057,208,114,43,14,37,171
56058,73,41,16,2,14,59
56059,89,18,43,9,19,70
56060,174,84,55,7,28,146
56061,560,393,47,1,119,441
56062,46,27,9,4,6,40
56063,54,15,22,5,12,42
56064,18,1,13,0,4,14
56065,43,28,1,0,14,29
56066,42,31,3,2,6,36
56067,105,67,11,4,23,82
56068,99,36,38,10,15,84
56069,33,11,10,6,6,27
56070,118,52,42,1,23,95
56071,18,0,11,5,2,16
56072,4,2,0,0,2,2
56073,563,309,122,13,119,444
56074,71,45,12,2,12,59
56075,31,4,16,0,11,20
56076,17,9,2,1,5,12
56077,70,48,7,1,14,56
56078,58,18,25,2,13,45
56079,30,15,12,2,1,29
56080,45,8,29,0,8,37
56081,81,1,62,0,18,63
56082,33,10,7,9,7,26
56083,8,2,4,0,2,6
56084,32,18,12,0,2,30
56085,49,33,5,2,9,40
56086,68,34,24,0,10,58
56087,146,92,28,0,26,120
56088,37,11,18,0,8,29
56089,70,38,20,0,12,58
56090,174,79,57,4,34,140
56091,21,8,11,1,1,20
56092,47,14,24,1,8,39
56093,146,36,76,1,33,113
56094,19,2,14,0,3,16
56095,62,43,8,4,7,55
56096,80,31,32,0,17,63
56097,523,276,98,42,107,416
56098,22,3,13,2,4,18
56099,128,50,33,10,35,93
56100,123,45,46,13,19,104
56101,24,11,8,1,4,20
56102,45,30,8,1,6,39
56103,53,18,21,6,8,45
56104,43,7,24,2,10,33
56105,29,9,8,9,3,26
56106,34,15,12,1,6,28
56107,43,17,9,6,11,32
56108,12,0,10,0,2,10
56109,61,14,41,0,6,55
56110,32,21,9,0,2,30
56111,30,20,4,0,6,24
56112,57,46,3,1,7,50
56113,76,23,30,10,13,63
56114,15,2,7,4,2,13
56115,51,11,26,1,13,38
56116,38,29,6,3,0,38
56117,60,29,23,2,6,54
56118,21,16,1,0,4,17
56119,18,5,5,2,6,12
56120,113,91,3,3,16,97
56121,46,18,20,0,8,38
56122,41,2,25,0,14,27
56123,83,22,38,6,17,66
56124,149,109,6,0,34,115
56125,623,367,134,15,107,516
56126,5,0,4,0,1,4
56127,112,39,40,11,22,90
56128,73,25,37,0,11,62
56129,182,64,80,0,38,144
56130,86,46,25,0,15,71
56131,46,18,20,0,8,38
56132,49,17,20,2,10,39
56133,57,25,13,8,11,46
56134,42,26,11,1,4,38
56135,32,21,9,0,2,30
56136,45,22,16,0,7,38
56137,6,0,5,0,1,5
56138,35,22,7,1,5,30
56139,27,8,14,0,5,22
56140,41,3,29,2,7,34
56141,100,70,19,1,10,90
56142,115,27,53,2,33,82
56143,26,13,2,5,6,20
56144,10,7,3,0,0,10
56145,33,17,11,0,5,28
56146,598,343,123,19,113,485
56147,20,4,15,0,1,19
56148,27,7,12,2,6,21
56149,14,10,2,1,1,13
56150,59,24,24,1,10,49
56151,385,275,23,0,87,298
56152,36,15,9,3,9,27
56153,176,135,16,1,24,152
56154,94,42,13,18,21,73
56155,208,109,35,30,34,174
56156,65,6,45,0,14,51
56157,59,28,21,2,8,51
56158,669,390,143,17,119,550
56159,39,23,8,0,8,31
56160,167,53,73,9,32,135
56161,69,30,27,0,12,57
56162,47,20,16,2,9,38
56163,86,21,47,3,15,71
56164,117,49,44,1,23,94
56165,116,70,23,0,23,93
56166,41,16,10,8,7,34
56167,57,34,14,0,9,48
56168,47,29,10,0,8,39
56169,44,11,19,0,14,30
56170,70,45,12,1,12,58
56171,382,218,85,0,79,303
56172,32,14,6,3,9,23
56173,289,32,199,4,54,235
56174,49,24,13,4,8,41
56175,21,9,4,1,7,14
56176,32,21,9,0,2,30
56177,50,22,20,3,5,45
56178,31,15,13,0,3,28
56179,119,54,38,4,23,96
56180,323,140,109,6,68,255
56181,235,94,14,83,44,191
56182,50,11,28,4,7,43
56183,25,22,1,2,0,25
56184,68,29,25,0,14,54
56185,129,53,24,26,26,103
56186,40,22,3,7,8,32
56187,214,60,112,5,37,177
56188,46,18,20,0,8,38
56189,60,33,9,0,18,42
56190,46,23,16,0,7,39
56191,19,2,10,0,7,12
56192,132,98,6,0,28,104
56193,47,40,2,0,5,42
56194,18,11,4,1,2,16
56195,32,21,9,0,2,30
56196,76,32,22,11,11,65
56197,70,24,19,7,20,50
56198,62,48,0,0,14,48
56199,10,5,4,0,1,9
56200,173,52,56,26,39,134
56201,205,68,81,15,41,164
56202,38,18,4,5,11,27
56203,39,13,17,1,8,31
56204,44,18,17,2,7,37
56205,314,76,177,4,57,257
56206,45,4,34,0,7,38
56207,14,0,11,0,3,11
56208,46,18,20,0,8,38
56209,8,4,1,0,3,5
56210,32,16,10,1,5,27
56211,26,16,5,1,4,22
56212,12,1,9,0,2,10
56213,70,16,29,11,14,56
56214,71,57,2,0,12,59
56215,26,2,20,0,4,22
56216,76,34,18,6,18,58
56217,124,54,19,18,33,91
56218,113,8,57,25,23,90
56219,63,39,13,1,10,53
56220,33,12,3,14,4,29
56221,2,0,1,0,1,1
56222,71,56,1,0,14,57
56223,129,45,28,24,32,97
56224,80,34,9,17,20,60
56225,32,21,9,0,2,30
56226,60,14,40,0,6,54
56227,141,60,43,9,29,112
56228,142,43,70,0,29,113
56229,28,10,11,1,6,22
56230,18,6,7,0,5,13
56231,20,9,7,1,3,17
56232,163,99,31,6,27,136
56233,179,79,28,28,44,135
56234,62,34,20,0,8,54
56235,77,46,16,0,15,62
56236,17,4,13,0,0,17
56237,102,43,35,7,17,85
56238,140,80,23,3,34,106
56239,1,0,1,0,0,1
56240,65,38,10,2,15,50
56241,76,5,53,1,17,59
56242,52,21,20,1,10,42
56243,11,3,6,0,2,9
56244,31,3,12,5,11,20
56245,1,0,1,0,0,1
56246,32,4,24,0,4,28
56247,15,1,12,0,2,13
56248,13,6,7,0,0,13
56249,13,10,1,0,2,11
56250,50,14,17,4,15,35
56251,88,45,24,2,17,71
56252,55,33,14,2,6,49
56253,413,194,118,13,88,325
56254,257,125,71,0,61,196
56255,92,35,22,14,21,71
56256,83,19,43,1,20,63
56257,57,6,41,1,9,48
56258,167,52,89,4,22,145
56259,24,2,17,0,5,19
56260,193,86,81,0,26,167
56261,22,10,8,0,4,18
56262,71,43,13,3,12,59
56263,400,183,134,11,72,328
56264,199,109,39,14,37,162
56265,4,1,2,1,0,4
56266,157,100,30,0,27,130
56267,91,29,46,0,16,75
56268,46,18,20,0,8,38
56269,69,30,29,0,10,59
56270,195,150,14,1,30,165
56271,17,6,7,1,3,14
56272,23,6,12,0,5,18
56273,23,13,6,0,4,19
56274,127,25,44,22,36,91
56275,9,4,1,2,2,7
56276,396,193,103,18,82,314
56277,42,14,19,3,6,36
56278,22,12,6,0,4,18
56279,28,5,11,10,2,26
56280,41,11,25,0,5,36
56281,51,23,17,5,6,45
56282,5,3,1,0,1,4
56283,106,50,16,23,17,89
56284,13,5,8,0,0,13
56285,97,31,39,10,17,80
56286,24,3,12,0,9,15
56287,25,6,16,0,3,22
56288,27,12,11,0,4,23
56289,173,47,56,35,35,138
56290,119,82,8,5,24,95
56291,32,21,9,0,2,30
56292,36,23,8,3,2,34
56293,30,13,10,3,4,26
56294,88,38,28,3,19,69
56295,48,19,21,0,8,40
56296,170,66,41,24,39,131
56297,99,47,18,16,18,81
56298,160,46,62,11,41,119
56299,322,160,105,3,54,268
56300,38,18,12,2,6,32
56301,9,2,5,0,2,7
56302,148,58,45,9,36,112
56303,51,23,16,3,9,42
56304,184,123,19,0,42,142
56305,25,14,7,0,4,21
56306,214,166,15,1,32,182
56307,94,34,36,10,14,80
56308,21,1,3,13,4,17
56309,62,34,4,12,12,50
56310,129,89,21,0,19,110
56311,64,35,11,5,13,51
56312,49,18,25,0,6,43
56313,10,9,0,0,1,9
56314,116,44,48,11,13,103
56315,175,120,15,0,40,135
56316,21,11,4,0,6,15
56317,39,2,19,12,6,33
56318,38,7,21,0,10,28
56319,420,239,89,15,77,343
56320,143,111,1,1,30,113
56321,484,201,143,35,105,379
56322,27,12,9,1,5,22
56323,143,61,31,17,34,109
56324,97,55,25,5,12,85
56325,101,23,55,3,20,81
56326,44,18,18,0,8,36
56327,41,14,17,0,10,31
56328,78,16,44,7,11,67
56329,109,103,0,6,0,109
56330,52,22,19,1,10,42
56331,28,11,13,0,4,24
56332,99,40,35,7,17,82
56333,207,152,14,0,41,166
56334,63,14,35,4,10,53
56335,2,1,0,0,1,1
56336,496,340,53,2,101,395
56337,45,24,8,5,8,37
56338,33,3,6,16,8,25
56339,36,13,17,1,5,31
56340,137,40,51,15,31,106
56341,19,14,0,0,5,14
56342,132,44,52,8,28,104
56343,43,20,14,0,9,34
56344,104,41,26,15,22,82
56345,217,158,21,1,37,180
56346,36,14,14,2,6,30
56347,383,223,78,17,65,318
56348,429,126,162,46,95,334
56349,47,22,15,2,8,39
56350,256,32,173,2,49,207
56351,65,22,24,2,17,48
56352,92,46,13,9,24,68
56353,126,56,19,17,34,92
56354,33,8,10,7,8,25
56355,75,37,22,2,14,61
56356,31,23,2,3,3,28
56357,2,1,0,1,0,2
56358,82,64,2,0,16,66
56359,13,3,6,2,2,11
56360,5,1,2,0,2,3
56361,41,0,35,0,6,35
56362,42,8,25,3,6,36
56363,76,37,16,0,23,53
56364,29,15,2,4,8,21
56365,162,49,54,22,37,125
56366,348,186,91,15,56,292
56367,56,15,29,0,12,44
56368,44,15,15,11,3,41
56369,360,156,125,11,68,292
56370,55,28,14,0,13,42
56371,34,7,11,7,9,25
56372,93,81,2,0,10,83
56373,70,20,38,1,11,59
56374,6,1,1,0,4,2
56375,135,81,29,0,25,110
56376,282,176,43,0,63,219
56377,57,42,3,3,9,48
56378,31,16,7,2,6,25
56379,124,31,67,0,26,98
56380,15,4,7,2,2,13
56381,128,76,13,19,20,108
56382,134,51,28,26,29,105
56383,88,35,37,0,16,72
56384,62,40,10,0,12,50
56385,12,4,5,0,3,9
56386,397,207,101,20,69,328
56387,61,49,0,1,11,50
56388,131,98,4,2,27,104
56389,163,46,52,28,37,126
56390,211,113,48,0,50,161
56391,16,3,11,0,2,14
56392,109,32,56,0,21,88
56393,84,48,19,2,15,69
56394,44,14,16,1,13,31
56395,666,388,143,17,118,548
56396,6,4,0,0,2,4
56397,14,1,9,0,4,10
56398,211,109,49,0,53,158
56399,112,84,7,0,21,91
56400,20,2,12,0,6,14
56401,69,37,3,13,16,53
56402,398,176,122,23,77,321
56403,68,43,8,2,15,53
56404,13,1,8,0,4,9
56405,154,66,32,20,36,118
56406,131,43,50,13,25,106
56407,54,5,33,6,10,44
56408,37,25,5,2,5,32
56409,14,8,3,0,3,11
56410,128,57,46,4,21,107
56411,568,413,42,1,112,456
56412,89,28,23,20,18,71
56413,53,32,13,0,8,45
56414,70,43,12,3,12,58
56415,120,26,43,30,21,99
56416,184,102,34,1,47,137
56417,354,180,110,5,59,295
56418,253,133,81,0,39,214
56419,11,2,9,0,0,11
56420,67,9,31,13,14,53
56421,21,7,6,0,8,13
56422,416,119,193,10,94,322
56423,135,50,58,4,23,112
56424,32,21,9,0,2,30
56425,498,366,31,0,101,397
56426,44,19,5,15,5,39
56427,642,390,103,9,140,502
56428,27,13,6,4,4,23
56429,109,47,42,11,9,100
56430,77,10,43,5,19,58
56431,14,6,5,0,3,11
56432,31,4,24,0,3,28
56433,46,18,20,0,8,38
56434,13,2,9,0,2,11
56435,18,0,14,0,4,14
56436,267,103,101,16,47,220
56437,81,39,25,4,13,68
56438,69,49,11,0,9,60
56439,30,15,5,6,4,26
56440,241,57,119,5,60,181
56441,96,27,40,3,26,70
56442,12,3,9,0,0,12
56443,61,33,17,0,11,50
56444,20,5,7,2,6,14
56445,84,52,15,3,14,70
56446,17,9,0,3,5,12
56447,11,10,0,0,1,10
56448,102,72,12,3,15,87
56449,117,52,22,15,28,89
56450,46,18,20,0,8,38
56451,100,54,20,6,20,80
56452,41,11,20,3,7,34
56453,33,9,9,7,8,25
56454,24,13,4,1,6,18
56455,120,72,32,0,16,104
56456,132,57,47,5,23,109
56457,82,55,9,3,15,67
56458,18,4,8,0,6,12
56459,17,6,7,1,3,14
56460,82,21,30,10,21,61
56461,146,63,46,10,27,119
56462,21,11,7,0,3,18
56463,13,4,7,2,0,13
56464,34,13,17,0,4,30
56465,51,2,42,0,7,44
56466,27,0,21,3,3,24
56467,85,16,45,1,23,62
56468,26,8,13,1,4,22
56469,32,21,9,0,2,30
56470,20,5,6,3,6,14
56471,98,45,15,23,15,83
56472,107,33,38,12,24,83
56473,105,37,25,20,23,82
56474,66,26,29,0,11,55
56475,307,170,81,0,56,251
56476,32,21,9,0,2,30
56477,8,3,2,0,3,5
56478,20,7,2,10,1,19
56479,27,14,8,0,5,22
56480,166,99,34,8,25,141
56481,61,31,13,4,13,48
56482,46,25,16,0,5,41
56483,102,79,3,0,20,82
56484,7,2,5,0,0,7
56485,67,22,27,2,16,51
56486,33,21,8,0,4,29
56487,101,57,8,11,25,76
56488,105,58,8,19,20,85
56489,26,12,7,5,2,24
56490,39,13,19,0,7,32
56491,124,56,34,8,26,98
56492,52,5,34,1,12,40
56493,184,93,54,6,31,153
56494,196,129,22,0,45,151
56495,68,20,29,11,8,60
56496,59,25,19,5,10,49
56497,378,180,81,38,79,299
56498,23,9,11,2,1,22
56499,43,22,5,7,9,34
56500,47,23,20,0,4,43
56501,12,1,9,0,2,10
56502,63,20,14,16,13,50
56503,47,17,14,6,10,37
56504,76,15,43,7,11,65
56505,44,5,27,4,8,36
56506,71,46,9,2,14,57
56507,10,5,4,0,1,9
56508,177,46,56,39,36,141
56509,220,136,29,2,53,167
56510,77,10,43,5,19,58
56511,83,55,16,2,10,73
56512,81,45,22,4,10,71
56513,56,10,26,5,15,41
56514,45,30,1,2,12,33
56515,83,63,5,4,11,72
56516,170,48,13,80,29,141
56517,24,1,19,0,4,20
56518,646,380,144,18,104,542
56519,22,11,4,0,7,15
56520,276,89,127,15,45,231
56521,8,0,7,0,1,7
56522,21,7,7,1,6,15
56523,238,72,112,2,52,186
56524,34,14,11,0,9,25
56525,82,49,19,0,14,68
56526,15,2,12,0,1,14
56527,37,15,13,1,8,29
56528,82,19,45,3,15,67
56529,19,12,3,1,3,16
56530,38,25,1,1,11,27
56531,110,39,31,17,23,87
56532,17,1,13,0,3,14
56533,22,11,6,1,4,18
56534,96,26,54,2,14,82
56535,247,188,13,0,46,201
56536,264,63,148,1,52,212
56537,213,116,33,23,41,172
56538,83,68,2,0,13,70
56539,239,134,58,0,47,192
56540,170,112,27,1,30,140
56541,65,18,30,1,16,49
56542,2,0,1,0,1,1
56543,7,2,3,0,2,5
56544,76,20,35,7,14,62
56545,210,120,63,7,20,190
56546,33,14,12,5,2,31
56547,85,55,15,0,15,70
56548,145,102,17,2,24,121
56549,181,102,32,1,46,135
56550,576,339,128,14,95,481
56551,43,20,9,5,9,34
56552,33,13,12,2,6,27
56553,500,365,32,0,103,397
56554,65,28,17,5,15,50
56555,42,15,11,1,15,27
56556,96,62,9,6,19,77
56557,105,37,25,20,23,82
56558,88,28,21,18,21,67
56559,424,119,192,14,99,325
56560,444,224,114,12,94,350
56561,63,41,4,0,18,45
56562,118,90,4,1,23,95
56563,12,3,3,0,6,6
56564,51,40,1,0,10,41
56565,43,32,2,3,6,37
56566,50,14,22,1,13,37
56567,34,12,17,0,5,29
56568,58,10,24,12,12,46
56569,38,9,3,19,7,31
56570,31,2,18,5,6,25
56571,27,8,13,0,6,21
56572,123,96,3,0,24,99
56573,23,2,19,0,2,21
56574,153,54,38,30,31,122
56575,34,9,20,0,5,29
56576,30,21,4,0,5,25
56577,23,12,6,0,5,18
56578,14,4,8,0,2,12
56579,157,76,49,1,31,126
56580,127,76,27,0,24,103
56581,105,24,58,3,20,85
56582,73,38,16,0,19,54
56583,45,35,6,1,3,42
56584,12,6,2,0,4,8
56585,77,46,15,2,14,63
56586,40,11,20,1,8,32
56587,239,164,52,5,18,221
56588,51,12,19,10,10,41
56589,46,4,33,2,7,39
56590,85,47,18,1,19,66
56591,47,29,6,3,9,38
56592,27,16,7,0,4,23
56593,272,184,65,2,21,251
56594,11,2,7,0,2,9
56595,119,64,37,9,9,110
56596,45,8,30,0,7,38
56597,75,18,26,19,12,63
56598,36,26,3,0,7,29
56599,32,21,9,0,2,30
56600,71,47,7,1,16,55
56601,18,9,3,1,5,13
56602,34,4,18,6,6,28
56603,31,4,14,5,8,23
56604,101,97,0,4,0,101
56605,158,55,33,35,35,123
56606,39,23,9,4,3,36
56607,32,21,9,0,2,30
56608,166,122,6,1,37,129
56609,17,1,13,0,3,14
56610,84,58,5,0,21,63
56611,88,52,22,0,14,74
56612,225,131,22,26,46,179
56613,46,18,20,0,8,38
56614,84,51,16,0,17,67
56615,122,83,13,3,23,99
56616,41,30,2,0,9,32
56617,24,8,8,0,8,16
56618,108,104,0,4,0,108
56619,11,1,9,0,1,10
56620,52,32,12,0,8,44
56621,26,4,16,1,5,21
56622,25,8,10,0,7,18
56623,303,148,98,5,52,251
56624,110,48,32,16,14,96
56625,74,21,19,19,15,59
56626,40,26,11,0,3,37
56627,195,109,28,23,35,160
56628,79,35,28,1,15,64
56629,17,15,0,0,2,15
56630,12,4,7,0,1,11
56631,33,5,22,0,6,27
56632,41,14,14,5,8,33
56633,355,188,90,15,62,293
56634,229,173,10,0,46,183
56635,355,116,154,8,77,278
56636,6,1,2,0,3,3
56637,59,30,20,0,9,50
56638,94,34,36,10,14,80
56639,5,0,1,1,3,2
56640,163,121,4,2,36,127
56641,25,3,16,1,5,20
56642,62,38,6,3,15,47
56643,20,3,14,0,3,17
56644,160,97,36,1,26,134
56645,19,6,5,1,7,12
56646,37,8,16,4,9,28
56647,188,75,71,3,39,149
56648,55,5,34,6,10,45
56649,57,28,20,0,9,48
56650,137,101,5,2,29,108
56651,256,115,95,6,40,216
56652,62,14,42,0,6,56
56653,46,18,20,0,8,38
56654,38,6,3,20,9,29
56655,67,53,2,0,12,55
56656,175,135,8,6,26,149
56657,114,67,23,6,18,96
56658,65,41,14,2,8,57
56659,49,22,9,5,13,36
56660,46,21,15,2,8,38
56661,79,25,29,1,24,55
56662,65,35,13,0,17,48
56663,134,51,34,19,30,104
56664,228,124,51,15,38,190
56665,49,20,9,11,9,40
56666,88,35,37,2,14,74
56667,62,20,23,7,12,50
56668,75,58,5,1,11,64
56669,387,290,21,2,74,313
56670,60,31,9,8,12,48
56671,470,220,142,12,96,374
56672,41,9,18,2,12,29
56673,34,13,12,0,9,25
56674,99,44,27,3,25,74
56675,60,40,9,1,10,50
56676,32,21,9,0,2,30
56677,53,18,17,7,11,42
56678,197,78,36,33,50,147
56679,179,101,32,0,46,133
56680,33,17,10,0,6,27
56681,6,3,1,0,2,4
56682,60,16,17,15,12,48
56683,32,21,9,0,2,30
56684,15,10,0,0,5,10
56685,40,10,19,0,11,29
56686,31,18,3,0,10,21
56687,99,54,17,8,20,79
56688,15,10,3,0,2,13
56689,265,75,138,1,51,214
56690,48,26,3,8,11,37
56691,22,10,9,1,2,20
56692,74,19,37,2,16,58
56693,29,11,12,0,6,23
56694,117,53,48,3,13,104
56695,8,2,1,4,1,7
56696,46,12,25,0,9,37
56697,245,102,15,82,46,199
56698,167,50,92,4,21,146
56699,61,18,32,1,10,51
56700,111,27,32,29,23,88
56701,65,13,35,1,16,49
56702,53,24,18,1,10,43
56703,105,46,27,6,26,79
56704,33,20,3,4,6,27
56705,65,36,14,4,11,54
56706,30,3,21,0,6,24
56707,83,28,42,0,13,70
56708,76,25,28,1,22,54
56709,40,13,8,8,11,29
56710,19,9,7,0,3,16
56711,71,58,2,2,9,62
56712,98,46,33,0,19,79
56713,235,101,14,79,41,194
56714,122,1,102,0,19,103
56715,225,153,31,0,41,184
56716,45,17,16,4,8,37
56717,6,1,5,0,0,6
56718,54,23,11,16,4,50
56719,108,2,87,0,19,89
56720,79,37,5,15,22,57
56721,50,16,22,4,8,42
56722,44,15,21,2,6,38
56723,99,29,40,3,27,72
56724,59,43,4,0,12,47
56725,63,25,13,9,16,47
56726,107,53,30,5,19,88
56727,6,4,0,2,0,6
56728,61,41,1,4,15,46
56729,46,18,20,0,8,38
56730,18,3,11,0,4,14
56731,22,9,7,2,4,18
56732,25,13,9,1,2,23
56733,173,121,14,2,36,137
56734,222,137,30,3,52,170
56735,18,5,12,0,1,17
56736,52,28,13,2,9,43
56737,58,12,40,0,6,52
56738,62,8,39,2,13,49
56739,145,98,28,11,8,137
56740,22,17,0,0,5,17
56741,31,7,18,0,6,25
56742,20,12,3,0,5,15
56743,36,25,5,0,6,30
56744,99,56,8,17,18,81
56745,72,25,33,5,9,63
56746,66,33,13,3,17,49
56747,58,2,40,0,16,42
56748,359,155,125,11,68,291
56749,87,52,16,0,19,68
56750,46,19,10,8,9,37
56751,102,67,1,12,22,80
56752,24,8,11,1,4,20
56753,42,20,10,1,11,31
56754,74,34,28,0,12,62
56755,32,21,9,0,2,30
56756,77,49,17,1,10,67
56757,215,95,62,20,38,177
56758,44,27,7,0,10,34
56759,20,4,6,8,2,18
56760,59,11,33,4,11,48
56761,271,200,16,0,55,216
56762,69,34,14,8,13,56
56763,384,196,96,16,76,308
56764,25,12,4,0,9,16
56765,151,24,98,1,28,123
56766,56,37,12,0,7,49
56767,100,53,22,1,24,76
56768,226,131,24,25,46,180
56769,131,90,16,0,25,106
56770,30,13,7,2,8,22
56771,90,55,12,2,21,69
56772,63,32,22,1,8,55
56773,74,18,34,2,20,54
56774,8,0,5,0,3,5
56775,40,11,16,2,11,29
56776,51,21,19,3,8,43
56777,40,30,1,2,7,33
56778,15,2,6,0,7,8
56779,20,13,4,0,3,17
56780,69,36,16,3,14,55
56781,40,30,6,4,0,40
56782,53,28,12,2,11,42
56783,20,0,17,0,3,17
56784,44,21,12,0,11,33
56785,106,68,19,2,17,89
56786,35,17,6,2,10,25
56787,36,8,18,1,9,27
56788,127,77,21,0,29,98
56789,151,44,38,39,30,121
56790,15,3,8,2,2,13
56791,642,367,138,18,119,523
56792,27,1,17,0,9,18
56793,12,7,2,0,3,9
56794,275,14,208,0,53,222
56795,3,1,1,0,1,2
56796,186,99,24,25,38,148
56797,46,31,1,0,14,32
56798,46,18,20,0,8,38
56799,142,72,18,22,30,112
56800,273,60,144,7,62,211
56801,105,40,28,14,23,82
56802,69,35,24,0,10,59
56803,101,40,24,16,21,80
56804,78,18,42,7,11,67
56805,58,27,8,8,15,43
56806,166,55,52,25,34,132
56807,93,34,40,3,16,77
56808,22,1,16,0,5,17
56809,22,7,11,1,3,19
56810,156,123,5,4,24,132
56811,51,26,14,1,10,41
56812,32,21,9,0,2,30
56813,105,69,19,0,17,88
56814,70,12,44,0,14,56
56815,7,0,3,2,2,5
56816,393,297,20,0,76,317
56817,74,14,32,13,15,59
56818,56,34,6,3,13,43
56819,215,143,31,1,40,175
56820,46,18,20,0,8,38
56821,147,43,54,17,33,114
56822,206,101,39,30,36,170
56823,100,34,40,10,16,84
56824,20,9,6,3,2,18
56825,13,6,3,1,3,10
56826,37,21,8,0,8,29
56827,29,11,13,2,3,26
56828,7,4,0,1,2,5
56829,26,12,12,1,1,25
56830,107,46,36,5,20,87
56831,49,1,43,0,5,44
56832,46,21,17,0,8,38
56833,95,84,2,9,0,95
56834,79,53,15,0,11,68
56835,40,22,6,2,10,30
56836,72,62,2,0,8,64
56837,636,372,127,22,115,521
56838,240,163,31,3,43,197
56839,13,3,3,2,5,8
56840,172,54,12,76,30,142
56841,33,22,6,2,3,30
56842,4,1,1,0,2,2
56843,26,10,14,0,2,24
56844,109,50,23,14,22,87
56845,195,76,35,33,51,144
56846,38,7,22,2,7,31
56847,379,163,136,10,70,309
56848,117,51,22,23,21,96
56849,40,12,21,0,7,33
56850,100,48,32,3,17,83
56851,73,30,20,1,22,51
56852,22,17,0,0,5,17
56853,29,4,21,2,2,27
56854,205,111,43,14,37,168
56855,92,48,12,2,30,62
56856,143,72,36,0,35,108
56857,142,42,44,29,27,115
56858,165,68,47,12,38,127
56859,47,34,5,0,8,39
56860,164,120,5,1,38,126
56861,63,26,13,8,16,47
56862,22,11,8,0,3,19
56863,66,44,9,4,9,57
56864,181,89,30,32,30,151
56865,56,3,40,1,12,44
56866,32,21,9,0,2,30
56867,219,148,30,0,41,178
56868,4,2,1,0,1,3
56869,46,16,18,7,5,41
56870,21,6,6,0,9,12
56871,377,213,85,0,79,298
56872,96,39,35,0,22,74
56873,23,7,11,0,5,18
56874,64,39,8,2,15,49
56875,83,67,2,0,14,69
56876,14,5,6,0,3,11
56877,74,36,20,0,18,56
56878,38,8,24,1,5,33
56879,662,387,138,20,117,545
56880,103,94,0,9,0,103
56881,124,47,31,18,28,96
56882,67,47,9,0,11,56
56883,46,18,20,0,8,38
56884,36,17,14,1,4,32
56885,33,9,4,15,5,28
56886,57,22,24,1,10,47
56887,150,103,22,0,25,125
56888,82,41,26,0,15,67
56889,191,146,14,1,30,161
56890,42,17,15,2,8,34
56891,27,6,11,5,5,22
56892,674,395,140,21,118,556
56893,121,62,22,12,25,96
56894,24,16,5,0,3,21
56895,19,12,7,0,0,19
56896,51,25,17,1,8,43
56897,56,18,31,0,7,49
56898,102,36,37,6,23,79
56899,46,18,20,0,8,38
56900,32,21,9,0,2,30
56901,273,24,197,2,50,223
56902,79,46,6,5,22,57
56903,95,26,21,21,27,68
56904,26,13,12,0,1,25
56905,531,375,46,1,109,422
56906,70,38,16,1,15,55
56907,2,0,2,0,0,2
56908,12,5,0,4,3,9
56909,140,109,8,2,21,119
56910,67,33,9,6,19,48
56911,283,160,31,33,59,224
56912,38,14,18,0,6,32
56913,19,6,10,0,3,16
56914,21,11,6,0,4,17
56915,43,32,4,2,5,38
56916,66,18,32,1,15,51
56917,56,2,41,1,12,44
56918,49,26,7,8,8,41
56919,43,15,16,6,6,37
56920,48,32,8,1,7,41
56921,61,40,11,1,9,52
56922,118,46,25,25,22,96
56923,204,135,22,0,47,157
56924,65,44,5,5,11,54
56925,38,21,3,0,14,24
56926,113,70,17,3,23,90
56927,7,0,2,0,5,2
56928,146,50,71,0,25,121
56929,502,260,90,49,103,399
56930,35,22,8,1,4,31
56931,36,9,18,0,9,27
56932,35,23,4,3,5,30
56933,69,35,13,6,15,54
56934,39,7,23,2,7,32
56935,40,30,1,2,7,33
56936,28,13,8,0,7,21
56937,123,18,60,20,25,98
56938,15,10,2,0,3,12
56939,32,21,9,0,2,30
56940,62,36,14,5,7,55
56941,73,30,20,1,22,51
56942,19,8,5,0,6,13
56943,39,24,7,0,8,31
56944,41,14,17,2,8,33
56945,70,30,34,0,6,64
56946,82,55,7,1,19,63
56947,204,89,57,20,38,166
56948,51,24,16,1,10,41
56949,10,2,6,0,2,8
56950,60,22,27,2,9,51
56951,149,60,45,9,35,114
56952,21,0,14,0,7,14
56953,57,24,20,1,12,45
56954,437,295,44,0,98,339
56955,113,25,38,27,23,90
56956,33,18,7,0,8,25
56957,126,30,57,4,35,91
56958,171,90,61,4,16,155
56959,106,21,51,14,20,86
56960,104,97,0,7,0,104
56961,18,4,8,0,6,12
56962,54,34,10,3,7,47
56963,24,14,2,0,8,16
56964,6,2,4,0,0,6
56965,60,31,10,2,17,43
56966,183,5,149,0,29,154
56967,75,24,29,9,13,62
56968,36,20,8,0,8,28
56969,5,1,3,1,0,5
56970,46,18,18,1,9,37
56971,62,23,20,1,18,44
56972,46,18,20,0,8,38
56973,102,56,19,2,25,77
56974,76,39,22,2,13,63
56975,57,25,12,7,13,44
56976,86,38,15,15,18,68
56977,21,9,6,1,5,16
56978,52,15,26,0,11,41
56979,4,1,3,0,0,4
56980,14,3,9,0,2,12
56981,133,95,7,3,28,105
56982,49,16,19,2,12,37
56983,32,15,11,0,6,26
56984,40,7,21,1,11,29
56985,79,39,28,1,11,68
56986,20,13,2,0,5,15
56987,23,13,6,0,4,19
56988,69,37,3,17,12,57
56989,87,67,0,4,16,71
56990,100,31,43,6,20,80
56991,32,21,9,0,2,30
56992,79,21,39,11,8,71
56993,253,192,15,0,46,207
56994,66,26,26,3,11,55
56995,110,46,38,0,26,84
56996,388,287,23,0,78,310
56997,33,31,0,0,2,31
56998,28,14,10,0,4,24
56999,152,63,32,23,34,118
57000,159,78,25,26,30,129
57001,52,15,27,1,9,43
57002,41,32,0,0,9,32
57003,101,29,53,0,19,82
57004,62,38,10,1,13,49
57005,116,47,38,3,28,88
57006,33,19,8,1,5,28
57007,101,38,41,9,13,88
57008,12,2,9,0,1,11
57009,22,15,2,0,5,17
57010,98,28,38,8,24,74
57011,299,49,196,1,53,246
57012,31,4,16,0,11,20
57013,293,203,22,2,66,227
57014,47,13,14,6,14,33
57015,84,28,33,2,21,63
57016,28,2,19,0,7,21
57017,556,325,111,18,102,454
57018,115,53,19,15,28,87
57019,301,146,89,5,61,240
57020,84,65,1,0,18,66
57021,109,58,25,4,22,87
57022,26,8,13,0,5,21
57023,16,11,3,0,2,14
57024,13,5,6,0,2,11
57025,113,69,24,1,19,94
57026,9,1,4,3,1,8
57027,62,13,43,0,6,56
57028,32,21,9,0,2,30
57029,43,26,6,4,7,36
57030,13,6,0,2,5,8
57031,48,27,17,0,4,44
57032,63,42,8,0,13,50
57033,55,32,15,2,6,49
57034,55,32,13,0,10,45
57035,97,81,3,0,13,84
57036,37,20,11,0,6,31
57037,25,2,12,1,10,15
57038,49,17,21,2,9,40
57039,40,17,9,6,8,32
57040,16,7,5,0,4,12
57041,444,142,181,20,101,343
57042,21,14,5,0,2,19
57043,35,16,12,1,6,29
57044,71,24,30,0,17,54
57045,97,22,40,13,22,75
57046,134,27,50,30,27,107
57047,88,36,16,18,18,70
57048,156,120,9,3,24,132
57049,86,40,22,1,23,63
57050,32,21,4,0,7,25
57051,104,26,26,29,23,81
57052,26,14,2,4,6,20
57053,38,15,16,0,7,31
57054,29,10,8,0,11,18
57055,122,31,47,16,28,94
57056,328,179,96,0,53,275
57057,25,17,4,0,4,21
57058,80,23,39,1,17,63
57059,7,3,2,1,1,6
57060,373,205,108,0,60,313
57061,50,28,12,1,9,41
57062,103,59,27,1,16,87
57063,66,35,15,2,14,52
57064,74,41,11,8,14,60
57065,222,155,49,2,16,206
57066,27,9,11,2,5,22
57067,185,86,57,4,38,147
57068,22,10,5,0,7,15
57069,609,359,123,22,105,504
57070,44,6,29,0,9,35
57071,62,24,24,5,9,53
57072,90,55,7,12,16,74
57073,6,1,5,0,0,6
57074,46,1,13,25,7,39
57075,219,161,12,2,44,175
57076,26,8,10,2,6,20
57077,284,198,19,4,63,221
57078,71,47,15,9,0,71
57079,24,8,12,1,3,21
57080,61,35,16,0,10,51
57081,54,17,11,16,10,44
57082,33,8,17,4,4,29
57083,146,58,45,9,34,112
57084,74,31,19,1,23,51
57085,80,37,29,4,10,70
57086,51,9,24,8,10,41
57087,84,37,24,0,23,61
57088,50,6,35,0,9,41
57089,41,12,10,11,8,33
57090,27,9,15,1,2,25
57091,163,67,35,21,40,123
57092,121,54,40,4,23,98
57093,51,36,3,0,12,39
57094,61,36,12,2,11,50
57095,362,103,172,6,81,281
57096,35,2,25,0,8,27
57097,175,105,46,13,11,164
57098,68,44,12,0,12,56
57099,45,18,13,0,14,31
57100,136,47,46,19,24,112
57101,15,3,8,0,4,11
57102,233,180,13,0,40,193
57103,125,28,38,24,35,90
57104,89,32,35,0,22,67
57105,24,3,19,0,2,22
57106,150,67,30,18,35,115
57107,48,28,11,0,9,39
57108,91,40,28,3,20,71
57109,30,4,18,0,8,22
57110,74,33,25,0,16,58
57111,270,155,25,33,57,213
57112,58,13,35,1,9,49
57113,89,64,6,0,19,70
57114,32,21,9,0,2,30
57115,99,36,38,10,15,84
57116,64,35,13,0,16,48
57117,52,27,13,3,9,43
57118,16,9,5,0,2,14
57119,69,31,24,0,14,55
57120,115,46,10,30,29,86
57121,28,15,9,1,3,25
57122,13,3,7,0,3,10
57123,26,8,9,5,4,22
57124,166,110,25,1,30,136
57125,51,29,10,0,12,39
57126,1,0,1,0,0,1
57127,77,16,47,0,14,63
57128,17,8,5,0,4,13
57129,129,110,2,0,17,112
57130,67,42,12,0,13,54
57131,62,18,33,1,10,52
57132,152,59,38,21,34,118
57133,19,0,10,0,9,10
57134,78,47,15,6,10,68
57135,32,21,9,0,2,30
57136,225,113,37,36,39,186
57137,46,18,20,0,8,38
57138,30,12,2,13,3,27
57139,19,7,7,0,5,14
57140,5,2,2,1,0,5
57141,42,21,11,3,7,35
57142,3,1,1,0,1,2
57143,268,59,57,106,46,222
57144,17,2,9,0,6,11
57145,4,3,0,0,1,3
57146,17,11,2,3,1,16
57147,16,11,3,0,2,14
57148,19,6,7,2,4,15
57149,16,3,10,0,3,13
57150,86,42,32,5,7,79
57151,148,61,46,13,28,120
57152,74,35,21,2,16,58
57153,71,43,15,0,13,58
57154,64,48,2,0,14,50
57155,51,27,11,0,13,38
57156,46,18,20,0,8,38
57157,135,78,35,1,21,114
57158,118,88,7,0,23,95
57159,127,101,6,0,20,107
57160,196,133,19,1,43,153
57161,56,16,29,0,11,45
57162,232,130,48,14,40,192
57163,79,39,16,4,20,59
57164,74,42,21,3,8,66
57165,64,49,1,0,14,50
57166,36,19,8,0,9,27
57167,90,43,14,14,19,71
57168,59,25,20,1,13,46
57169,138,40,66,1,31,107
57170,80,46,17,4,13,67
57171,10,5,5,0,0,10
57172,2,1,1,0,0,2
57173,450,225,117,12,96,354
57174,128,26,42,24,36,92
57175,79,55,8,3,13,66
57176,47,21,13,5,8,39
57177,137,92,28,3,14,123
57178,103,38,28,13,24,79
57179,161,71,52,2,36,125
57180,24,5,7,7,5,19
57181,34,14,8,3,9,25
57182,73,38,25,0,10,63
57183,145,64,28,20,33,112
57184,9,2,4,1,2,7
57185,85,37,32,0,16,69
57186,26,10,10,0,6,20
57187,4,0,2,0,2,2
57188,88,51,21,3,13,75
57189,10,1,6,0,3,7
57190,53,22,21,0,10,43
57191,224,75,83,15,51,173
57192,25,14,6,1,4,21
57193,466,217,145,12,92,374
57194,88,17,48,1,22,66
57195,92,35,21,18,18,74
57196,51,16,23,2,10,41
57197,207,113,32,23,39,168
57198,11,8,1,1,1,10
57199,226,173,5,2,46,180
57200,108,46,30,12,20,88
57201,291,79,150,3,59,232
57202,138,70,31,9,28,110
57203,43,12,25,0,6,37
57204,13,10,1,0,2,11
57205,651,385,137,16,113,538
57206,22,6,10,0,6,16
57207,4,4,0,0,0,4
57208,17,0,15,0,2,15
57209,44,9,27,1,7,37
57210,28,15,7,0,6,22
57211,56,20,19,4,13,43
57212,123,95,6,0,22,101
57213,101,44,26,6,25,76
57214,122,64,33,1,24,98
57215,62,24,14,8,16,46
57216,29,16,11,1,1,28
57217,15,7,3,3,2,13
57218,140,55,44,9,32,108
57219,100,80,1,2,17,83
57220,33,8,14,1,10,23
57221,389,222,86,0,81,308
57222,170,133,15,1,21,149
57223,111,77,15,10,9,102
57224,189,123,24,9,33,156
57225,92,55,17,3,17,75
57226,369,217,77,0,75,294
57227,278,51,168,4,55,223
57228,91,29,38,1,23,68
57229,21,9,8,0,4,17
57230,46,18,20,0,8,38
57231,422,136,147,48,91,331
57232,2,1,0,1,0,2
57233,213,114,63,0,36,177
57234,33,13,10,2,8,25
57235,78,26,26,14,12,66
57236,65,43,10,2,10,55
57237,33,6,23,1,3,30
57238,92,24,53,2,13,79
57239,147,115,6,0,26,121
57240,203,111,30,22,40,163
57241,20,11,4,1,4,16
57242,31,11,11,1,8,23
57243,175,82,33,30,30,145
57244,80,39,25,0,16,64
57245,285,120,99,19,47,238
57246,32,7,19,1,5,27
57247,37,13,15,3,6,31
57248,292,214,12,2,64,228
57249,434,322,19,0,93,341
57250,230,157,31,0,42,188
57251,59,24,13,9,13,46
57252,15,3,11,0,1,14
57253,16,6,8,0,2,14
57254,54,23,15,2,14,40
57255,224,115,35,34,40,184
57256,71,32,22,0,17,54
57257,45,10,13,9,13,32
57258,96,92,0,4,0,96
57259,60,42,9,0,9,51
57260,4,1,3,0,0,4
57261,62,26,20,1,15,47
57262,18,2,11,0,5,13
57263,278,135,85,5,53,225
57264,39,10,25,0,4,35
57265,82,50,17,0,15,67
57266,616,383,97,7,129,487
57267,61,31,14,3,13,48
57268,37,21,6,3,7,30
57269,17,11,3,1,2,15
57270,184,122,12,11,39,145
57271,134,57,49,7,21,113
57272,656,380,148,16,112,544
57273,154,66,54,6,28,126
57274,45,15,14,13,3,42
57275,318,168,77,14,59,259
57276,141,55,46,9,31,110
57277,52,28,15,0,9,43
57278,59,39,4,2,14,45
57279,72,17,38,1,16,56
57280,273,68,149,4,52,221
57281,46,18,20,0,8,38
57282,5,0,1,1,3,2
57283,57,41,9,7,0,57
57284,83,19,33,14,17,66
57285,46,18,20,0,8,38
57286,45,7,21,9,8,37
57287,197,49,29,85,34,163
57288,77,19,37,8,13,64
57289,208,112,34,22,40,168
57290,188,75,71,3,39,149
57291,88,24,42,8,14,74
57292,82,29,24,8,21,61
57293,15,5,2,4,4,11
57294,265,142,60,14,49,216
57295,58,28,11,5,14,44
57296,38,17,11,5,5,33
57297,96,74,3,0,19,77
57298,56,31,13,0,12,44
57299,36,21,5,0,10,26
57300,32,16,2,6,8,24
57301,13,3,6,0,4,9
57302,21,2,14,0,5,16
57303,52,9,16,16,11,41
57304,50,22,11,3,14,36
57305,29,9,6,6,8,21
57306,30,22,0,0,8,22
57307,28,21,6,1,0,28
57308,342,166,111,1,64,278
57309,338,190,72,12,64,274
57310,30,16,7,2,5,25
57311,157,52,46,32,27,130
57312,26,7,13,0,6,20
57313,89,59,2,10,18,71
57314,158,113,20,0,25,133
57315,7,4,2,1,0,7
57316,41,17,15,1,8,33
57317,245,122,71,0,52,193
57318,22,8,11,0,3,19
57319,3,1,2,0,0,3
57320,11,5,5,0,1,10
57321,34,3,22,5,4,30
57322,50,15,27,1,7,43
57323,66,50,2,0,14,52
57324,14,7,4,1,2,12
57325,48,11,22,1,14,34
57326,31,9,16,0,6,25
57327,91,55,17,0,19,72
57328,32,21,9,0,2,30
57329,39,16,10,7,6,33
57330,46,18,20,0,8,38
57331,332,178,60,28,66,266
57332,33,3,21,2,7,26
57333,98,36,31,8,23,75
57334,36,12,13,3,8,28
57335,18,9,5,0,4,14
57336,46,27,9,4,6,40
57337,480,224,155,11,90,390
57338,159,67,34,24,34,125
57339,37,1,27,2,7,30
57340,16,9,1,6,0,16
57341,42,26,9,0,7,35
57342,81,48,19,0,14,67
57343,42,25,5,6,6,36
57344,9,4,3,0,2,7
57345,158,74,32,15,37,121
57346,80,25,35,4,16,64
57347,22,11,9,0,2,20
57348,87,25,37,10,15,72
57349,38,0,31,0,7,31
57350,32,21,9,0,2,30
57351,473,220,154,13,86,387
57352,33,2,23,0,8,25
57353,220,93,14,76,37,183
57354,36,12,11,6,7,29
57355,61,41,7,0,13,48
57356,161,37,16,82,26,135
57357,20,5,6,3,6,14
57358,97,23,32,25,17,80
57359,215,116,47,14,38,177
57360,17,11,1,4,1,16
57361,62,14,16,17,15,47
57362,122,38,68,0,16,106
57363,102,46,28,16,12,90
57364,28,14,7,0,7,21
57365,50,12,18,10,10,40
57366,85,25,22,20,18,67
57367,343,262,20,0,61,282
57368,184,75,42,21,46,138
57369,123,84,25,1,13,110
57370,37,8,24,0,5,32
57371,18,11,4,0,3,15
57372,47,30,9,0,8,39
57373,17,8,6,0,3,14
57374,38,27,2,2,7,31
57375,455,247,101,16,91,364
57376,24,19,3,1,1,23
57377,40,27,6,2,5,35
57378,148,52,39,29,28,120
57379,129,97,4,2,26,103
57380,93,28,39,4,22,71
57381,511,270,115,16,110,401
57382,169,66,27,48,28,141
57383,203,50,40,76,37,166
57384,328,167,90,5,66,262
57385,84,41,14,8,21,63
57386,12,6,5,0,1,11
57387,45,25,12,0,8,37
57388,13,3,6,1,3,10
57389,187,133,15,2,37,150
57390,221,121,64,0,36,185
57391,450,215,91,44,100,350
57392,132,88,12,3,29,103
57393,30,9,4,10,7,23
57394,25,2,13,0,10,15
57395,31,13,13,0,5,26
57396,8,6,1,0,1,7
57397,12,0,8,0,4,8
57398,61,36,14,1,10,51
57399,393,193,103,12,85,308
57400,40,23,12,0,5,35
57401,86,60,15,1,10,76
57402,49,24,9,3,13,36
57403,96,44,32,4,16,80
57404,61,20,16,16,9,52
57405,58,20,26,0,12,46
57406,38,9,5,17,7,31
57407,88,19,40,13,16,72
57408,95,56,20,0,19,76
57409,131,97,6,0,28,103
57410,52,17,20,0,15,37
57411,101,93,0,8,0,101
57412,44,27,7,0,10,34
57413,32,21,9,0,2,30
57414,26,9,13,0,4,22
57415,226,107,71,3,45,181
57416,71,40,16,1,14,57
57417,76,38,11,7,20,56
57418,8,3,3,0,2,6
57419,6,1,1,0,4,2
57420,81,26,27,9,19,62
57421,34,14,12,0,8,26
57422,84,58,5,0,21,63
57423,83,23,36,9,15,68
57424,47,0,37,2,8,39
57425,34,13,10,2,9,25
57426,121,41,51,11,18,103
57427,164,101,50,1,12,152
57428,221,74,83,15,49,172
57429,24,4,12,2,6,18
57430,102,37,33,9,23,79
57431,44,26,17,0,1,43
57432,470,251,77,40,102,368
57433,199,138,12,9,40,159
57434,32,21,9,0,2,30
57435,32,23,3,0,6,26
57436,658,385,141,17,115,543
57437,6,2,3,0,1,5
57438,89,78,2,9,0,89
57439,10,0,8,0,2,8
57440,12,0,10,0,2,10
57441,120,55,42,3,20,100
57442,155,19,79,23,34,121
57443,32,21,9,0,2,30
57444,67,35,21,0,11,56
57445,47,29,10,0,8,39
57446,142,36,68,4,34,108
57447,11,7,2,0,2,9
57448,574,393,54,1,126,448
57449,47,18,17,0,12,35
57450,21,8,5,1,7,14
57451,99,48,18,7,26,73
57452,56,37,12,0,7,49
57453,98,63,9,2,24,74
57454,21,5,11,1,4,17
57455,84,55,12,9,8,76
57456,16,8,2,0,6,10
57457,8,1,7,0,0,8
57458,104,23,44,15,22,82
57459,54,18,11,15,10,44
57460,78,17,47,0,14,64
57461,163,83,40,0,40,123
57462,27,6,10,3,8,19
57463,65,7,49,0,9,56
57464,62,30,11,6,15,47
57465,35,15,12,0,8,27
57466,56,23,20,0,13,43
57467,111,46,23,18,24,87
57468,26,4,14,0,8,18
57469,388,222,87,0,79,309
57470,85,40,22,1,22,63
57471,40,7,24,1,8,32
57472,86,43,24,4,15,71
57473,86,47,18,0,21,65
57474,59,17,33,0,9,50
57475,35,16,10,0,9,26
57476,56,29,3,14,10,46
57477,53,18,28,0,7,46
57478,44,2,34,0,8,36
57479,40,5,27,0,8,32
57480,50,21,6,16,7,43
57481,230,160,27,2,41,189
57482,73,30,24,3,16,57
57483,46,15,16,4,11,35
57484,344,179,92,15,58,286
57485,2,1,0,0,1,1
57486,62,27,15,5,15,47
57487,69,35,12,6,16,53
57488,138,55,44,8,31,107
57489,30,6,21,0,3,27
57490,152,54,38,29,31,121
57491,52,25,13,4,10,42
57492,31,2,23,0,6,25
57493,46,18,20,0,8,38
57494,363,167,117,14,65,298
57495,37,23,6,0,8,29
57496,173,39,17,89,28,145
57497,489,228,110,51,100,389
57498,31,5,20,1,5,26
57499,34,11,18,0,5,29
57500,72,29,13,14,16,56
57501,23,17,4,0,2,21
57502,58,31,8,11,8,50
57503,53,36,7,2,8,45
57504,40,9,23,0,8,32
57505,153,88,37,1,27,126
57506,27,3,20,0,4,23
57507,204,114,49,9,32,172
57508,99,56,19,5,19,80
57509,15,1,12,0,2,13
57510,207,114,42,14,37,170
57511,62,23,20,1,18,44
57512,24,6,10,4,4,20
57513,76,26,29,6,15,61
57514,539,391,32,1,115,424
57515,26,14,5,0,7,19
57516,93,46,25,8,14,79
57517,42,16,16,2,8,34
57518,39,7,21,2,9,30
57519,109,25,42,19,23,86
57520,168,31,103,1,33,135
57521,60,32,2,15,11,49
57522,53,33,4,0,16,37
57523,32,21,9,0,2,30
57524,59,14,33,1,11,48
57525,78,48,18,0,12,66
57526,62,43,8,4,7,55
57527,68,32,20,0,16,52
57528,32,21,9,0,2,30
57529,61,39,12,1,9,52
57530,7,1,3,1,2,5
57531,98,65,9,6,18,80
57532,94,47,14,2,31,63
57533,1,0,1,0,0,1
57534,44,13,13,8,10,34
57535,265,56,155,2,52,213
57536,18,6,8,0,4,14
57537,144,61,32,17,34,110
57538,35,16,11,0,8,27
57539,32,21,9,0,2,30
57540,56,3,40,1,12,44
57541,43,31,3,3,6,37
57542,23,8,9,2,4,19
57543,90,37,33,0,20,70
57544,37,19,4,7,7,30
57545,58,13,35,1,9,49
57546,33,16,6,3,8,25
57547,126,74,21,3,28,98
57548,55,13,30,0,12,43
57549,48,34,2,3,9,39
57550,14,4,6,0,4,10
57551,86,57,2,9,18,68
57552,75,18,36,1,20,55
57553,108,76,16,0,16,92
57554,21,6,10,1,4,17
57555,150,97,26,1,26,124
57556,40,1,9,23,7,33
57557,377,224,50,29,74,303
57558,46,18,20,0,8,38
57559,95,66,8,1,20,75
57560,42,23,6,3,10,32
57561,90,22,49,3,16,74
57562,20,11,7,0,2,18
57563,102,47,35,1,19,83
57564,46,25,16,0,5,41
57565,52,0,41,2,9,43
57566,285,154,81,0,50,235
57567,61,34,13,3,11,50
57568,52,27,20,0,5,47
57569,1068,394,431,46,197,871
57570,53,30,11,0,12,41
57571,39,8,24,0,7,32
57572,38,22,10,0,6,32
57573,6,4,2,0,0,6
57574,26,8,9,1,8,18
57575,74,17,34,3,20,54
57576,35,5,23,2,5,30
57577,430,105,183,46,96,334
57578,12,4,5,0,3,9
57579,38,25,1,1,11,27
57580,47,7,30,0,10,37
57581,126,27,44,30,25,101
57582,265,58,139,4,64,201
57583,46,18,20,0,8,38
57584,80,34,9,17,20,60
57585,133,103,11,0,19,114
57586,50,9,29,0,12,38
57587,141,73,16,22,30,111
57588,69,36,10,8,15,54
57589,160,93,37,1,29,131
57590,58,30,18,1,9,49
57591,132,34,73,0,25,107
57592,39,5,5,20,9,30
57593,31,13,7,5,6,25
57594,39,15,13,2,9,30
57595,188,26,87,30,45,143
57596,149,70,33,17,29,120
57597,26,9,11,0,6,20
57598,282,37,188,4,53,229
57599,27,13,8,0,6,21
57600,146,62,33,18,33,113
57601,44,17,15,0,12,32
57602,11,4,5,1,1,10
57603,82,64,2,0,16,66
57604,111,35,36,14,26,85
57605,32,12,2,14,4,28
57606,125,48,51,12,14,111
57607,72,52,7,3,10,62
57608,567,315,119,13,120,447
57609,10,6,2,0,2,8
57610,11,8,0,0,3,8
57611,19,7,4,0,8,11
57612,27,8,6,0,13,14
57613,52,20,14,1,17,35
57614,128,69,23,4,32,96
57615,21,9,6,2,4,17
57616,85,40,30,1,14,71
57617,64,16,35,1,12,52
57618,26,10,10,0,6,20
57619,52,35,9,0,8,44
57620,215,117,33,23,42,173
57621,49,27,11,0,11,38
57622,55,38,6,1,10,45
57623,62,43,8,4,7,55
57624,185,69,47,29,40,145
57625,183,146,9,0,28,155
57626,50,33,8,1,8,42
57627,15,4,8,0,3,12
57628,316,162,87,5,62,254
57629,107,50,31,5,21,86
57630,127,64,22,14,27,100
57631,32,21,9,0,2,30
57632,388,201,100,20,67,321
57633,87,26,44,0,17,70
57634,230,157,31,0,42,188
57635,418,105,177,44,92,326
57636,58,20,26,0,12,46
57637,132,103,4,3,22,110
57638,59,17,32,1,9,50
57639,36,5,22,0,9,27
57640,73,51,1,0,21,52
57641,94,38,31,8,17,77
57642,53,40,7,6,0,53
57643,102,67,1,12,22,80
57644,23,9,8,0,6,17
57645,38,10,15,6,7,31
57646,4,1,3,0,0,4
57647,40,2,29,0,9,31
57648,13,6,7,0,0,13
57649,32,21,9,0,2,30
57650,57,0,38,3,16,41
57651,28,12,6,5,5,23
57652,23,8,2,7,6,17
57653,44,16,17,3,8,36
57654,275,84,131,16,44,231
57655,45,15,20,2,8,37
57656,41,8,13,7,13,28
57657,51,18,22,2,9,42
57658,15,4,8,1,2,13
57659,80,44,18,2,16,64
57660,9,2,2,0,5,4
57661,5,4,0,0,1,4
57662,32,21,9,0,2,30
57663,32,21,9,0,2,30
57664,439,236,102,12,89,350
57665,138,89,32,3,14,124
57666,32,21,9,0,2,30
57667,200,43,55,61,41,159
57668,36,20,8,0,8,28
57669,70,42,15,0,13,57
57670,42,24,12,0,6,36
57671,99,59,25,0,15,84
57672,107,27,28,29,23,84
57673,2,2,0,0,0,2
57674,85,58,5,9,13,72
57675,106,45,36,5,20,86
57676,461,137,196,32,96,365
57677,49,20,11,5,13,36
57678,141,74,39,2,26,115
57679,40,22,10,1,7,33
57680,27,9,7,2,9,18
57681,480,258,80,41,101,379
57682,78,51,10,0,17,61
57683,56,23,19,2,12,44
57684,87,58,8,0,21,66
57685,137,72,34,0,31,106
57686,18,7,5,0,6,12
57687,37,21,8,0,8,29
57688,66,29,15,5,17,49
57689,187,72,62,6,47,140
57690,177,61,67,11,38,139
57691,676,377,163,24,112,564
57692,112,26,32,30,24,88
57693,77,51,7,0,19,58
57694,72,50,4,2,16,56
57695,159,50,10,71,28,131
57696,109,62,16,8,23,86
57697,27,11,14,0,2,25
57698,45,37,2,0,6,39
57699,22,4,10,0,8,14
57700,455,258,91,12,94,361
57701,621,349,151,19,102,519
57702,5,5,0,0,0,5
57703,33,14,10,0,9,24
57704,39,21,9,1,8,31
57705,22,2,11,3,6,16
57706,29,7,15,3,4,25
57707,50,29,13,0,8,42
57708,171,113,27,1,30,141
57709,35,20,6,2,7,28
57710,111,38,51,1,21,90
57711,173,83,53,3,34,139
57712,407,288,34,0,85,322
57713,99,41,19,14,25,74
57714,33,23,1,0,9,24
57715,207,51,40,78,38,169
57716,15,4,9,0,2,13
57717,138,73,34,5,26,112
57718,14,7,4,0,3,11
57719,157,75,48,1,33,124
57720,27,11,11,0,5,22
57721,414,172,106,41,95,319
57722,103,65,10,12,16,87
57723,64,11,38,0,15,49
57724,87,35,32,0,20,67
57725,102,69,11,1,21,81
57726,9,4,2,0,3,6
57727,74,35,16,8,15,59
57728,17,5,12,0,0,17
57729,150,112,9,3,26,124
57730,69,44,12,1,12,57
57731,69,18,30,3,18,51
57732,83,40,32,2,9,74
57733,51,40,1,0,10,41
57734,112,32,57,0,23,89
57735,119,96,2,3,18,101
57736,201,102,50,0,49,152
57737,38,20,12,0,6,32
57738,31,23,2,0,6,25
57739,183,96,47,0,40,143
57740,87,25,40,5,17,70
57741,245,167,33,3,42,203
57742,2,0,2,0,0,2
57743,1,0,0,1,0,1
57744,8,6,1,1,0,8
57745,219,108,64,9,38,181
57746,70,43,15,0,12,58
57747,70,27,5,22,16,54
57748,46,18,20,0,8,38
57749,34,9,20,1,4,30
57750,35,19,12,0,4,31
57751,37,24,5,2,6,31
57752,17,3,4,0,10,7
57753,26,11,3,1,11,15
57754,23,6,13,0,4,19
57755,14,1,10,0,3,11
57756,127,74,22,3,28,99
57757,210,70,94,2,44,166
57758,27,14,2,4,7,20
57759,92,61,7,4,20,72
57760,48,21,17,0,10,38
57761,13,2,6,0,5,8
57762,67,28,26,6,7,60
57763,54,32,8,2,12,42
57764,72,43,17,0,12,60
57765,105,29,58,0,18,87
57766,7,1,3,0,3,4
57767,1,0,1,0,0,1
57768,39,2,26,2,9,30
57769,74,43,21,0,10,64
57770,41,9,22,1,9,32
57771,149,59,32,23,35,114
57772,45,19,15,2,9,36
57773,36,13,16,3,4,32
57774,142,65,44,11,22,120
57775,121,68,21,2,30,91
57776,46,9,21,4,12,34
57777,30,11,11,0,8,22
57778,26,9,12,1,4,22
57779,33,14,11,0,8,25
57780,332,178,86,0,68,264
57781,34,14,11,0,9,25
57782,24,16,2,0,6,18
57783,1,1,0,0,0,1
57784,91,38,24,13,16,75
57785,77,59,5,4,9,68
57786,49,19,25,1,4,45
57787,227,50,130,1,46,181
57788,111,66,21,7,17,94
57789,46,18,20,0,8,38
57790,271,69,39,119,44,227
57791,162,79,24,26,33,129
57792,109,74,11,1,23,86
57793,55,24,13,6,12,43
57794,46,18,20,0,8,38
57795,208,56,53,59,40,168
57796,143,115,4,0,24,119
57797,110,62,14,10,24,86
57798,42,33,3,1,5,37
57799,15,4,5,0,6,9
57800,54,22,11,7,14,40
57801,372,82,165,35,90,282
57802,46,32,9,0,5,41
57803,15,5,8,0,2,13
57804,71,43,13,3,12,59
57805,29,12,12,0,5,24
57806,108,70,13,1,24,84
57807,46,18,20,0,8,38
57808,38,22,5,3,8,30
57809,93,51,19,6,17,76
57810,38,29,6,3,0,38
57811,115,79,10,3,23,92
57812,46,18,20,0,8,38
57813,38,3,27,0,8,30
57814,26,15,4,3,4,22
57815,8,2,2,3,1,7
57816,40,24,8,0,8,32
57817,20,10,5,3,2,18
57818,246,130,59,13,44,202
57819,39,26,8,1,4,35
57820,155,9,92,24,30,125
57821,3,2,1,0,0,3
57822,130,89,14,2,25,105
57823,32,21,9,0,2,30
57824,10,4,3,0,3,7
57825,21,5,10,0,6,15
57826,12,2,8,0,2,10
57827,32,21,9,0,2,30
57828,258,95,108,6,49,209
57829,123,48,49,5,21,102
57830,44,2,35,1,6,38
57831,505,266,89,44,106,399
57832,2,0,2,0,0,2
57833,169,82,51,3,33,136
57834,5,1,2,1,1,4
57835,56,2,41,1,12,44
57836,28,18,5,5,0,28
57837,113,106,0,7,0,113
57838,20,5,8,2,5,15
57839,479,225,153,11,90,389
57840,29,4,17,2,6,23
57841,36,20,7,0,9,27
57842,10,4,6,0,0,10
57843,24,4,11,0,9,15
57844,36,7,12,10,7,29
57845,101,55,28,0,18,83
57846,64,19,30,1,14,50
57847,67,29,19,7,12,55
57848,31,18,3,0,10,21
57849,67,26,6,22,13,54
57850,22,5,14,0,3,19
57851,60,37,17,1,5,55
57852,55,34,9,0,12,43
57853,10,3,5,0,2,8
57854,152,64,31,23,34,118
57855,30,24,2,4,0,30
57856,45,24,9,0,12,33
57857,223,78,85,14,46,177
57858,439,202,147,11,79,360
57859,12,0,9,0,3,9
57860,111,73,23,3,12,99
57861,46,18,20,0,8,38
57862,328,156,112,0,60,268
57863,80,39,23,0,18,62
57864,161,123,9,3,26,135
57865,22,15,2,0,5,17
57866,102,66,15,3,18,84
57867,155,38,82,1,34,121
57868,13,2,8,1,2,11
57869,131,104,9,0,18,113
57870,28,13,10,0,5,23
57871,95,33,44,1,17,78
57872,43,11,21,0,11,32
57873,35,27,4,0,4,31
57874,6,0,4,0,2,4
57875,156,74,30,17,35,121
57876,35,3,24,0,8,27
57877,34,7,17,0,10,24
57878,646,373,149,17,107,539
57879,47,23,18,0,6,41
57880,91,47,24,1,19,72
57881,36,7,16,3,10,26
57882,132,87,14,4,27,105
57883,269,175,72,4,18,251
57884,36,15,14,0,7,29
57885,71,5,50,1,15,56
57886,81,26,42,0,13,68
57887,93,41,32,4,16,77
57888,30,10,16,0,4,26
57889,68,34,9,8,17,51
57890,92,40,32,4,16,76
57891,131,54,34,19,24,107
57892,68,34,13,5,16,52
57893,49,32,6,2,9,40
57894,141,80,39,13,9,132
57895,116,51,34,5,26,90
57896,8,8,0,0,0,8
57897,179,88,32,29,30,149
57898,14,6,4,2,2,12
57899,26,11,6,1,8,18
57900,39,2,19,12,6,33
57901,3,2,0,0,1,2
57902,21,10,5,2,4,17
57903,54,24,19,1,10,44
57904,361,206,78,0,77,284
57905,138,95,22,0,21,117
57906,264,136,92,0,36,228
57907,166,53,54,24,35,131
57908,135,99,6,0,30,105
57909,46,15,19,1,11,35
57910,249,165,21,3,60,189
57911,583,402,53,1,127,456
57912,55,27,10,8,10,45
57913,34,6,18,0,10,24
57914,41,7,28,0,6,35
57915,11,2,9,0,0,11
57916,46,14,19,0,13,33
57917,38,23,9,2,4,34
57918,32,21,9,0,2,30
57919,160,81,47,1,31,129
57920,362,156,127,11,68,294
57921,36,27,0,0,9,27
57922,34,5,20,0,9,25
57923,416,193,123,13,87,329
57924,22,10,7,0,5,17
57925,160,10,92,26,32,128
57926,76,23,37,3,13,63
57927,15,10,2,0,3,12
57928,54,26,20,0,8,46
57929,33,17,7,3,6,27
57930,11,8,0,0,3,8
57931,274,68,42,119,45,229
57932,75,44,18,0,13,62
57933,104,57,25,3,19,85
57934,57,15,20,8,14,43
57935,42,15,18,5,4,38
57936,14,3,9,0,2,12
57937,65,27,23,5,10,55
57938,81,40,22,1,18,63
57939,27,22,2,3,0,27
57940,26,9,11,2,4,22
57941,116,53,46,3,14,102
57942,180,80,60,4,36,144
57943,602,415,57,1,129,473
57944,150,66,30,23,31,119
57945,48,13,22,0,13,35
57946,23,2,19,0,2,21
57947,56,37,12,0,7,49
57948,14,10,0,0,4,10
57949,74,17,36,2,19,55
57950,108,69,19,2,18,90
57951,39,19,10,0,10,29
57952,32,15,12,0,5,27
57953,68,45,11,1,11,57
57954,47,28,6,0,13,34
57955,34,10,18,4,2,32
57956,671,391,146,17,117,554
57957,107,68,19,2,18,89
57958,62,25,21,5,11,51
57959,166,45,56,27,38,128
57960,245,108,61,28,48,197
57961,60,30,11,2,17,43
57962,83,19,42,3,19,64
57963,36,5,23,0,8,28
57964,4,0,1,2,1,3
57965,33,19,6,0,8,25
57966,197,80,32,39,46,151
57967,101,68,11,0,22,79
57968,55,34,7,1,13,42
57969,195,106,34,19,36,159
57970,50,24,10,7,9,41
57971,111,59,31,0,21,90
57972,126,75,20,3,28,98
57973,58,20,23,1,14,44
57974,87,26,44,1,16,71
57975,53,8,31,8,6,47
57976,49,21,16,3,9,40
57977,61,27,21,1,12,49
57978,33,15,7,0,11,22
57979,8,1,4,0,3,5
57980,34,24,6,4,0,34
57981,25,9,12,0,4,21
57982,120,47,33,13,27,93
57983,26,10,6,0,10,16
57984,24,13,3,5,3,21
57985,27,14,5,0,8,19
57986,31,17,12,0,2,29
57987,390,177,115,25,73,317
57988,146,7,90,21,28,118
57989,120,48,37,14,21,99
57990,82,32,34,1,15,67
57991,56,22,16,11,7,49
57992,14,3,7,1,3,11
57993,281,117,105,9,50,231
57994,54,22,19,0,13,41
57995,4,1,0,0,3,1
57996,77,37,22,0,18,59
57997,140,76,41,12,11,129
57998,14,5,1,4,4,10
57999,83,19,46,2,16,67
58000,26,18,4,1,3,23
58001,71,17,35,1,18,53
58002,69,37,12,8,12,57
58003,63,24,23,4,12,51
58004,29,28,0,0,1,28
58005,32,21,9,0,2,30
58006,27,5,9,8,5,22
58007,33,6,19,0,8,25
58008,182,77,43,23,39,143
58009,27,3,15,2,7,20
58010,129,44,48,12,25,104
58011,42,7,29,0,6,36
58012,39,7,10,15,7,32
58013,28,9,15,0,4,24
58014,33,12,13,0,8,25
58015,10,3,6,0,1,9
58016,58,26,14,4,14,44
58017,580,425,38,1,116,464
58018,85,33,35,0,17,68
58019,20,7,5,2,6,14
58020,70,38,17,0,15,55
58021,3,3,0,0,0,3
58022,32,21,6,0,5,27
58023,112,40,41,3,28,84
58024,10,8,0,0,2,8
58025,7,1,3,0,3,4
58026,43,24,7,1,11,32
58027,263,103,98,16,46,217
58028,19,7,10,0,2,17
58029,21,15,2,0,4,17
58030,157,72,50,5,30,127
58031,69,29,25,0,15,54
58032,83,58,8,3,14,69
58033,155,55,38,29,33,122
58034,28,11,9,0,8,20
58035,103,54,28,0,21,82
58036,21,14,4,0,3,18
58037,125,68,22,2,33,92
58038,246,169,30,3,44,202
58039,46,18,20,0,8,38
58040,93,35,33,5,20,73
58041,208,114,50,10,34,174
58042,37,14,16,1,6,31
58043,71,12,38,6,15,56
58044,216,167,12,1,36,180
58045,32,21,9,0,2,30
58046,46,18,20,0,8,38
58047,35,17,9,3,6,29
58048,70,35,23,1,11,59
58049,53,5,34,0,14,39
58050,533,370,51,1,111,422
58051,310,160,82,15,53,257
58052,110,48,34,5,23,87
58053,44,20,13,0,11,33
58054,74,47,9,2,16,58
58055,157,120,10,1,26,131
58056,53,15,30,0,8,45
58057,22,9,7,1,5,17
58058,84,40,24,4,16,68
58059,103,29,47,8,19,84
58060,116,35,49,7,25,91
58061,193,54,48,54,37,156
58062,65,23,4,29,9,56
58063,366,188,85,13,80,286
58064,143,51,36,29,27,116
58065,4,0,2,1,1,3
58066,134,52,36,16,30,104
58067,68,30,23,1,14,54
58068,89,78,2,9,0,89
58069,38,5,21,6,6,32
58070,187,53,98,2,34,153
58071,32,21,9,0,2,30
58072,66,39,16,1,10,56
58073,93,45,26,5,17,76
58074,168,73,50,5,40,128
58075,210,161,8,0,41,169
58076,40,27,4,1,8,32
58077,32,21,9,0,2,30
58078,60,14,40,0,6,54
58079,34,13,13,2,6,28
58080,15,7,4,2,2,13
58081,58,33,13,0,12,46
58082,491,266,81,44,100,391
58083,55,18,31,0,6,49
58084,92,21,45,3,23,69
58085,62,35,16,0,11,51
58086,108,53,38,1,16,92
58087,166,98,38,1,29,137
58088,365,88,150,47,80,285
58089,98,70,11,1,16,82
58090,28,5,14,0,9,19
58091,63,34,18,3,8,55
58092,277,69,72,79,57,220
58093,155,55,38,29,33,122
58094,38,22,5,3,8,30
58095,48,28,12,0,8,40
58096,43,34,1,0,8,35
58097,47,25,3,11,8,39
58098,47,19,19,0,9,38
58099,48,26,4,9,9,39
58100,28,10,11,1,6,22
58101,42,18,4,15,5,37
58102,46,18,20,0,8,38
58103,70,30,34,0,6,64
58104,25,15,6,1,3,22
58105,47,7,31,0,9,38
58106,28,11,10,0,7,21
58107,97,59,22,11,5,92
58108,35,19,6,2,8,27
58109,87,36,22,12,17,70
58110,89,44,21,1,23,66
58111,19,8,9,0,2,17
58112,452,230,116,12,94,358
58113,203,140,46,2,15,188
58114,341,144,120,6,71,270
58115,134,54,53,2,25,109
58116,280,95,127,15,43,237
58117,10,2,7,0,1,9
58118,17,3,9,1,4,13
58119,90,26,44,0,20,70
58120,143,91,14,10,28,115
58121,50,14,23,2,11,39
58122,68,37,19,0,12,56
58123,5,3,1,0,1,4
58124,58,19,25,0,14,44
58125,68,41,17,2,8,60
58126,69,25,34,0,10,59
58127,105,47,27,12,19,86
58128,63,16,30,2,15,48
58129,84,42,21,1,20,64
58130,48,35,2,2,9,39
58131,62,26,25,0,11,51
58132,29,24,3,0,2,27
58133,57,32,10,0,15,42
58134,83,11,55,0,17,66
58135,77,40,17,0,20,57
58136,20,6,9,0,5,15
58137,32,12,9,2,9,23
58138,21,13,4,1,3,18
58139,87,65,5,4,13,74
58140,94,52,18,6,18,76
58141,66,14,8,28,16,50
58142,49,22,10,6,11,38
58143,25,9,10,2,4,21
58144,16,0,10,2,4,12
58145,111,64,8,15,24,87
58146,55,41,9,5,0,55
58147,76,39,8,18,11,65
58148,11,3,3,0,5,6
58149,322,146,104,6,66,256
58150,299,142,85,12,60,239
58151,39,12,15,0,12,27
58152,3,0,3,0,0,3
58153,40,16,10,7,7,33
58154,9,5,2,0,2,7
58155,382,168,130,11,73,309
58156,54,32,13,0,9,45
58157,65,30,18,2,15,50
58158,73,14,43,1,15,58
58159,61,34,12,0,15,46
58160,56,38,6,1,11,45
58161,36,9,19,0,8,28
58162,49,14,20,7,8,41
58163,231,155,32,0,44,187
58164,37,8,19,0,10,27
58165,41,14,21,0,6,35
58166,385,206,98,19,62,323
58167,38,25,4,2,7,31
58168,29,15,7,0,7,22
58169,105,21,50,15,19,86
58170,217,14,164,0,39,178
58171,10,6,4,0,0,10
58172,49,36,0,0,13,36
58173,49,38,1,0,10,39
58174,7,0,5,0,2,5
58175,6,3,1,1,1,5
58176,101,67,1,12,21,80
58177,46,27,9,4,6,40
58178,100,40,26,11,23,77
58179,36,2,30,0,4,32
58180,33,17,2,5,9,24
58181,44,15,23,0,6,38
58182,22,10,9,1,2,20
58183,57,33,15,2,7,50
58184,37,19,11,1,6,31
58185,473,217,159,11,86,387
58186,35,8,15,4,8,27
58187,11,8,0,0,3,8
58188,105,38,40,12,15,90
58189,65,7,47,0,11,54
58190,125,40,60,4,21,104
58191,109,27,63,4,15,94
58192,91,60,14,0,17,74
58193,178,127,14,1,36,142
58194,37,24,7,1,5,32
58195,42,25,14,0,3,39
58196,21,8,9,0,4,17
58197,22,12,8,1,1,21
58198,142,88,31,0,23,119
58199,26,15,5,0,6,20
58200,24,11,7,3,3,21
58201,21,7,8,0,6,15
58202,91,26,37,10,18,73
58203,40,31,4,0,5,35
58204,32,0,28,1,3,29
58205,60,33,15,1,11,49
58206,55,19,21,4,11,44
58207,91,59,20,0,12,79
58208,101,27,49,0,25,76
58209,9,5,1,0,3,6
58210,59,4,43,2,10,49
58211,8,3,2,0,3,5
58212,49,9,26,5,9,40
58213,73,45,15,0,13,60
58214,37,10,18,0,9,28
58215,74,22,34,2,16,58
58216,37,7,24,1,5,32
58217,5,2,3,0,0,5
58218,33,11,14,0,8,25
58219,2,2,0,0,0,2
58220,166,77,52,3,34,132
58221,43,26,11,0,6,37
58222,76,36,25,0,15,61
58223,62,7,42,1,12,50
58224,78,55,4,0,19,59
58225,66,36,15,3,12,54
58226,142,66,28,17,31,111
58227,38,19,9,0,10,28
58228,24,2,12,1,9,15
58229,31,25,3,0,3,28
58230,85,19,45,1,20,65
58231,211,140,22,0,49,162
58232,76,5,53,1,17,59
58233,80,9,52,3,16,64
58234,448,138,191,26,93,355
58235,51,12,27,1,11,40
58236,8,1,5,0,2,6
58237,101,30,31,21,19,82
58238,17,0,15,0,2,15
58239,392,188,106,14,84,308
58240,62,23,19,10,10,52
58241,19,10,3,1,5,14
58242,31,11,15,1,4,27
58243,156,71,50,5,30,126
58244,160,101,5,18,36,124
58245,490,262,104,28,96,394
58246,38,21,3,7,7,31
58247,99,32,36,8,23,76
58248,19,2,0,9,8,11
58249,223,149,33,0,41,182
58250,99,77,8,0,14,85
58251,334,165,106,5,58,276
58252,33,7,16,0,10,23
58253,37,19,11,1,6,31
58254,133,44,69,1,19,114
58255,105,25,57,3,20,85
58256,65,24,3,28,10,55
58257,46,18,20,0,8,38
58258,30,10,15,0,5,25
58259,12,7,3,0,2,10
58260,127,28,45,29,25,102
58261,48,34,6,3,5,43
58262,56,3,40,1,12,44
58263,667,391,139,19,118,549
58264,71,42,10,10,9,62
58265,55,29,17,0,9,46
58266,89,50,22,4,13,76
58267,49,29,12,0,8,41
58268,38,18,9,1,10,28
58269,12,9,3,0,0,12
58270,40,29,6,0,5,35
58271,17,1,13,0,3,14
58272,44,8,28,0,8,36
58273,56,35,11,0,10,46
58274,126,74,21,3,28,98
58275,73,28,21,8,16,57
58276,1045,386,415,46,198,847
58277,179,51,80,5,43,136
58278,72,30,22,7,13,59
58279,38,16,15,0,7,31
58280,39,15,17,0,7,32
58281,73,3,52,1,17,56
58282,50,17,15,8,10,40
58283,663,389,142,17,115,548
58284,138,46,7,62,23,115
58285,56,15,28,1,12,44
58286,101,54,29,0,18,83
58287,113,106,0,7,0,113
58288,86,43,17,2,24,62
58289,25,1,17,2,5,20
58290,31,4,19,0,8,23
58291,37,1,29,0,7,30
58292,39,6,24,0,9,30
58293,107,34,38,13,22,85
58294,82,10,50,4,18,64
58295,50,12,29,0,9,41
58296,636,418,74,6,138,498
58297,51,19,25,2,5,46
58298,70,26,32,4,8,62
58299,207,87,50,25,45,162
58300,257,101,96,15,45,212
58301,124,42,57,1,24,100
58302,27,10,10,1,6,21
58303,113,62,11,14,26,87
58304,479,348,29,1,101,378
58305,274,127,86,4,57,217
58306,74,39,21,0,14,60
58307,61,49,0,1,11,50
58308,31,16,11,0,4,27
58309,160,101,3,18,38,122
58310,196,94,62,0,40,156
58311,36,23,3,3,7,29
58312,38,22,10,2,4,34
58313,659,386,142,17,114,545
58314,14,4,2,5,3,11
58315,96,26,35,14,21,75
58316,10,1,4,0,5,5
58317,20,8,3,3,6,14
58318,512,259,95,51,107,405
58319,47,11,15,11,10,37
58320,29,1,22,1,5,24
58321,64,48,12,0,4,60
58322,140,79,22,2,37,103
58323,21,5,10,0,6,15
58324,151,42,50,19,40,111
58325,81,7,56,5,13,68
58326,85,56,8,3,18,67
58327,15,8,5,0,2,13
58328,29,21,3,1,4,25
58329,26,17,5,0,4,22
58330,12,2,8,0,2,10
58331,48,17,16,7,8,40
58332,168,86,22,27,33,135
58333,9,5,3,0,1,8
58334,11,1,8,0,2,9
58335,12,5,4,0,3,9
58336,50,3,38,1,8,42
58337,53,28,9,7,9,44
58338,63,46,5,4,8,55
58339,176,125,13,1,37,139
58340,288,195,69,3,21,267
58341,51,16,22,3,10,41
58342,148,99,21,1,27,121
58343,21,5,12,0,4,17
58344,149,61,55,7,26,123
58345,91,39,8,25,19,72
58346,42,16,18,0,8,34
58347,40,25,9,2,4,36
58348,30,16,7,2,5,25
58349,48,25,8,6,9,39
58350,53,0,33,3,17,36
58351,455,216,103,42,94,361
58352,1,1,0,0,0,1
58353,13,8,2,2,1,12
58354,61,35,13,2,11,50
58355,33,6,21,0,6,27
58356,12,4,6,2,0,12
58357,52,13,25,1,13,39
58358,74,16,43,0,15,59
58359,88,30,32,5,21,67
58360,548,402,32,1,113,435
58361,210,92,52,23,43,167
58362,72,18,32,0,22,50
58363,12,2,8,0,2,10
58364,14,1,9,0,4,10
58365,74,34,14,12,14,60
58366,350,185,92,15,58,292
58367,4,1,2,0,1,3
58368,61,33,12,0,16,45
58369,90,64,13,0,13,77
58370,17,8,5,0,4,13
58371,7,1,5,1,0,7
58372,31,15,4,5,7,24
58373,17,3,7,2,5,12
58374,63,27,20,4,12,51
58375,76,49,17,0,10,66
58376,33,16,8,0,9,24
58377,12,5,3,0,4,8
58378,79,38,29,1,11,68
58379,327,137,109,10,71,256
58380,36,18,10,0,8,28
58381,27,11,12,0,4,23
58382,89,39,28,3,19,70
58383,236,180,10,0,46,190
58384,20,2,10,3,5,15
58385,26,8,12,1,5,21
58386,15,9,1,4,1,14
58387,170,84,50,3,33,137
58388,110,29,47,5,29,81
58389,35,6,14,6,9,26
58390,28,3,12,6,7,21
58391,99,56,24,3,16,83
58392,30,3,21,0,6,24
58393,226,129,51,0,46,180
58394,142,78,36,0,28,114
58395,51,12,25,6,8,43
58396,53,37,4,1,11,42
58397,32,21,9,0,2,30
58398,459,212,144,12,91,368
58399,30,4,22,0,4,26
58400,44,23,2,11,8,36
58401,210,43,55,71,41,169
58402,95,27,52,1,15,80
58403,56,23,22,1,10,46
58404,18,11,1,0,6,12
58405,22,7,6,2,7,15
58406,58,36,12,3,7,51
58407,13,3,6,0,4,9
58408,137,20,70,17,30,107
58409,68,51,6,0,11,57
58410,56,16,32,0,8,48
58411,145,107,9,0,29,116
58412,39,1,8,22,8,31
58413,46,18,20,0,8,38
58414,24,7,7,2,8,16
58415,32,21,9,0,2,30
58416,46,18,20,0,8,38
58417,18,12,2,0,4,14
58418,562,314,111,13,124,438
58419,75,39,19,4,13,62
58420,32,19,4,8,1,31
58421,79,24,38,2,15,64
58422,19,5,9,1,4,15
58423,429,117,198,12,102,327
58424,83,16,50,0,17,66
58425,9,0,5,1,3,6
58426,40,26,8,0,6,34
58427,55,33,10,0,12,43
58428,33,24,5,0,4,29
58429,31,22,2,0,7,24
58430,55,11,27,0,17,38
58431,38,25,3,5,5,33
58432,33,3,22,2,6,27
58433,363,89,176,8,90,273
58434,72,27,7,22,16,56
58435,32,21,9,0,2,30
58436,70,56,4,0,10,60
58437,51,16,26,1,8,43
58438,654,383,135,20,116,538
58439,54,19,24,1,10,44
58440,20,12,5,1,2,18
58441,41,18,13,1,9,32
58442,95,38,27,6,24,71
58443,64,15,26,13,10,54
58444,69,18,33,1,17,52
58445,111,43,44,2,22,89
58446,46,18,20,0,8,38
58447,42,20,15,0,7,35
58448,54,25,18,0,11,43
58449,26,12,12,1,1,25
58450,159,37,16,81,25,134
58451,86,25,30,11,20,66
58452,15,4,10,0,1,14
58453,62,19,18,9,16,46
58454,53,27,12,0,14,39
58455,125,27,57,18,23,102
58456,110,76,16,1,17,93
58457,94,29,46,0,19,75
58458,49,32,6,2,9,40
58459,8,3,3,2,0,8
58460,231,155,30,6,40,191
58461,95,45,35,0,15,80
58462,56,38,11,0,7,49
58463,46,18,20,0,8,38
58464,51,5,8,25,13,38
58465,180,110,35,3,32,148
58466,63,33,3,17,10,53
58467,18,9,4,0,5,13
58468,46,20,16,1,9,37
58469,42,22,10,0,10,32
58470,5,1,3,0,1,4
58471,14,11,1,0,2,12
58472,55,24,13,5,13,42
58473,278,93,127,15,43,235
58474,43,36,0,0,7,36
58475,66,27,22,2,15,51
58476,11,4,6,0,1,10
58477,19,2,11,0,6,13
58478,16,8,7,0,1,15
58479,2,2,0,0,0,2
58480,51,30,14,0,7,44
58481,75,34,25,6,10,65
58482,439,326,20,0,93,346
58483,67,41,13,1,12,55
58484,42,20,16,0,6,36
58485,162,28,66,26,42,120
58486,13,4,4,0,5,8
58487,31,18,9,0,4,27
58488,52,17,21,2,12,40
58489,45,22,16,0,7,38
58490,112,53,25,13,21,91
58491,126,86,10,5,25,101
58492,36,17,10,3,6,30
58493,60,31,22,2,5,55
58494,190,105,54,0,31,159
58495,88,45,24,2,17,71
58496,32,25,3,0,4,28
58497,66,26,25,3,12,54
58498,106,36,29,11,30,76
58499,153,62,53,5,33,120
58500,395,262,41,0,92,303
58501,47,25,3,11,8,39
58502,25,15,6,0,4,21
58503,14,6,6,0,2,12
58504,27,7,15,0,5,22
58505,397,232,82,16,67,330
58506,60,29,18,0,13,47
58507,222,74,83,15,50,172
58508,22,20,0,0,2,20
58509,245,168,14,5,58,187
58510,315,198,48,12,57,258
58511,95,30,26,20,19,76
58512,71,16,39,1,15,56
58513,37,15,16,2,4,33
58514,89,32,36,8,13,76
58515,293,221,18,0,54,239
58516,42,5,23,0,14,28
58517,32,21,9,0,2,30
58518,33,3,6,16,8,25
58519,56,3,40,1,12,44
58520,49,30,12,0,7,42
58521,120,57,38,4,21,99
58522,14,7,4,1,2,12
58523,90,33,30,12,15,75
58524,22,13,5,0,4,18
58525,491,348,37,1,105,386
58526,46,13,10,13,10,36
58527,48,10,29,0,9,39
58528,21,8,8,2,3,18
58529,22,17,0,0,5,17
58530,62,26,7,13,16,46
58531,237,173,14,0,50,187
58532,60,47,2,0,11,49
58533,71,48,7,1,15,56
58534,398,185,118,11,84,314
58535,103,30,45,8,20,83
58536,443,110,186,46,101,342
58537,95,41,20,14,20,75
58538,22,1,17,0,4,18
58539,68,37,15,0,16,52
58540,31,19,3,0,9,22
58541,94,35,19,13,27,67
58542,159,71,51,5,32,127
58543,11,0,6,0,5,6
58544,22,10,5,3,4,18
58545,46,18,20,0,8,38
58546,40,27,1,1,11,29
58547,10,4,1,2,3,7
58548,42,13,12,13,4,38
58549,55,7,35,2,11,44
58550,32,21,9,0,2,30
58551,67,26,21,8,12,55
58552,25,17,0,0,8,17
58553,13,2,5,1,5,8
58554,33,11,11,0,11,22
58555,46,18,20,0,8,38
58556,27,15,6,1,5,22
58557,66,26,19,5,16,50
58558,135,54,42,8,31,104
58559,38,13,14,0,11,27
58560,34,7,17,0,10,24
58561,121,40,54,6,21,100
58562,109,25,47,11,26,83
58563,51,36,2,1,12,39
58564,107,36,43,1,27,80
58565,47,26,9,1,11,36
58566,165,122,4,1,38,127
58567,39,7,22,0,10,29
58568,112,48,33,18,13,99
58569,17,3,10,1,3,14
58570,455,292,65,3,95,360
58571,45,15,15,8,7,38
58572,161,66,44,22,29,132
58573,465,231,90,49,95,370
58574,111,67,20,7,17,94
58575,45,26,12,7,0,45
58576,209,109,48,0,52,157
58577,69,34,19,4,12,57
58578,309,150,91,5,63,246
58579,29,10,12,3,4,25
58580,8,4,1,0,3,5
58581,53,25,14,5,9,44
58582,201,107,62,0,32,169
58583,52,19,12,7,14,38
58584,168,50,37,45,36,132
58585,53,22,21,1,9,44
58586,58,14,31,0,13,45
58587,190,105,27,23,35,155
58588,104,51,29,5,19,85
58589,39,14,18,2,5,34
58590,76,9,52,1,14,62
58591,11,2,9,0,0,11
58592,93,27,38,8,20,73
58593,90,42,13,17,18,72
58594,169,125,4,1,39,130
58595,128,76,27,0,25,103
58596,165,98,37,1,29,136
58597,112,42,38,5,27,85
58598,6,0,3,1,2,4
58599,33,25,4,0,4,29
58600,34,22,5,1,6,28
58601,95,40,24,18,13,82
58602,159,85,38,6,30,129
58603,98,43,38,4,13,85
58604,77,40,30,0,7,70
58605,54,5,33,6,10,44
58606,19,5,12,1,1,18
58607,66,7,8,30,21,45
58608,119,35,42,15,27,92
58609,159,68,34,24,33,126
58610,178,100,33,0,45,133
58611,358,188,102,3,65,293
58612,51,24,15,0,12,39
58613,53,22,6,16,9,44
58614,465,216,151,11,87,378
58615,42,9,21,0,12,30
58616,123,56,32,10,25,98
58617,8,1,6,0,1,7
58618,25,9,10,1,5,20
58619,74,23,24,8,19,55
58620,5,0,4,0,1,4
58621,62,35,12,2,13,49
58622,120,41,41,10,28,92
58623,12,1,9,0,2,10
58624,46,13,21,1,11,35
58625,434,208,109,30,87,347
58626,37,5,24,0,8,29
58627,57,40,13,4,0,57
58628,159,30,97,1,31,128
58629,49,26,12,2,9,40
58630,63,36,18,1,8,55
58631,47,1,34,2,10,37
58632,189,85,52,13,39,150
58633,80,53,11,1,15,65
58634,144,110,2,1,31,113
58635,58,29,13,1,15,43
58636,54,23,16,3,12,42
58637,60,39,4,2,15,45
58638,49,6,35,0,8,41
58639,15,6,7,0,2,13
58640,139,56,52,3,28,111
58641,7,0,3,0,4,3
58642,42,13,19,2,8,34
58643,517,220,131,49,117,400
58644,17,12,1,0,4,13
58645,97,65,7,10,15,82
58646,420,198,135,12,75,345
58647,8,2,5,0,1,7
58648,394,293,20,0,81,313
58649,641,376,139,15,111,530
58650,509,286,122,15,86,423
58651,9,2,5,0,2,7
58652,114,39,45,0,30,84
58653,129,60,45,4,20,109
58654,27,14,6,3,4,23
58655,12,7,4,0,1,11
58656,42,14,19,0,9,33
58657,110,53,36,0,21,89
58658,106,72,18,0,16,90
58659,27,10,6,2,9,18
58660,169,115,11,10,33,136
58661,54,14,13,12,15,39
58662,242,105,78,16,43,199
58663,52,27,14,0,11,41
58664,35,16,10,3,6,29
58665,89,43,19,4,23,66
58666,148,70,49,5,24,124
58667,18,7,5,0,6,12
58668,6,2,3,0,1,5
58669,80,52,16,0,12,68
58670,68,36,23,0,9,59
58671,31,16,6,3,6,25
58672,26,14,6,0,6,20
58673,52,17,21,3,11,41
58674,52,16,22,4,10,42
58675,154,72,49,1,32,122
58676,10,6,4,0,0,10
58677,9,3,5,0,1,8
58678,46,18,20,0,8,38
58679,36,13,16,0,7,29
58680,443,209,141,12,81,362
58681,65,23,6,21,15,50
58682,14,2,7,3,2,12
58683,74,39,16,8,11,63
58684,119,44,31,21,23,96
58685,43,11,24,1,7,36
58686,87,27,42,8,10,77
58687,144,66,44,11,23,121
58688,84,17,41,9,17,67
58689,280,160,28,33,59,221
58690,22,17,1,0,4,18
58691,46,7,24,1,14,32
58692,207,47,30,92,38,169
58693,25,21,2,1,1,24
58694,213,124,38,3,48,165
58695,29,11,4,5,9,20
58696,40,17,13,0,10,30
58697,38,29,6,3,0,38
58698,122,25,45,30,22,100
58699,49,13,31,0,5,44
58700,1,1,0,0,0,1
58701,300,157,98,0,45,255
58702,90,43,29,1,17,73
58703,353,165,103,18,67,286
58704,15,10,3,0,2,13
58705,23,6,11,1,5,18
58706,58,2,40,0,16,42
58707,15,9,4,0,2,13
58708,14,3,8,1,2,12
58709,212,113,48,0,51,161
58710,49,26,11,1,11,38
58711,54,22,25,0,7,47
58712,24,8,9,4,3,21
58713,30,14,9,0,7,23
58714,42,9,14,8,11,31
58715,158,71,51,6,30,128
58716,69,19,38,0,12,57
58717,56,28,12,6,10,46
58718,61,22,31,0,8,53
58719,136,92,16,2,26,110
58720,478,225,154,11,88,390
58721,2,0,2,0,0,2
58722,2,0,1,0,1,1
58723,530,249,116,53,112,418
58724,74,10,46,5,13,61
58725,503,261,93,47,102,401
58726,27,14,10,2,1,26
58727,82,14,48,3,17,65
58728,113,63,16,9,25,88
58729,24,9,8,0,7,17
58730,42,33,1,0,8,34
58731,50,18,11,8,13,37
58732,4,1,2,0,1,3
58733,88,38,33,3,14,74
58734,2,1,0,0,1,1
58735,32,21,9,0,2,30
58736,97,25,56,2,14,83
58737,79,54,11,5,9,70
58738,91,43,32,3,13,78
58739,16,5,6,1,4,12
58740,161,83,45,1,32,129
58741,48,17,13,3,15,33
58742,218,92,14,75,37,181
58743,39,18,12,1,8,31
58744,568,408,41,1,118,450
58745,14,0,9,0,5,9
58746,111,38,44,10,19,92
58747,431,228,108,21,74,357
58748,48,28,13,0,7,41
58749,91,36,37,1,17,74
58750,63,18,20,11,14,49
58751,353,152,128,10,63,290
58752,33,2,25,3,3,30
58753,25,9,10,2,4,21
58754,484,226,124,31,103,381
58755,22,7,6,2,7,15
58756,73,30,20,1,22,51
58757,37,10,17,2,8,29
58758,163,67,56,8,32,131
58759,119,90,6,0,23,96
58760,135,103,8,0,24,111
58761,172,78,56,3,35,137
58762,85,40,7,16,22,63
58763,35,21,10,1,3,32
58764,30,22,0,0,8,22
58765,61,28,18,5,10,51
58766,196,103,35,23,35,161
58767,350,186,92,15,57,293
58768,17,9,3,0,5,12
58769,75,60,2,0,13,62
58770,15,3,8,0,4,11
58771,32,21,9,0,2,30
58772,78,62,0,5,11,67
58773,44,12,23,0,9,35
58774,47,11,27,1,8,39
58775,37,23,6,0,8,29
58776,157,80,45,1,31,126
58777,76,39,8,18,11,65
58778,59,18,27,2,12,47
58779,53,36,3,1,13,40
58780,8,1,6,0,1,7
58781,102,37,41,3,21,81
58782,235,114,71,10,40,195
58783,26,11,9,1,5,21
58784,42,25,4,3,10,32
58785,181,126,15,2,38,143
58786,77,57,4,0,16,61
58787,26,6,14,2,4,22
58788,34,25,2,0,7,27
58789,56,11,8,25,12,44
58790,55,2,28,18,7,48
58791,110,52,34,4,20,90
58792,11,6,5,0,0,11
58793,45,11,21,2,11,34
58794,45,7,29,0,9,36
58795,101,34,41,1,25,76
58796,139,98,18,1,22,117
58797,50,13,24,2,11,39
58798,69,37,16,2,14,55
58799,137,67,36,0,34,103
58800,370,103,174,7,86,284
58801,89,51,15,3,20,69
58802,28,13,12,0,3,25
58803,126,62,21,15,28,98
58804,199,122,37,3,37,162
58805,214,14,161,0,39,175
58806,92,35,38,0,19,73
58807,139,83,29,0,27,112
58808,52,24,19,0,9,43
58809,49,33,7,2,7,42
58810,11,4,5,0,2,9
58811,141,51,34,20,36,105
58812,55,32,15,0,8,47
58813,33,14,7,0,12,21
58814,43,18,15,2,8,35
58815,41,0,36,0,5,36
58816,149,63,31,21,34,115
58817,19,6,8,0,5,14
58818,45,21,13,1,10,35
58819,70,38,10,9,13,57
58820,31,13,10,0,8,23
58821,327,139,113,6,69,258
58822,120,81,12,2,25,95
58823,78,44,18,2,14,64
58824,102,44,20,12,26,76
58825,152,27,57,25,43,109
58826,72,45,13,0,14,58
58827,63,6,45,2,10,53
58828,52,30,7,3,12,40
58829,54,19,26,1,8,46
58830,29,9,13,1,6,23
58831,48,27,10,3,8,40
58832,24,10,6,1,7,17
58833,65,43,5,6,11,54
58834,57,2,45,0,10,47
58835,22,18,2,0,2,20
58836,30,23,2,0,5,25
58837,32,21,9,0,2,30
58838,64,5,44,0,15,49
58839,49,16,20,4,9,40
58840,25,9,12,0,4,21
58841,41,10,18,4,9,32
58842,33,23,4,0,6,27
58843,50,24,14,0,12,38
58844,45,14,21,2,8,37
58845,18,4,8,0,6,12
58846,94,42,32,4,16,78
58847,52,32,7,0,13,39
58848,74,19,45,0,10,64
58849,93,75,2,2,14,79
58850,195,109,27,23,36,159
58851,213,72,79,15,47,166
58852,66,9,49,0,8,58
58853,215,72,96,2,45,170
58854,275,17,202,2,54,221
58855,235,165,21,4,45,190
58856,26,13,6,0,7,19
58857,233,78,92,14,49,184
58858,73,45,11,2,15,58
58859,46,18,20,0,8,38
58860,161,61,38,23,39,122
58861,31,14,10,0,7,24
58862,46,6,28,0,12,34
58863,292,83,134,6,69,223
58864,48,34,5,2,7,41
58865,20,3,13,0,4,16
58866,19,8,6,0,5,14
58867,22,3,15,2,2,20
58868,62,30,8,8,16,46
58869,256,186,11,0,59,197
58870,235,100,78,16,41,194
58871,10,5,0,0,5,5
58872,62,41,10,0,11,51
58873,75,32,29,2,12,63
58874,166,105,11,12,38,128
58875,16,6,6,0,4,12
58876,118,74,9,10,25,93
58877,54,24,17,1,12,42
58878,36,21,9,1,5,31
58879,89,53,9,3,24,65
58880,12,8,3,0,1,11
58881,28,14,10,0,4,24
58882,287,130,80,25,52,235
58883,9,6,0,1,2,7
58884,100,39,30,8,23,77
58885,27,17,3,0,7,20
58886,20,8,7,0,5,15
58887,18,7,4,1,6,12
58888,85,38,25,0,22,63
58889,139,75,26,7,31,108
58890,14,6,4,0,4,10
58891,37,20,9,0,8,29
58892,34,20,9,1,4,30
58893,192,92,33,33,34,158
58894,140,78,39,13,10,130
58895,45,29,3,5,8,37
58896,25,13,6,1,5,20
58897,277,61,148,4,64,213
58898,73,63,2,0,8,65
58899,64,42,10,2,10,54
58900,159,113,21,0,25,134
58901,67,29,19,7,12,55
58902,59,14,20,7,18,41
58903,420,309,21,0,90,330
58904,138,103,6,0,29,109
58905,100,40,21,18,21,79
58906,12,1,7,0,4,8
58907,10,0,8,0,2,8
58908,20,15,0,0,5,15
58909,120,62,36,0,22,98
58910,53,23,20,2,8,45
58911,42,16,20,0,6,36
58912,7,3,1,0,3,4
58913,66,12,42,0,12,54
58914,42,22,10,0,10,32
58915,58,12,30,0,16,42
58916,132,11,95,1,25,107
58917,132,46,63,0,23,109
58918,124,37,47,19,21,103
58919,354,189,93,15,57,297
58920,16,10,3,1,2,14
58921,53,39,8,2,4,49
58922,16,4,8,0,4,12
58923,137,101,5,2,29,108
58924,105,75,12,10,8,97
58925,77,44,17,3,13,64
58926,85,55,15,0,15,70
58927,26,2,19,0,5,21
58928,347,203,69,0,75,272
58929,46,28,2,10,6,40
58930,60,22,19,5,14,46
58931,93,75,3,0,15,78
58932,40,30,1,2,7,33
58933,123,50,18,19,36,87
58934,84,44,19,4,17,67
58935,68,39,14,2,13,55
58936,64,41,5,0,18,46
58937,89,56,16,2,15,74
58938,9,7,2,0,0,9
58939,44,24,2,10,8,36
58940,12,1,8,0,3,9
58941,577,331,121,19,106,471
58942,40,0,32,2,6,34
58943,9,7,2,0,0,9
58944,13,7,3,0,3,10
58945,67,14,39,0,14,53
58946,17,9,4,0,4,13
58947,91,34,34,4,19,72
58948,49,27,10,2,10,39
58949,54,32,8,0,14,40
58950,39,17,12,2,8,31
58951,49,20,18,1,10,39
58952,155,48,80,4,23,132
58953,36,16,14,0,6,30
58954,81,41,9,20,11,70
58955,184,117,51,2,14,170
58956,17,15,0,0,2,15
58957,90,60,7,4,19,71
58958,114,81,12,2,19,95
58959,15,6,6,0,3,12
58960,6,1,3,1,1,5
58961,166,81,24,28,33,133
58962,103,36,38,9,20,83
58963,429,171,118,45,95,334
58964,159,105,20,3,31,128
58965,370,200,99,0,71,299
58966,44,20,13,0,11,33
58967,29,5,5,10,9,20
58968,57,31,15,0,11,46
58969,32,21,9,0,2,30
58970,52,37,2,0,13,39
58971,107,54,32,4,17,90
58972,32,4,21,0,7,25
58973,533,317,107,11,98,435
58974,139,75,33,0,31,108
58975,62,23,21,2,16,46
58976,666,390,142,17,117,549
58977,6,0,5,0,1,5
58978,345,154,116,5,70,275
58979,39,27,5,2,5,34
58980,45,16,23,2,4,41
58981,20,15,3,0,2,18
58982,20,3,14,0,3,17
58983,62,36,16,0,10,52
58984,39,10,24,0,5,34
58985,65,21,35,0,9,56
58986,19,11,5,0,3,16
58987,84,21,46,3,14,70
58988,7,3,3,0,1,6
58989,82,49,15,1,17,65
58990,93,31,31,11,20,73
58991,64,33,22,0,9,55
58992,390,203,101,20,66,324
58993,305,144,105,2,54,251
58994,46,17,20,0,9,37
58995,35,5,28,0,2,33
58996,91,36,40,0,15,76
58997,46,18,20,0,8,38
58998,26,16,2,5,3,23
58999,143,108,14,0,21,122
59000,88,41,28,2,17,71
59001,146,36,76,1,33,113
59002,443,229,108,12,94,349
59003,111,105,0,6,0,111
59004,46,34,2,5,5,41
59005,51,33,3,6,9,42
59006,197,55,52,50,40,157
59007,46,22,10,3,11,35
59008,51,27,15,0,9,42
59009,71,37,24,0,10,61
59010,31,17,9,0,5,26
59011,135,81,29,6,19,116
59012,345,151,120,6,68,277
59013,24,12,6,2,4,20
59014,16,11,3,0,2,14
59015,637,363,152,20,102,535
59016,9,4,4,0,1,8
59017,32,21,9,0,2,30
59018,54,11,5,26,12,42
59019,22,13,2,0,7,15
59020,389,224,86,0,79,310
59021,93,36,20,18,19,74
59022,192,62,81,12,37,155
59023,35,12,14,2,7,28
59024,0,0,0,0,0,0
59025,127,74,22,3,28,99
59026,97,61,18,0,18,79
59027,24,2,15,4,3,21
59028,105,55,28,4,18,87
59029,474,221,153,13,87,387
59030,519,244,117,49,109,410
59031,39,33,0,0,6,33
59032,144,62,31,18,33,111
59033,32,21,9,0,2,30
59034,35,15,13,0,7,28
59035,64,34,15,0,15,49
59036,78,44,16,2,16,62
59037,31,9,14,3,5,26
59038,96,44,32,4,16,80
59039,152,63,44,10,35,117
59040,44,7,25,4,8,36
59041,55,15,19,6,15,40
59042,168,82,54,5,27,141
59043,64,24,25,5,10,54
59044,272,182,66,3,21,251
59045,36,11,20,0,5,31
59046,78,45,16,2,15,63
59047,79,45,16,0,18,61
59048,31,7,20,0,4,27
59049,44,19,13,2,10,34
59050,127,74,22,3,28,99
59051,124,34,49,19,22,102
59052,67,35,21,0,11,56
59053,143,95,25,0,23,120
59054,32,2,26,0,4,28
59055,221,57,112,6,46,175
59056,37,11,19,0,7,30
59057,28,4,8,10,6,22
59058,78,35,25,2,16,62
59059,97,25,53,0,19,78
59060,86,39,19,7,21,65
59061,158,54,52,25,27,131
59062,68,43,11,3,11,57
59063,94,51,30,7,6,88
59064,76,39,16,2,19,57
59065,101,32,40,10,19,82
59066,23,7,10,1,5,18
59067,20,12,3,0,5,15
59068,7,2,2,0,3,4
59069,65,15,35,6,9,56
59070,39,30,4,0,5,34
59071,104,44,23,18,19,85
59072,105,40,38,6,21,84
59073,9,3,3,0,3,6
59074,454,231,117,12,94,360
59075,136,81,30,0,25,111
59076,40,8,25,4,3,37
59077,60,15,29,2,14,46
59078,30,22,0,0,8,22
59079,22,5,10,0,7,15
59080,131,40,48,17,26,105
59081,203,89,56,20,38,165
59082,46,11,29,0,6,40
59083,34,9,15,1,9,25
59084,22,2,13,1,6,16
59085,201,146,15,1,39,162
59086,30,4,15,4,7,23
59087,0,0,0,0,0,0
59088,52,33,6,1,12,40
59089,444,306,41,1,96,348
59090,71,46,12,0,13,58
59091,12,4,5,0,3,9
59092,113,32,53,3,25,88
59093,90,29,41,1,19,71
59094,476,223,153,11,89,387
59095,38,18,15,0,5,33
59096,76,36,22,1,17,59
59097,49,15,23,1,10,39
59098,23,10,7,0,6,17
59099,48,22,15,0,11,37
59100,106,42,14,16,34,72
59101,51,25,10,7,9,42
59102,70,22,36,1,11,59
59103,39,24,4,0,11,28
59104,4,1,3,0,0,4
59105,25,1,18,1,5,20
59106,44,5,16,11,12,32
59107,36,19,5,7,5,31
59108,109,25,38,26,20,89
59109,58,14,28,2,14,44
59110,56,32,16,0,8,48
59111,32,21,9,0,2,30
59112,34,8,16,1,9,25
59113,369,214,80,17,58,311
59114,91,31,32,13,15,76
59115,221,84,14,81,42,179
59116,471,180,142,45,104,367
59117,34,22,6,2,4,30
59118,95,29,51,2,13,82
59119,28,2,11,8,7,21
59120,46,18,20,0,8,38
59121,46,22,9,3,12,34
59122,46,16,18,3,9,37
59123,25,12,6,0,7,18
59124,54,13,27,0,14,40
59125,42,10,27,0,5,37
59126,199,93,68,1,37,162
59127,39,27,3,2,7,32
59128,38,5,25,0,8,30
59129,345,186,89,15,55,290
59130,80,7,56,5,12,68
59131,94,33,32,7,22,72
59132,66,46,4,1,15,51
59133,509,231,120,47,111,398
59134,458,264,76,29,89,369
59135,46,18,20,0,8,38
59136,117,38,49,7,23,94
59137,58,32,11,3,12,46
59138,266,198,15,0,53,213
59139,19,2,10,0,7,12
59140,100,44,21,16,19,81
59141,451,209,142,10,90,361
59142,109,70,17,1,21,88
59143,6,3,3,0,0,6
59144,184,85,42,19,38,146
59145,67,26,22,1,18,49
59146,11,1,6,1,3,8
59147,99,34,40,10,15,84
59148,29,5,18,0,6,23
59149,52,29,7,6,10,42
59150,46,28,5,7,6,40
59151,13,2,8,1,2,11
59152,160,114,11,0,35,125
59153,39,14,20,1,4,35
59154,75,8,43,5,19,56
59155,48,30,5,6,7,41
59156,16,2,9,1,4,12
59157,222,90,41,38,53,169
59158,32,21,9,0,2,30
59159,95,65,6,5,19,76
59160,63,15,30,0,18,45
59161,41,13,18,4,6,35
59162,46,18,20,0,8,38
59163,68,23,35,1,9,59
59164,12,7,2,0,3,9
59165,11,5,6,0,0,11
59166,32,21,9,0,2,30
59167,14,8,3,0,3,11
59168,79,35,19,12,13,66
59169,25,12,10,0,3,22
59170,32,13,8,6,5,27
59171,55,33,14,2,6,49
59172,48,24,14,1,9,39
59173,11,3,3,3,2,9
59174,26,11,7,2,6,20
59175,272,62,143,7,60,212
59176,24,13,0,5,6,18
59177,137,63,45,5,24,113
59178,211,158,13,3,37,174
59179,117,40,36,15,26,91
59180,95,38,18,14,25,70
59181,83,21,43,4,15,68
59182,18,10,6,0,2,16
59183,84,41,27,0,16,68
59184,46,18,20,0,8,38
59185,95,43,16,18,18,77
59186,14,5,7,0,2,12
59187,38,27,4,2,5,33
59188,199,94,77,5,23,176
59189,32,21,9,0,2,30
59190,15,6,3,4,2,13
59191,150,102,22,0,26,124
59192,139,92,12,7,28,111
59193,57,18,29,2,8,49
59194,54,25,14,0,15,39
59195,44,35,2,0,7,37
59196,589,412,51,1,125,464
59197,67,33,15,0,19,48
59198,140,80,23,3,34,106
59199,156,55,38,31,32,124
59200,24,5,12,0,7,17
59201,22,2,18,0,2,20
59202,19,1,11,0,7,12
59203,71,36,16,0,19,52
59204,41,26,7,2,6,35
59205,99,31,40,10,18,81
59206,23,3,8,9,3,20
59207,107,51,35,0,21,86
59208,32,21,9,0,2,30
59209,25,5,15,0,5,20
59210,71,32,27,1,11,60
59211,64,32,8,8,16,48
59212,409,186,114,19,90,319
59213,74,30,25,3,16,58
59214,95,26,34,14,21,74
59215,25,3,16,1,5,20
59216,125,63,39,0,23,102
59217,14,3,9,1,1,13
59218,13,8,3,0,2,11
59219,142,49,6,63,24,118
59220,29,7,13,0,9,20
59221,58,23,25,0,10,48
59222,21,1,13,1,6,15
59223,81,37,26,4,14,67
59224,1256,501,169,336,250,1006
59225,148,80,32,9,27,121
59226,17,1,10,1,5,12
59227,65,36,14,0,15,50
59228,455,138,187,32,98,357
59229,72,36,19,2,15,57
59230,18,7,5,0,6,12
59231,1,0,1,0,0,1
59232,121,57,25,16,23,98
59233,35,1,26,0,8,27
59234,115,75,18,1,21,94
59235,88,44,25,2,17,71
59236,329,173,86,13,57,272
59237,301,170,77,0,54,247
59238,89,41,31,3,14,75
59239,132,46,29,26,31,101
59240,24,4,9,3,8,16
59241,444,204,136,13,91,353
59242,38,19,11,2,6,32
59243,32,8,19,0,5,27
59244,38,29,5,3,1,37
59245,107,37,32,16,22,85
59246,6,5,0,1,0,6
59247,95,53,18,10,14,81
59248,141,52,60,5,24,117
59249,17,11,5,1,0,17
59250,48,26,14,2,6,42
59251,12,7,4,0,1,11
59252,259,13,198,0,48,211
59253,53,6,33,0,14,39
59254,7,2,4,0,1,6
59255,91,67,16,2,6,85
59256,93,23,52,0,18,75
59257,48,24,9,0,15,33
59258,39,12,19,0,8,31
59259,16,4,6,0,6,10
59260,175,66,45,25,39,136
59261,69,29,28,1,11,58
59262,45,19,15,2,9,36
59263,57,30,18,0,9,48
59264,137,3,113,0,21,116
59265,420,104,181,44,91,329
59266,36,14,11,0,11,25
59267,40,29,1,0,10,30
59268,132,48,37,17,30,102
59269,111,23,49,14,25,86
59270,18,8,7,0,3,15
59271,42,19,11,4,8,34
59272,34,6,23,0,5,29
59273,118,39,55,2,22,96
59274,11,4,3,1,3,8
59275,57,17,19,8,13,44
59276,389,224,86,0,79,310
59277,114,67,19,5,23,91
59278,220,150,29,0,41,179
59279,65,18,3,31,13,52
59280,449,240,107,14,88,361
59281,265,198,17,0,50,215
59282,171,82,38,14,37,134
59283,19,11,2,0,6,13
59284,126,40,45,15,26,100
59285,403,230,87,13,73,330
59286,83,47,18,4,14,69
59287,215,49,126,2,38,177
59288,43,13,12,6,12,31
59289,111,40,43,14,14,97
59290,74,53,7,3,11,63
59291,167,57,80,0,30,137
59292,233,79,90,14,50,183
59293,30,3,21,0,6,24
59294,31,12,7,6,6,25
59295,32,21,9,0,2,30
59296,72,54,6,0,12,60
59297,16,11,2,0,3,13
59298,74,33,25,2,14,60
59299,30,14,6,1,9,21
59300,36,17,9,0,10,26
59301,61,15,25,7,14,47
59302,27,17,7,3,0,27
59303,513,252,100,56,105,408
59304,97,45,16,16,20,77
59305,178,101,32,0,45,133
59306,120,35,62,0,23,97
59307,349,186,92,15,56,293
59308,33,18,6,0,9,24
59309,57,18,25,3,11,46
59310,68,36,10,9,13,55
59311,219,108,38,34,39,180
59312,16,10,1,3,2,14
59313,166,62,45,21,38,128
59314,79,42,19,0,18,61
59315,65,37,17,0,11,54
59316,129,48,46,8,27,102
59317,173,49,15,81,28,145
59318,22,15,4,1,2,20
59319,142,38,37,37,30,112
59320,39,2,30,0,7,32
59321,76,42,22,0,12,64
59322,20,11,4,0,5,15
59323,128,48,48,0,32,96
59324,32,21,9,0,2,30
59325,236,155,35,0,46,190
59326,45,21,15,1,8,37
59327,186,46,97,11,32,154
59328,52,36,4,3,9,43
59329,104,53,31,0,20,84
59330,447,303,45,1,98,349
59331,80,45,18,3,14,66
59332,53,22,19,2,10,43
59333,33,3,6,16,8,25
59334,76,38,18,1,19,57
59335,30,14,11,0,5,25
59336,33,9,16,0,8,25
59337,168,49,50,36,33,135
59338,115,94,3,3,15,100
59339,212,86,14,75,37,175
59340,489,266,79,43,101,388
59341,181,81,53,8,39,142
59342,130,43,47,7,33,97
59343,128,58,45,6,19,109
59344,110,72,13,1,24,86
59345,222,52,31,103,36,186
59346,57,19,26,0,12,45
59347,32,7,18,1,6,26
59348,158,112,20,0,26,132
59349,15,4,5,0,6,9
59350,54,22,17,5,10,44
59351,23,15,4,0,4,19
59352,218,121,49,0,48,170
59353,50,26,7,8,9,41
59354,168,58,79,0,31,137
59355,17,4,7,1,5,12
59356,100,41,35,5,19,81
59357,39,14,17,2,6,33
59358,36,16,12,2,6,30
59359,126,51,28,21,26,100
59360,111,73,23,3,12,99
59361,25,14,10,0,1,24
59362,21,13,1,0,7,14
59363,73,27,28,3,15,58
59364,81,33,32,1,15,66
59365,177,86,35,22,34,143
59366,80,21,40,4,15,65
59367,91,61,8,0,22,69
59368,11,8,0,0,3,8
59369,118,56,23,17,22,96
59370,40,17,4,14,5,35
59371,57,35,7,2,13,44
59372,56,24,19,0,13,43
59373,17,5,4,5,3,14
59374,32,21,9,0,2,30
59375,54,19,20,1,14,40
59376,62,15,32,3,12,50
59377,30,17,6,2,5,25
59378,205,159,11,0,35,170
59379,165,54,73,0,38,127
59380,28,16,7,1,4,24
59381,145,95,26,0,24,121
59382,549,279,110,49,111,438
59383,68,32,26,0,10,58
59384,143,63,27,22,31,112
59385,66,14,40,1,11,55
59386,24,5,15,0,4,20
59387,394,217,96,0,81,313
59388,189,96,45,9,39,150
59389,31,3,25,0,3,28
59390,20,15,2,0,3,17
59391,140,66,42,10,22,118
59392,48,3,34,7,4,44
59393,58,13,35,1,9,49
59394,228,78,85,15,50,178
59395,540,390,38,1,111,429
59396,30,22,0,0,8,22
59397,13,2,7,1,3,10
59398,62,26,22,1,13,49
59399,40,20,11,1,8,32
59400,37,17,13,4,3,34
59401,680,378,166,23,113,567
59402,64,19,35,3,7,57
59403,3,1,1,0,1,2
59404,144,67,42,6,29,115
59405,673,391,154,21,107,566
59406,2,1,1,0,0,2
59407,45,1,32,0,12,33
59408,42,3,34,1,4,38
59409,330,241,21,0,68,262
59410,641,400,96,8,137,504
59411,5,0,4,0,1,4
59412,6,0,5,0,1,5
59413,13,2,9,0,2,11
59414,9,7,0,1,1,8
59415,27,14,2,5,6,21
59416,105,33,52,1,19,86
59417,35,2,23,5,5,30
59418,93,31,39,1,22,71
59419,40,19,7,2,12,28
59420,31,3,22,0,6,25
59421,32,7,14,3,8,24
59422,77,49,10,1,17,60
59423,32,14,11,0,7,25
59424,143,81,37,1,24,119
59425,81,15,41,6,19,62
59426,32,21,9,0,2,30
59427,12,3,7,2,0,12
59428,87,66,3,0,18,69
59429,35,6,22,0,7,28
59430,40,10,19,2,9,31
59431,103,82,3,0,18,85
59432,158,94,25,11,28,130
59433,202,142,13,9,38,164
59434,122,101,5,0,16,106
59435,266,120,75,26,45,221
59436,119,35,46,19,19,100
59437,84,21,45,7,11,73
59438,9,3,5,0,1,8
59439,97,54,24,0,19,78
59440,56,14,24,1,17,39
59441,57,33,13,1,10,47
59442,48,22,16,1,9,39
59443,13,6,7,0,0,13
59444,71,43,7,8,13,58
59445,121,53,31,15,22,99
59446,46,23,7,3,13,33
59447,233,143,7,31,52,181
59448,43,14,17,4,8,35
59449,11,4,3,0,4,7
59450,25,2,17,1,5,20
59451,10,2,6,1,1,9
59452,46,18,20,0,8,38
59453,32,16,4,5,7,25
59454,420,103,185,44,88,332
59455,47,20,17,1,9,38
59456,449,239,116,18,76,373
59457,107,46,28,7,26,81
59458,18,8,5,0,5,13
59459,102,48,32,5,17,85
59460,31,12,12,0,7,24
59461,36,18,10,0,8,28
59462,382,222,82,16,62,320
59463,272,60,144,7,61,211
59464,393,248,51,6,88,305
59465,49,14,16,12,7,42
59466,31,4,9,11,7,24
59467,72,35,17,8,12,60
59468,78,38,20,0,20,58
59469,11,2,7,1,1,10
59470,55,22,18,5,10,45
59471,58,33,16,0,9,49
59472,524,360,57,2,105,419
59473,26,4,14,0,8,18
59474,118,50,38,8,22,96
59475,24,6,11,0,7,17
59476,53,24,10,6,13,40
59477,17,6,5,5,1,16
59478,90,57,12,2,19,71
59479,403,192,136,7,68,335
59480,58,22,12,11,13,45
59481,11,5,3,1,2,9
59482,106,77,7,1,21,85
59483,22,18,0,0,4,18
59484,145,80,28,1,36,109
59485,39,11,18,1,9,30
59486,102,22,48,13,19,83
59487,36,14,11,3,8,28
59488,72,30,32,0,10,62
59489,54,36,12,0,6,48
59490,35,25,1,0,9,26
59491,222,75,84,15,48,174
59492,125,53,28,20,24,101
59493,12,2,9,0,1,11
59494,45,11,21,1,12,33
59495,142,39,80,0,23,119
59496,20,14,2,1,3,17
59497,26,9,9,3,5,21
59498,24,9,10,0,5,19
59499,83,56,10,0,17,66
59500,36,21,3,6,6,30
59501,68,37,17,0,14,54
59502,207,139,53,1,14,193
59503,40,21,10,0,9,31
59504,16,3,7,1,5,11
59505,194,106,57,0,31,163
59506,42,32,2,0,8,34
59507,618,365,133,15,105,513
59508,170,97,56,4,13,157
59509,44,9,28,0,7,37
59510,98,43,34,4,17,81
59511,107,49,35,5,18,89
59512,64,15,29,6,14,50
59513,35,9,17,3,6,29
59514,46,27,6,4,9,37
59515,404,161,114,43,86,318
59516,8,2,4,0,2,6
59517,228,154,34,0,40,188
59518,7,1,5,0,1,6
59519,126,93,6,0,27,99
59520,434,252,80,9,93,341
59521,120,32,57,4,27,93
59522,53,37,4,0,12,41
59523,160,72,53,5,30,130
59524,63,47,1,0,15,48
59525,37,9,19,0,9,28
59526,105,25,58,3,19,86
59527,117,80,13,1,23,94
59528,67,10,6,34,17,50
59529,73,23,36,4,10,63
59530,38,6,4,20,8,30
59531,26,8,8,3,7,19
59532,46,18,20,0,8,38
59533,88,51,14,0,23,65
59534,3,0,2,0,1,2
59535,23,1,13,3,6,17
59536,423,134,170,26,93,330
59537,127,86,18,1,22,105
59538,8,1,4,2,1,7
59539,31,18,6,0,7,24
59540,129,24,55,19,31,98
59541,178,101,33,0,44,134
59542,32,21,9,0,2,30
59543,41,9,24,3,5,36
59544,93,46,30,3,14,79
59545,0,0,0,0,0,0
59546,104,56,23,7,18,86
59547,86,49,19,1,17,69
59548,4,2,1,0,1,3
59549,90,29,44,1,16,74
59550,69,20,32,1,16,53
59551,75,13,40,6,16,59
59552,52,32,6,2,12,40
59553,73,28,29,1,15,58
59554,21,11,8,1,1,20
59555,48,0,37,0,11,37
59556,247,162,27,3,55,192
59557,42,6,26,0,10,32
59558,85,38,32,0,15,70
59559,48,29,12,0,7,41
59560,123,56,42,1,24,99
59561,298,221,12,2,63,235
59562,30,8,16,0,6,24
59563,33,8,17,0,8,25
59564,86,53,18,0,15,71
59565,239,129,31,31,48,191
59566,19,3,9,1,6,13
59567,14,6,4,0,4,10
59568,21,15,5,0,1,20
59569,148,29,91,1,27,121
59570,233,133,54,0,46,187
59571,40,16,16,0,8,32
59572,79,50,12,0,17,62
59573,51,27,12,1,11,40
59574,32,17,3,8,4,28
59575,77,41,22,0,14,63
59576,77,23,33,2,19,58
59577,5,1,1,1,2,3
59578,390,201,111,17,61,329
59579,17,4,7,1,5,12
59580,4,2,1,0,1,3
59581,192,106,29,23,34,158
59582,464,261,95,12,96,368
59583,39,13,8,11,7,32
59584,135,99,7,3,26,109
59585,39,25,4,0,10,29
59586,14,6,5,2,1,13
59587,42,29,5,0,8,34
59588,50,22,18,1,9,41
59589,75,20,24,16,15,60
59590,235,150,34,3,48,187
59591,63,36,13,0,14,49
59592,6,1,4,1,0,6
59593,55,33,15,2,5,50
59594,20,9,3,3,5,15
59595,49,18,13,3,15,34
59596,29,10,15,0,4,25
59597,54,0,36,3,15,39
59598,29,14,6,0,9,20
59599,32,14,11,1,6,26
59600,193,142,14,1,36,157
59601,0,0,0,0,0,0
59602,58,11,33,0,14,44
59603,26,12,5,7,2,24
59604,22,8,10,1,3,19
59605,263,116,80,21,46,217
59606,495,264,106,26,99,396
59607,45,9,22,0,14,31
59608,146,65,45,10,26,120
59609,108,58,22,1,27,81
59610,87,57,11,4,15,72
59611,35,17,15,0,3,32
59612,47,22,17,0,8,39
59613,38,10,20,0,8,30
59614,12,1,5,0,6,6
59615,21,9,6,0,6,15
59616,79,61,3,0,15,64
59617,341,161,85,26,69,272
59618,26,3,15,0,8,18
59619,50,31,11,0,8,42
59620,43,14,20,2,7,36
59621,102,29,46,6,21,81
59622,416,218,107,20,71,345
59623,24,5,9,4,6,18
59624,9,3,5,0,1,8
59625,131,81,20,5,25,106
59626,21,1,4,13,3,18
59627,73,31,20,1,21,52
59628,57,22,19,4,12,45
59629,83,68,2,0,13,70
59630,79,44,19,1,15,64
59631,88,45,25,2,16,72
59632,52,25,16,1,10,42
59633,90,23,48,0,19,71
59634,54,31,11,2,10,44
59635,98,42,29,0,27,71
59636,22,4,11,1,6,16
59637,46,18,20,0,8,38
59638,36,18,11,0,7,29
59639,9,0,6,0,3,6
59640,32,21,9,0,2,30
59641,221,136,6,30,49,172
59642,86,27,27,12,20,66
59643,68,38,15,0,15,53
59644,21,14,1,3,3,18
59645,264,195,16,0,53,211
59646,30,15,6,2,7,23
59647,82,41,16,4,21,61
59648,33,13,13,1,6,27
59649,119,45,41,12,21,98
59650,189,60,61,24,44,145
59651,140,97,16,2,25,115
59652,92,28,25,21,18,74
59653,67,31,14,8,14,53
59654,31,13,10,2,6,25
59655,11,0,8,2,1,10
59656,10,2,7,0,1,9
59657,3,1,1,0,1,2
59658,173,64,75,0,34,139
59659,64,16,39,0,9,55
59660,40,16,16,1,7,33
59661,87,44,25,4,14,73
59662,24,17,2,0,5,19
59663,219,118,53,13,35,184
59664,294,156,71,19,48,246
59665,39,20,10,0,9,30
59666,91,56,20,0,15,76
59667,38,22,8,0,8,30
59668,99,54,19,11,15,84
59669,10,2,4,2,2,8
59670,35,26,2,0,7,28
59671,71,27,27,4,13,58
59672,344,149,122,6,67,277
59673,122,92,5,8,17,105
59674,35,19,5,3,8,27
59675,154,68,31,22,33,121
59676,51,5,36,2,8,43
59677,18,15,1,0,2,16
59678,49,11,30,0,8,41
59679,41,7,27,0,7,34
59680,129,87,20,2,20,109
59681,201,84,33,38,46,155
59682,40,31,1,2,6,34
59683,14,0,10,0,4,10
59684,33,3,6,17,7,26
59685,1,0,0,0,1,0
59686,41,16,12,7,6,35
59687,11,5,4,0,2,9
59688,45,9,22,0,14,31
59689,154,91,25,12,26,128
59690,94,43,32,4,15,79
59691,112,48,47,3,14,98
59692,8,1,4,0,3,5
59693,82,49,18,2,13,69
59694,58,20,27,0,11,47
59695,45,20,9,8,8,37
59696,41,32,1,0,8,33
59697,79,61,1,0,17,62
59698,13,1,7,0,5,8
59699,87,54,18,4,11,76
59700,61,27,8,13,13,48
59701,139,99,19,1,20,119
59702,305,172,77,0,56,249
59703,125,66,15,15,29,96
59704,38,19,9,1,9,29
59705,25,10,5,8,2,23
59706,66,39,9,0,18,48
59707,76,13,49,0,14,62
59708,365,213,80,16,56,309
59709,18,9,6,0,3,15
59710,95,39,44,1,11,84
59711,257,201,10,0,46,211
59712,86,36,35,0,15,71
59713,23,9,9,0,5,18
59714,81,61,4,0,16,65
59715,134,64,49,2,19,115
59716,52,32,11,0,9,43
59717,66,33,24,2,7,59
59718,11,0,7,0,4,7
59719,42,17,8,6,11,31
59720,4,0,2,0,2,2
59721,209,115,50,10,34,175
59722,69,3,50,1,15,54
59723,77,33,27,2,15,62
59724,63,28,15,4,16,47
59725,11,5,2,0,4,7
59726,151,65,55,1,30,121
59727,57,27,21,4,5,52
59728,27,4,16,2,5,22
59729,13,5,3,2,3,10
59730,299,223,12,2,62,237
59731,39,22,12,0,5,34
59732,470,183,138,47,102,368
59733,145,84,31,5,25,120
59734,73,28,22,1,22,51
59735,88,33,18,9,28,60
59736,25,2,13,0,10,15
59737,38,10,17,3,8,30
59738,158,113,20,0,25,133
59739,43,24,9,4,6,37
59740,79,21,34,6,18,61
59741,104,41,31,5,27,77
59742,90,16,40,17,17,73
59743,17,1,10,5,1,16
59744,46,18,20,0,8,38
59745,115,46,37,9,23,92
59746,93,34,42,3,14,79
59747,102,66,2,12,22,80
59748,156,80,45,1,30,126
59749,90,31,24,13,22,68
59750,34,18,8,3,5,29
59751,361,101,166,11,83,278
59752,340,162,84,25,69,271
59753,34,5,22,0,7,27
59754,610,357,125,18,110,500
59755,48,26,16,0,6,42
59756,12,3,7,0,2,10
59757,223,150,33,0,40,183
59758,31,13,11,2,5,26
59759,59,23,27,1,8,51
59760,34,5,14,10,5,29
59761,17,10,0,3,4,13
59762,118,54,27,14,23,95
59763,73,25,28,4,16,57
59764,42,21,12,0,9,33
59765,434,243,90,12,89,345
59766,41,12,19,1,9,32
59767,76,32,27,2,15,61
59768,104,43,14,16,31,73
59769,37,16,13,0,8,29
59770,17,6,6,0,5,12
59771,50,16,18,9,7,43
59772,69,43,18,0,8,61
59773,90,65,7,0,18,72
59774,3,1,0,0,2,1
59775,49,23,13,3,10,39
59776,35,5,26,1,3,32
59777,19,2,11,0,6,13
59778,13,3,6,1,3,10
59779,78,25,24,7,22,56
59780,50,32,5,0,13,37
59781,19,5,12,0,2,17
59782,26,20,3,1,2,24
59783,113,38,44,7,24,89
59784,78,33,35,1,9,69
59785,0,0,0,0,0,0
59786,16,5,6,0,5,11
59787,7,2,4,0,1,6
59788,132,99,3,0,30,102
59789,26,8,9,0,9,17
59790,271,150,34,32,55,216
59791,105,35,32,14,24,81
59792,4,1,3,0,0,4
59793,122,59,39,4,20,102
59794,54,11,28,5,10,44
59795,180,77,26,30,47,133
59796,32,21,9,0,2,30
59797,47,24,12,0,11,36
59798,46,18,20,0,8,38
59799,63,24,27,2,10,53
59800,35,24,2,3,6,29
59801,302,84,150,5,63,239
59802,146,67,50,3,26,120
59803,60,27,19,2,12,48
59804,39,24,10,2,3,36
59805,22,11,7,0,4,18
59806,32,21,9,0,2,30
59807,69,23,36,1,9,60
59808,49,35,6,3,5,44
59809,145,69,41,6,29,116
59810,99,50,25,5,19,80
59811,192,110,26,21,35,157
59812,58,27,19,0,12,46
59813,116,91,4,0,21,95
59814,26,14,8,0,4,22
59815,267,135,81,0,51,216
59816,32,21,9,0,2,30
59817,41,24,9,0,8,33
59818,7,2,2,0,3,4
59819,114,60,34,0,20,94
59820,13,9,4,0,0,13
59821,93,30,21,24,18,75
59822,71,11,26,17,17,54
59823,295,208,18,4,65,230
59824,47,21,21,0,5,42
59825,25,10,10,2,3,22
59826,156,77,49,1,29,127
59827,32,21,9,0,2,30
59828,23,3,15,2,3,20
59829,12,5,3,0,4,8
59830,61,39,5,4,13,48
59831,95,58,21,5,11,84
59832,10,4,4,0,2,8
59833,124,26,60,4,34,90
59834,566,410,41,1,114,452
59835,76,26,31,3,16,60
59836,6,2,3,0,1,5
59837,62,12,40,1,9,53
59838,11,11,0,0,0,11
59839,23,20,2,0,1,22
59840,581,334,121,16,110,471
59841,15,10,1,0,4,11
59842,82,37,32,0,13,69
59843,87,60,8,0,19,68
59844,57,22,25,0,10,47
59845,288,80,126,22,60,228
59846,49,26,9,0,14,35
59847,46,9,19,9,9,37
59848,77,35,19,6,17,60
59849,11,2,5,1,3,8
59850,334,144,109,10,71,263
59851,3,0,1,0,2,1
59852,177,87,35,22,33,144
59853,17,3,12,0,2,15
59854,78,27,26,6,19,59
59855,52,31,8,2,11,41
59856,669,395,136,20,118,551
59857,263,22,192,2,47,216
59858,181,73,41,21,46,135
59859,207,138,22,0,47,160
59860,32,21,9,0,2,30
59861,0,0,0,0,0,0
59862,19,9,5,0,5,14
59863,67,29,16,9,13,54
59864,5,3,2,0,0,5
59865,124,70,28,0,26,98
59866,435,207,122,14,92,343
59867,81,50,17,6,8,73
59868,57,9,32,6,10,47
59869,32,16,15,0,1,31
59870,50,20,11,8,11,39
59871,32,22,0,0,10,22
59872,59,35,17,0,7,52
59873,28,12,7,3,6,22
59874,29,12,13,0,4,25
59875,76,21,28,12,15,61
59876,46,0,37,0,9,37
59877,12,9,1,0,2,10
59878,28,3,19,0,6,22
59879,340,177,98,1,64,276
59880,28,7,7,5,9,19
59881,46,18,20,0,8,38
59882,14,9,1,0,4,10
59883,139,75,34,0,30,109
59884,24,11,10,0,3,21
59885,91,52,17,1,21,70
59886,20,14,1,0,5,15
59887,17,0,16,0,1,16
59888,182,65,51,24,42,140
59889,75,14,39,1,21,54
59890,61,36,16,0,9,52
59891,35,20,12,0,3,32
59892,103,76,12,8,7,96
59893,46,18,20,0,8,38
59894,166,116,13,0,37,129
59895,135,101,8,2,24,111
59896,55,5,35,1,14,41
59897,17,9,5,0,3,14
59898,30,18,7,0,5,25
59899,44,5,27,1,11,33
59900,433,206,141,12,74,359
59901,63,43,9,2,9,54
59902,160,100,4,18,38,122
59903,128,39,60,4,25,103
59904,22,8,8,0,6,16
59905,27,16,5,2,4,23
59906,56,3,41,1,11,45
59907,50,30,13,0,7,43
59908,98,54,17,5,22,76
59909,80,48,17,0,15,65
59910,88,44,26,4,14,74
59911,186,53,31,71,31,155
59912,106,35,36,13,22,84
59913,127,55,46,1,25,102
59914,22,9,6,1,6,16
59915,444,216,118,20,90,354
59916,61,27,17,4,13,48
59917,72,18,42,2,10,62
59918,43,27,8,2,6,37
59919,355,186,99,3,67,288
59920,33,12,11,0,10,23
59921,46,18,20,0,8,38
59922,24,8,11,0,5,19
59923,43,36,2,0,5,38
59924,32,16,7,0,9,23
59925,35,16,10,0,9,26
59926,32,21,9,0,2,30
59927,50,32,6,0,12,38
59928,93,47,27,1,18,75
59929,166,108,11,10,37,129
59930,13,6,3,0,4,9
59931,460,169,154,43,94,366
59932,33,6,19,0,8,25
59933,289,163,63,0,63,226
59934,13,5,5,0,3,10
59935,24,12,7,2,3,21
59936,73,25,34,1,13,60
59937,0,0,0,0,0,0
59938,7,2,4,0,1,6
59939,16,7,4,0,5,11
59940,123,66,34,0,23,100
59941,38,10,16,6,6,32
59942,13,3,7,0,3,10
59943,36,15,16,0,5,31
59944,22,1,13,1,7,15
59945,34,15,12,1,6,28
59946,29,19,3,0,7,22
59947,10,4,3,0,3,7
59948,40,6,24,4,6,34
59949,22,9,6,1,6,16
59950,134,71,31,9,23,111
59951,529,241,124,46,118,411
59952,41,14,23,1,3,38
59953,27,13,11,0,3,24
59954,64,34,15,0,15,49
59955,178,101,33,0,44,134
59956,67,47,1,0,19,48
59957,182,105,21,23,33,149
59958,36,1,26,3,6,30
59959,19,7,9,0,3,16
59960,56,24,14,4,14,42
59961,29,8,7,5,9,20
59962,126,92,5,0,29,97
59963,98,58,20,0,20,78
59964,23,16,4,0,3,20
59965,71,48,7,1,15,56
59966,9,5,0,1,3,6
59967,8,6,0,1,1,7
59968,28,7,7,6,8,20
59969,66,49,6,1,10,56
59970,366,163,128,6,69,297
59971,108,65,22,0,21,87
59972,32,21,9,0,2,30
59973,157,122,3,2,30,127
59974,9,1,8,0,0,9
59975,145,93,14,10,28,117
59976,54,14,32,1,7,47
59977,168,86,40,0,42,126
59978,32,21,9,0,2,30
59979,23,16,3,0,4,19
59980,72,33,18,4,17,55
59981,106,72,11,1,22,84
59982,14,8,3,1,2,12
59983,57,16,29,0,12,45
59984,33,3,24,0,6,27
59985,56,9,30,3,14,42
59986,201,120,46,0,35,166
59987,14,4,5,3,2,12
59988,8,0,4,0,4,4
59989,56,31,9,7,9,47
59990,116,40,30,27,19,97
59991,32,22,4,0,6,26
59992,101,37,38,5,21,80
59993,176,74,38,21,43,133
59994,7,4,2,0,1,6
59995,36,20,8,0,8,28
59996,47,19,20,0,8,39
59997,14,2,6,2,4,10
59998,23,3,13,1,6,17
59999,55,15,32,0,8,47
60000,17,10,5,0,2,15
60001,47,21,15,4,7,40
60002,15,8,4,0,3,12
60003,67,14,42,0,11,56
60004,45,22,15,1,7,38
60005,46,25,3,11,7,39
60006,28,12,9,0,7,21
60007,54,32,7,0,15,39
60008,29,9,14,0,6,23
60009,262,177,18,5,62,200
60010,188,104,54,0,30,158
60011,258,197,13,0,48,210
60012,3,1,1,0,1,2
60013,159,55,49,24,31,128
60014,17,5,8,0,4,13
60015,32,17,11,1,3,29
60016,41,30,5,0,6,35
60017,46,28,9,4,5,41
60018,159,77,49,1,32,127
60019,56,35,16,0,5,51
60020,126,75,21,3,27,99
60021,27,11,11,1,4,23
60022,46,26,14,0,6,40
60023,16,4,8,1,3,13
60024,32,21,9,0,2,30
60025,31,9,20,0,2,29
60026,29,7,17,2,3,26
60027,93,56,23,1,13,80
60028,13,5,5,0,3,10
60029,83,49,16,0,18,65
60030,72,48,11,5,8,64
60031,637,355,157,23,102,535
60032,65,50,12,0,3,62
60033,20,3,15,0,2,18
60034,216,55,40,84,37,179
60035,35,16,10,0,9,26
60036,90,73,2,2,13,77
60037,349,150,123,6,70,279
60038,121,8,82,9,22,99
60039,23,15,4,0,4,19
60040,42,26,9,1,6,36
60041,46,18,20,0,8,38
60042,28,13,10,0,5,23
60043,37,18,12,3,4,33
60044,249,17,185,0,47,202
60045,40,6,29,0,5,35
60046,68,26,6,23,13,55
60047,17,12,2,0,3,14
60048,125,55,20,18,32,93
60049,385,181,110,15,79,306
60050,31,9,8,6,8,23
60051,238,73,112,2,51,187
60052,62,42,9,2,9,53
60053,18,2,11,1,4,14
60054,98,43,34,4,17,81
60055,49,31,6,0,12,37
60056,425,113,201,10,101,324
60057,107,22,50,12,23,84
60058,82,28,33,8,13,69
60059,107,80,6,0,21,86
60060,34,16,12,0,6,28
60061,357,206,79,16,56,301
60062,29,6,19,0,4,25
60063,119,74,17,4,24,95
60064,67,20,18,16,13,54
60065,49,33,6,2,8,41
60066,44,36,2,0,6,38
60067,135,104,12,0,19,116
60068,156,68,33,25,30,126
60069,32,21,9,0,2,30
60070,139,49,32,23,35,104
60071,16,11,0,0,5,11
60072,84,46,19,1,18,66
60073,40,9,21,0,10,30
60074,49,30,12,0,7,42
60075,20,11,5,1,3,17
60076,70,40,16,2,12,58
60077,24,10,7,2,5,19
60078,89,51,16,4,18,71
60079,47,34,4,0,9,38
60080,21,8,10,0,3,18
60081,11,4,3,0,4,7
60082,9,6,2,0,1,8
60083,65,29,11,8,17,48
60084,206,89,45,24,48,158
60085,119,57,38,4,20,99
60086,57,29,13,1,14,43
60087,57,9,34,0,14,43
60088,15,5,8,0,2,13
60089,56,21,15,4,16,40
60090,517,276,85,49,107,410
60091,31,8,16,0,7,24
60092,15,4,11,0,0,15
60093,65,29,23,0,13,52
60094,36,15,11,2,8,28
60095,52,17,17,7,11,41
60096,41,11,16,4,10,31
60097,100,35,27,12,26,74
60098,7,3,3,0,1,6
60099,10,6,0,0,4,6
60100,55,39,6,1,9,46
60101,37,3,27,0,7,30
60102,79,38,15,14,12,67
60103,10,3,5,0,2,8
60104,43,31,1,0,11,32
60105,107,57,20,5,25,82
60106,24,1,15,0,8,16
60107,46,20,10,8,8,38
60108,39,6,23,0,10,29
60109,8,3,4,1,0,8
60110,5,5,0,0,0,5
60111,77,5,55,1,16,61
60112,57,0,39,3,15,42
60113,58,19,24,8,7,51
60114,52,36,5,3,8,44
60115,70,24,27,3,16,54
60116,36,16,9,3,8,28
60117,41,31,3,0,7,34
60118,85,34,31,0,20,65
60119,151,66,54,1,30,121
60120,1,0,0,0,1,0
60121,29,15,7,0,7,22
60122,32,21,9,0,2,30
60123,317,160,90,5,62,255
60124,86,44,27,4,11,75
60125,93,71,7,1,14,79
60126,45,22,15,0,8,37
60127,14,11,0,0,3,11
60128,58,21,32,0,5,53
60129,9,3,5,0,1,8
60130,14,13,0,0,1,13
60131,13,6,6,0,1,12
60132,101,25,53,3,20,81
60133,26,16,6,0,4,22
60134,93,26,41,6,20,73
60135,6,1,3,0,2,4
60136,29,6,21,0,2,27
60137,343,144,127,6,66,277
60138,89,24,41,3,21,68
60139,39,16,12,5,6,33
60140,53,19,28,0,6,47
60141,90,65,15,1,9,81
60142,57,28,8,8,13,44
60143,49,34,6,1,8,41
60144,176,82,55,0,39,137
60145,418,115,173,35,95,323
60146,34,8,18,0,8,26
60147,104,56,10,16,22,82
60148,48,13,25,0,10,38
60149,71,7,47,5,12,59
60150,82,9,46,10,17,65
60151,36,22,6,0,8,28
60152,50,37,2,0,11,39
60153,22,16,3,1,2,20
60154,78,36,24,0,18,60
60155,267,62,139,7,59,208
60156,72,42,19,0,11,61
60157,208,92,51,23,42,166
60158,337,171,107,3,56,281
60159,32,21,9,0,2,30
60160,30,18,6,2,4,26
60161,73,41,16,4,12,61
60162,167,92,40,0,35,132
60163,86,52,19,4,11,75
60164,55,27,11,0,17,38
60165,81,34,30,0,17,64
60166,128,86,18,1,23,105
60167,44,8,19,9,8,36
60168,194,77,34,34,49,145
60169,362,206,79,0,77,285
60170,131,39,65,1,26,105
60171,109,34,36,14,25,84
60172,102,58,8,18,18,84
60173,139,59,39,15,26,113
60174,133,100,6,0,27,106
60175,23,12,2,3,6,17
60176,388,288,19,2,79,309
60177,36,21,6,2,7,29
60178,17,5,8,0,4,13
60179,34,20,7,0,7,27
60180,111,35,63,0,13,98
60181,31,4,19,4,4,27
60182,30,2,22,1,5,25
60183,43,14,17,4,8,35
60184,193,72,85,3,33,160
60185,7,5,0,0,2,5
60186,563,347,96,7,113,450
60187,56,15,19,6,16,40
60188,59,12,7,29,11,48
60189,45,6,27,0,12,33
60190,60,47,6,0,7,53
60191,15,6,5,2,2,13
60192,47,13,15,5,14,33
60193,220,119,35,31,35,185
60194,13,3,8,1,1,12
60195,59,30,15,2,12,47
60196,428,195,107,39,87,341
60197,87,31,18,10,28,59
60198,86,57,15,0,14,72
60199,18,5,9,0,4,14
60200,23,9,9,0,5,18
60201,96,32,33,15,16,80
60202,539,244,131,46,118,421
60203,474,218,158,12,86,388
60204,34,15,8,1,10,24
60205,167,16,94,22,35,132
60206,35,2,26,0,7,28
60207,344,187,88,15,54,290
60208,44,26,11,0,7,37
60209,33,12,14,0,7,26
60210,464,213,158,9,84,380
60211,94,56,20,0,18,76
60212,18,13,2,0,3,15
60213,62,47,5,4,6,56
60214,22,5,10,2,5,17
60215,426,129,182,25,90,336
60216,67,44,11,1,11,56
60217,17,6,4,5,2,15
60218,55,33,15,2,5,50
60219,331,139,118,6,68,263
60220,26,8,10,2,6,20
60221,41,34,2,0,5,36
60222,403,114,185,11,93,310
60223,65,28,25,1,11,54
60224,20,12,6,1,1,19
60225,19,7,8,0,4,15
60226,110,69,12,5,24,86
60227,24,4,13,2,5,19
60228,51,31,13,0,7,44
60229,94,29,46,4,15,79
60230,30,6,15,3,6,24
60231,16,3,6,0,7,9
60232,24,5,10,4,5,19
60233,264,173,72,2,17,247
60234,66,30,30,0,6,60
60235,24,10,5,1,8,16
60236,15,7,5,0,3,12
60237,28,12,11,0,5,23
60238,32,21,9,0,2,30
60239,57,41,3,1,12,45
60240,71,35,20,2,14,57
60241,146,37,76,1,32,114
60242,14,4,3,2,5,9
60243,223,91,41,38,53,170
60244,57,31,16,0,10,47
60245,127,75,22,3,27,100
60246,14,5,5,0,4,10
60247,24,10,7,2,5,19
60248,37,28,5,0,4,33
60249,27,15,5,0,7,20
60250,71,47,9,2,13,58
60251,3,0,1,1,1,2
60252,36,7,24,0,5,31
60253,44,16,14,5,9,35
60254,51,12,28,0,11,40
60255,44,10,21,0,13,31
60256,40,1,36,0,3,37
60257,178,101,33,0,44,134
60258,77,21,42,2,12,65
60259,64,18,31,1,14,50
60260,32,21,9,0,2,30
60261,10,2,3,0,5,5
60262,211,45,128,0,38,173
60263,12,4,6,2,0,12
60264,179,79,29,28,43,136
60265,39,14,18,3,4,35
60266,17,2,10,1,4,13
60267,162,79,25,27,31,131
60268,411,226,100,0,85,326
60269,64,42,7,1,14,50
60270,130,65,29,15,21,109
60271,47,32,2,1,12,35
60272,114,60,34,0,20,94
60273,22,5,14,0,3,19
60274,1,0,0,0,1,0
60275,634,368,145,16,105,529
60276,255,148,22,33,52,203
60277,100,26,39,14,21,79
60278,196,62,95,0,39,157
60279,26,17,3,0,6,20
60280,38,15,17,2,4,34
60281,45,30,7,0,8,37
60282,29,5,21,0,3,26
60283,80,19,46,2,13,67
60284,43,23,12,4,4,39
60285,57,47,3,1,6,51
60286,64,5,45,0,14,50
60287,44,4,32,0,8,36
60288,430,240,109,0,81,349
60289,1,0,0,0,1,0
60290,21,6,8,0,7,14
60291,51,8,29,4,10,41
60292,410,211,114,18,67,343
60293,26,11,9,0,6,20
60294,40,33,1,0,6,34
60295,283,152,68,0,63,220
60296,71,48,7,1,15,56
60297,9,3,3,0,3,6
60298,30,10,11,2,7,23
60299,16,2,10,1,3,13
60300,102,60,20,6,16,86
60301,40,12,18,0,10,30
60302,19,6,5,2,6,13
60303,159,75,32,13,39,120
60304,64,32,15,5,12,52
60305,90,71,0,4,15,75
60306,22,2,17,0,3,19
60307,80,37,12,9,22,58
60308,12,8,2,0,2,10
60309,29,2,20,2,5,24
60310,28,13,2,11,2,26
60311,62,31,7,5,19,43
60312,60,36,17,0,7,53
60313,35,21,8,0,6,29
60314,19,5,7,1,6,13
60315,289,135,101,3,50,239
60316,38,26,5,1,6,32
60317,60,28,23,0,9,51
60318,135,61,42,11,21,114
60319,24,10,8,1,5,19
60320,80,37,26,2,15,65
60321,46,28,10,0,8,38
60322,39,21,10,1,7,32
60323,102,24,48,10,20,82
60324,57,22,21,1,13,44
60325,61,27,16,4,14,47
60326,512,254,101,55,102,410
60327,76,31,8,17,20,56
60328,180,64,52,27,37,143
60329,50,19,20,0,11,39
60330,89,34,20,10,25,64
60331,12,6,1,0,5,7
60332,110,49,33,2,26,84
60333,369,197,104,3,65,304
60334,75,32,34,1,8,67
60335,31,17,3,4,7,24
60336,437,136,161,46,94,343
60337,43,19,18,0,6,37
60338,30,17,7,2,4,26
60339,2,2,0,0,0,2
60340,52,29,7,7,9,43
60341,25,10,9,1,5,20
60342,33,14,9,2,8,25
60343,25,15,7,0,3,22
60344,35,23,8,1,3,32
60345,121,54,18,18,31,90
60346,34,13,13,1,7,27
60347,211,114,48,0,49,162
60348,7,2,4,0,1,6
60349,50,26,14,0,10,40
60350,102,67,15,3,17,85
60351,149,110,6,0,33,116
60352,62,41,8,0,13,49
60353,64,19,33,1,11,53
60354,43,10,22,0,11,32
60355,241,104,92,1,44,197
60356,3,0,0,1,2,1
60357,103,47,35,4,17,86
60358,114,69,21,7,17,97
60359,139,49,36,29,25,114
60360,282,143,84,0,55,227
60361,7,6,1,0,0,7
60362,33,10,18,2,3,30
60363,41,25,9,0,7,34
60364,58,28,17,4,9,49
60365,76,62,2,0,12,64
60366,83,58,5,7,13,70
60367,295,148,86,12,49,246
60368,27,8,14,0,5,22
60369,10,8,1,0,1,9
60370,4,0,2,0,2,2
60371,42,29,1,2,10,32
60372,56,23,21,2,10,46
60373,299,178,54,0,67,232
60374,128,41,49,15,23,105
60375,7,3,2,1,1,6
60376,150,96,3,15,36,114
60377,66,41,8,2,15,51
60378,324,170,86,15,53,271
60379,54,11,27,5,11,43
60380,91,36,33,0,22,69
60381,103,33,40,7,23,80
60382,215,132,37,6,40,175
60383,44,7,27,2,8,36
60384,64,17,31,8,8,56
60385,18,7,10,0,1,17
60386,275,151,78,0,46,229
60387,32,21,9,0,2,30
60388,104,30,57,0,17,87
60389,45,30,8,0,7,38
60390,282,67,164,1,50,232
60391,15,4,9,1,1,14
60392,31,15,9,0,7,24
60393,114,36,48,7,23,91
60394,421,311,20,0,90,331
60395,49,13,26,0,10,39
60396,435,134,177,26,98,337
60397,40,8,24,2,6,34
60398,73,57,2,1,13,60
60399,45,15,15,13,2,43
60400,110,39,41,12,18,92
60401,103,45,21,19,18,85
60402,32,21,9,0,2,30
60403,11,6,2,1,2,9
60404,89,37,36,0,16,73
60405,79,51,7,2,19,60
60406,40,18,11,4,7,33
60407,56,39,8,1,8,48
60408,21,9,7,2,3,18
60409,396,195,99,26,76,320
60410,17,5,6,3,3,14
60411,165,71,37,24,33,132
60412,45,16,17,0,12,33
60413,33,16,7,0,10,23
60414,8,5,1,1,1,7
60415,46,18,20,0,8,38
60416,26,2,17,2,5,21
60417,176,109,15,13,39,137
60418,17,4,7,2,4,13
60419,67,9,47,3,8,59
60420,439,143,160,47,89,350
60421,46,26,10,0,10,36
60422,26,0,19,0,7,19
60423,31,10,7,10,4,27
60424,32,16,8,0,8,24
60425,158,114,20,0,24,134
60426,557,331,123,14,89,468
60427,432,128,180,33,91,341
60428,72,48,11,2,11,61
60429,73,41,14,0,18,55
60430,45,9,12,16,8,37
60431,20,9,8,0,3,17
60432,32,4,21,0,7,25
60433,206,92,58,13,43,163
60434,3,0,3,0,0,3
60435,63,17,35,3,8,55
60436,159,72,52,5,30,129
60437,126,90,6,5,25,101
60438,35,19,5,1,10,25
60439,157,44,51,26,36,121
60440,6,4,1,0,1,5
60441,149,95,29,0,25,124
60442,31,4,12,5,10,21
60443,130,103,7,0,20,110
60444,19,3,9,1,6,13
60445,46,18,20,0,8,38
60446,19,2,16,0,1,18
60447,434,201,99,43,91,343
60448,32,21,9,0,2,30
60449,32,21,9,0,2,30
60450,61,40,11,2,8,53
60451,161,121,12,1,27,134
60452,124,60,16,20,28,96
60453,26,18,2,0,6,20
60454,444,232,111,14,87,357
60455,276,93,126,14,43,233
60456,40,14,17,2,7,33
60457,119,72,24,0,23,96
60458,222,111,39,34,38,184
60459,78,48,19,0,11,67
60460,18,5,7,0,6,12
60461,98,43,34,4,17,81
60462,342,147,120,6,69,273
60463,73,40,4,15,14,59
60464,166,99,38,1,28,138
60465,621,378,97,9,137,484
60466,70,33,24,2,11,59
60467,32,21,9,0,2,30
60468,22,7,13,0,2,20
60469,32,21,9,0,2,30
60470,2,2,0,0,0,2
60471,13,5,3,1,4,9
60472,82,50,13,5,14,68
60473,17,9,5,0,3,14
60474,47,5,7,23,12,35
60475,30,15,9,0,6,24
60476,25,15,7,0,3,22
60477,48,26,16,0,6,42
60478,21,2,16,0,3,18
60479,1,1,0,0,0,1
60480,64,17,23,10,14,50
60481,7,3,4,0,0,7
60482,74,37,14,6,17,57
60483,237,160,17,3,57,180
60484,74,31,25,3,15,59
60485,22,7,6,3,6,16
60486,79,41,15,5,18,61
60487,116,47,44,0,25,91
60488,13,10,0,2,1,12
60489,81,38,27,2,14,67
60490,43,19,18,0,6,37
60491,98,51,29,3,15,83
60492,170,56,54,25,35,135
60493,102,66,26,0,10,92
60494,73,26,34,0,13,60
60495,96,23,54,2,17,79
60496,60,42,5,1,12,48
60497,138,80,22,3,33,105
60498,19,8,6,1,4,15
60499,32,13,9,2,8,24
60500,46,18,20,0,8,38
60501,37,13,17,0,7,30
60502,141,56,55,3,27,114
60503,8,5,3,0,0,8
60504,32,21,9,0,2,30
60505,115,71,23,0,21,94
60506,50,30,13,0,7,43
60507,343,190,92,0,61,282
60508,56,3,41,1,11,45
60509,1,0,1,0,0,1
60510,74,49,16,2,7,67
60511,70,44,12,3,11,59
60512,631,366,147,17,101,530
60513,32,19,5,0,8,24
60514,67,28,20,3,16,51
60515,218,148,30,0,40,178
60516,74,17,39,1,17,57
60517,142,109,6,0,27,115
60518,613,421,57,1,134,479
60519,10,3,4,0,3,7
60520,19,11,3,0,5,14
60521,72,36,6,18,12,60
60522,14,4,7,0,3,11
60523,118,59,22,11,26,92
60524,403,230,91,0,82,321
60525,38,15,4,10,9,29
60526,101,26,52,3,20,81
60527,92,48,13,2,29,63
60528,38,6,23,0,9,29
60529,58,30,14,1,13,45
60530,55,8,36,0,11,44
60531,35,25,1,0,9,26
60532,56,19,27,0,10,46
60533,96,67,14,0,15,81
60534,10,4,3,0,3,7
60535,144,34,80,1,29,115
60536,171,56,56,26,33,138
60537,57,26,21,3,7,50
60538,45,24,11,1,9,36
60539,85,51,17,2,15,70
60540,6,2,4,0,0,6
60541,219,74,97,2,46,173
60542,221,97,82,1,41,180
60543,138,80,22,3,33,105
60544,100,52,23,1,24,76
60545,133,47,29,27,30,103
60546,31,19,4,0,8,23
60547,95,34,34,2,25,70
60548,82,57,10,1,14,68
60549,114,25,42,23,24,90
60550,83,24,46,2,11,72
60551,97,42,34,4,17,80
60552,74,45,14,3,12,62
60553,386,186,114,13,73,313
60554,429,235,96,12,86,343
60555,269,135,83,0,51,218
60556,67,31,5,17,14,53
60557,178,92,50,0,36,142
60558,17,7,9,0,1,16
60559,16,9,1,1,5,11
60560,42,20,10,3,9,33
60561,104,55,22,4,23,81
60562,98,56,18,1,23,75
60563,214,99,63,13,39,175
60564,55,20,26,0,9,46
60565,93,64,6,0,23,70
60566,42,14,19,0,9,33
60567,89,34,39,2,14,75
60568,418,121,185,15,97,321
60569,73,56,3,0,14,59
60570,70,47,7,1,15,55
60571,5,0,5,0,0,5
60572,204,77,40,38,49,155
60573,45,16,19,0,10,35
60574,377,223,67,14,73,304
60575,155,61,42,19,33,122
60576,124,55,42,1,26,98
60577,171,90,33,17,31,140
60578,58,20,25,4,9,49
60579,516,236,116,55,109,407
60580,18,4,8,0,6,12
60581,15,2,6,2,5,10
60582,24,10,7,2,5,19
60583,173,79,58,3,33,140
60584,20,7,11,0,2,18
60585,233,79,90,15,49,184
60586,13,1,9,0,3,10
60587,69,46,9,0,14,55
60588,21,12,2,5,2,19
60589,184,128,43,2,11,173
60590,63,27,21,3,12,51
60591,31,4,17,0,10,21
60592,12,2,6,0,4,8
60593,31,10,4,11,6,25
60594,357,192,86,7,72,285
60595,234,94,14,83,43,191
60596,14,5,5,0,4,10
60597,96,40,42,1,13,83
60598,680,377,165,24,114,566
60599,113,54,32,5,22,91
60600,20,12,5,0,3,17
60601,13,3,8,0,2,11
60602,14,9,3,0,2,12
60603,46,18,20,0,8,38
60604,21,4,6,9,2,19
60605,139,100,10,0,29,110
60606,41,2,33,1,5,36
60607,46,27,7,1,11,35
60608,141,46,67,4,24,117
60609,0,0,0,0,0,0
60610,46,18,20,0,8,38
60611,82,53,7,2,20,62
60612,41,8,26,0,7,34
60613,126,75,21,3,27,99
60614,54,19,18,7,10,44
60615,145,61,32,23,29,116
60616,32,19,6,1,6,26
60617,73,41,15,2,15,58
60618,66,26,25,2,13,53
60619,41,13,14,6,8,33
60620,59,9,9,27,14,45
60621,17,13,0,0,4,13
60622,16,13,0,0,3,13
60623,13,7,2,0,4,9
60624,61,24,27,1,9,52
60625,132,49,54,13,16,116
60626,90,20,38,12,20,70
60627,43,17,13,3,10,33
60628,97,69,10,0,18,79
60629,168,53,58,25,32,136
60630,9,7,1,0,1,8
60631,62,23,21,1,17,45
60632,343,146,121,6,70,273
60633,4,3,1,0,0,4
60634,142,47,56,8,31,111
60635,124,70,28,0,26,98
60636,54,18,26,5,5,49
60637,44,19,18,1,6,38
60638,77,21,36,7,13,64
60639,31,19,6,1,5,26
60640,62,37,11,0,14,48
60641,534,388,36,1,109,425
60642,14,8,4,1,1,13
60643,78,36,5,16,21,57
60644,114,49,14,18,33,81
60645,86,20,48,0,18,68
60646,21,0,19,0,2,19
60647,10,5,4,1,0,10
60648,268,199,15,0,54,214
60649,293,203,22,2,66,227
60650,420,139,147,47,87,333
60651,50,24,16,0,10,40
60652,76,39,17,2,18,58
60653,94,35,19,10,30,64
60654,126,46,27,22,31,95
60655,55,7,35,0,13,42
60656,294,72,44,130,48,246
60657,639,376,138,15,110,529
60658,6,4,1,0,1,5
60659,326,140,112,6,68,258
60660,130,101,7,0,22,108
60661,10,4,4,0,2,8
60662,100,28,54,0,18,82
60663,147,37,76,1,33,114
60664,61,48,6,0,7,54
60665,512,278,86,44,104,408
60666,86,33,23,14,16,70
60667,26,4,20,0,2,24
60668,45,0,34,0,11,34
60669,46,18,20,0,8,38
60670,85,47,15,11,12,73
60671,206,89,59,20,38,168
60672,348,150,124,6,68,280
60673,16,8,4,0,4,12
60674,58,34,13,0,11,47
60675,32,21,9,0,2,30
60676,36,18,12,2,4,32
60677,20,3,11,2,4,16
60678,90,32,5,41,12,78
60679,96,51,13,17,15,81
60680,216,80,62,30,44,172
60681,61,17,30,2,12,49
60682,97,63,9,3,22,75
60683,44,3,28,0,13,31
60684,64,41,11,3,9,55
60685,72,43,8,3,18,54
60686,46,18,20,0,8,38
60687,146,37,76,1,32,114
60688,75,51,8,0,16,59
60689,10,6,0,0,4,6
60690,24,10,7,2,5,19
60691,126,28,40,24,34,92
60692,102,58,19,3,22,80
60693,32,21,9,0,2,30
60694,5,2,2,0,1,4
60695,17,16,0,0,1,16
60696,114,50,39,4,21,93
60697,23,15,2,0,6,17
60698,448,141,184,26,97,351
60699,62,30,13,3,16,46
60700,14,1,9,0,4,10
60701,104,56,34,7,7,97
60702,210,92,63,19,36,174
60703,66,5,46,0,15,51
60704,89,21,42,16,10,79
60705,67,28,16,10,13,54
60706,80,7,57,5,11,69
60707,21,12,7,0,2,19
60708,45,30,10,0,5,40
60709,13,10,0,0,3,10
60710,21,5,11,0,5,16
60711,120,59,22,17,22,98
60712,43,32,0,0,11,32
60713,198,35,130,2,31,167
60714,178,101,33,0,44,134
60715,85,35,34,5,11,74
60716,15,8,4,0,3,12
60717,62,40,10,2,10,52
60718,137,73,35,0,29,108
60719,357,158,124,6,69,288
60720,117,40,58,0,19,98
60721,80,30,30,2,18,62
60722,10,5,2,1,2,8
60723,171,114,27,1,29,142
60724,7,6,1,0,0,7
60725,46,18,20,0,8,38
60726,12,2,4,1,5,7
60727,37,6,22,0,9,28
60728,166,126,3,1,36,130
60729,8,2,6,0,0,8
60730,438,278,56,7,97,341
60731,9,0,7,0,2,7
60732,49,4,36,0,9,40
60733,86,18,46,8,14,72
60734,109,55,33,5,16,93
60735,97,61,25,0,11,86
60736,40,19,14,1,6,34
60737,29,20,6,1,2,27
60738,383,205,103,3,72,311
60739,22,9,3,3,7,15
60740,9,2,3,0,4,5
60741,19,5,0,8,6,13
60742,340,145,120,6,69,271
60743,342,146,120,6,70,272
60744,152,44,69,4,35,117
60745,46,8,22,6,10,36
60746,88,52,21,3,12,76
60747,462,218,145,13,86,376
60748,30,12,13,0,5,25
60749,9,3,5,0,1,8
60750,143,115,4,0,24,119
60751,50,27,13,2,8,42
60752,41,9,15,11,6,35
60753,26,9,11,1,5,21
60754,29,8,17,0,4,25
60755,23,9,9,0,5,18
60756,269,138,90,0,41,228
60757,12,1,8,0,3,9
60758,32,21,9,0,2,30
60759,32,21,9,0,2,30
60760,149,58,38,21,32,117
60761,423,198,121,13,91,332
60762,64,39,9,2,14,50
60763,82,55,11,0,16,66
60764,31,5,20,0,6,25
60765,61,23,17,7,14,47
60766,142,86,30,0,26,116
60767,50,30,11,0,9,41
60768,34,24,2,0,8,26
60769,25,2,17,1,5,20
60770,277,17,205,2,53,224
60771,40,10,20,5,5,35
60772,55,24,20,0,11,44
60773,58,45,6,0,7,51
60774,59,28,15,3,13,46
60775,6,2,2,0,2,4
60776,124,38,56,3,27,97
60777,51,13,23,1,14,37
60778,8,2,3,0,3,5
60779,354,160,120,5,69,285
60780,33,8,18,4,3,30
60781,29,14,9,0,6,23
60782,225,151,34,0,40,185
60783,32,21,9,0,2,30
60784,81,46,14,6,15,66
60785,277,56,169,1,51,226
60786,8,0,3,0,5,3
60787,61,32,11,6,12,49
60788,58,34,16,0,8,50
60789,97,19,49,12,17,80
60790,28,3,20,0,5,23
60791,10,3,5,0,2,8
60792,64,18,31,1,14,50
60793,10,0,10,0,0,10
60794,42,5,29,0,8,34
60795,40,23,3,8,6,34
60796,13,7,3,1,2,11
60797,32,21,9,0,2,30
60798,34,8,13,2,11,23
60799,38,6,24,4,4,34
60800,55,27,11,0,17,38
60801,62,18,28,2,14,48
60802,30,10,13,0,7,23
60803,31,9,13,2,7,24
60804,100,49,22,7,22,78
60805,52,33,8,0,11,41
60806,21,15,3,0,3,18
60807,27,16,6,0,5,22
60808,11,2,5,1,3,8
60809,29,14,9,3,3,26
60810,48,27,11,0,10,38
60811,164,74,52,7,31,133
60812,12,9,0,0,3,9
60813,7,1,4,0,2,5
60814,55,26,17,4,8,47
60815,46,18,20,0,8,38
60816,30,23,0,0,7,23
60817,46,18,20,0,8,38
60818,91,61,9,4,17,74
60819,56,11,24,7,14,42
60820,131,40,48,18,25,106
60821,25,10,7,4,4,21
60822,471,224,99,52,96,375
60823,75,47,8,5,15,60
60824,153,96,32,1,24,129
60825,95,12,62,0,21,74
60826,44,20,14,2,8,36
60827,16,3,7,0,6,10
60828,35,22,4,4,5,30
60829,87,62,10,2,13,74
60830,114,27,54,5,28,86
60831,46,18,20,0,8,38
60832,59,47,2,0,10,49
60833,6,2,4,0,0,6
60834,31,13,12,1,5,26
60835,102,67,1,12,22,80
60836,89,32,37,8,12,77
60837,31,9,20,0,2,29
60838,20,11,4,1,4,16
60839,77,28,29,1,19,58
60840,61,14,32,1,14,47
60841,49,19,25,0,5,44
60842,342,147,120,6,69,273
60843,349,191,89,15,54,295
60844,36,22,6,0,8,28
60845,37,12,20,0,5,32
60846,46,18,20,0,8,38
60847,54,44,1,0,9,45
60848,91,10,53,6,22,69
60849,85,45,20,1,19,66
60850,46,18,20,0,8,38
60851,13,7,3,1,2,11
60852,46,18,20,0,8,38
60853,123,38,52,8,25,98
60854,82,45,22,4,11,71
60855,67,29,25,0,13,54
60856,43,11,25,1,6,37
60857,47,17,19,2,9,38
60858,43,19,15,2,7,36
60859,11,6,5,0,0,11
60860,39,0,28,0,11,28
60861,20,11,4,1,4,16
60862,510,356,47,1,106,404
60863,525,290,114,12,109,416
60864,82,38,31,1,12,70
60865,89,35,5,37,12,77
60866,70,44,11,2,13,57
60867,33,3,6,17,7,26
60868,46,18,20,0,8,38
60869,36,7,19,4,6,30
60870,375,270,20,0,85,290
60871,9,3,3,0,3,6
60872,135,77,22,9,27,108
60873,37,22,6,2,7,30
60874,173,50,53,36,34,139
60875,80,43,9,18,10,70
60876,49,17,20,1,11,38
60877,159,13,90,25,31,128
60878,316,151,99,12,54,262
60879,42,15,17,0,10,32
60880,6,4,2,0,0,6
60881,131,72,27,5,27,104
60882,115,42,35,16,22,93
60883,133,28,48,30,27,106
60884,26,15,6,0,5,21
60885,78,35,31,0,12,66
60886,43,25,8,0,10,33
60887,64,5,45,0,14,50
60888,93,68,5,0,20,73
60889,71,42,16,0,13,58
60890,63,36,19,1,7,56
60891,163,84,40,0,39,124
60892,53,34,13,0,6,47
60893,414,199,102,30,83,331
60894,78,31,25,7,15,63
60895,206,102,34,33,37,169
60896,27,18,4,0,5,22
60897,163,115,12,0,36,127
60898,55,19,16,6,14,41
60899,42,21,6,3,12,30
60900,64,12,35,4,13,51
60901,15,3,5,4,3,12
60902,34,21,7,0,6,28
60903,69,42,15,0,12,57
60904,71,43,19,0,9,62
60905,269,187,19,4,59,210
60906,74,45,8,8,13,61
60907,31,17,9,0,5,26
60908,25,7,10,0,8,17
60909,26,17,5,0,4,22
60910,69,19,30,2,18,51
60911,25,0,20,1,4,21
60912,547,380,50,1,116,431
60913,37,12,10,2,13,24
60914,19,2,13,0,4,15
60915,91,42,33,1,15,76
60916,8,2,1,0,5,3
60917,414,309,20,0,85,329
60918,14,5,5,0,4,10
60919,34,16,13,0,5,29
60920,14,4,4,3,3,11
60921,138,79,23,3,33,105
60922,175,91,56,0,28,147
60923,58,12,27,3,16,42
60924,589,411,51,1,126,463
60925,62,46,7,0,9,53
60926,8,7,0,0,1,7
60927,88,55,15,4,14,74
60928,35,9,15,1,10,25
60929,111,75,15,1,20,91
60930,86,37,20,9,20,66
60931,220,94,14,76,36,184
60932,30,23,3,1,3,27
60933,28,10,8,2,8,20
60934,75,19,31,0,25,50
60935,49,29,11,1,8,41
60936,226,75,86,15,50,176
60937,140,56,44,9,31,109
60938,131,109,5,0,17,114
60939,29,8,15,0,6,23
60940,92,60,14,11,7,85
60941,234,127,32,29,46,188
60942,113,46,25,17,25,88
60943,63,52,1,0,10,53
60944,258,194,13,0,51,207
60945,217,123,42,13,39,178
60946,102,67,15,3,17,85
60947,41,4,28,0,9,32
60948,33,22,4,0,7,26
60949,32,21,9,0,2,30
60950,107,51,26,6,24,83
60951,119,66,14,15,24,95
60952,77,47,11,4,15,62
60953,74,36,30,1,7,67
60954,46,18,20,0,8,38
60955,52,17,22,2,11,41
60956,38,2,30,0,6,32
60957,174,129,5,1,39,135
60958,12,3,7,0,2,10
60959,10,2,6,0,2,8
60960,14,6,4,0,4,10
60961,12,5,3,1,3,9
60962,16,1,11,0,4,12
60963,15,5,7,0,3,12
60964,32,15,9,5,3,29
60965,50,30,8,3,9,41
60966,21,1,13,1,6,15
60967,99,34,45,1,19,80
60968,42,20,12,2,8,34
60969,197,96,58,1,42,155
60970,147,83,17,20,27,120
60971,93,45,27,7,14,79
60972,12,6,3,1,2,10
60973,13,1,6,3,3,10
60974,123,66,23,6,28,95
60975,46,18,20,0,8,38
60976,67,19,28,6,14,53
60977,13,7,1,0,5,8
60978,30,11,14,0,5,25
60979,52,9,30,3,10,42
60980,162,54,72,0,36,126
60981,55,33,15,2,5,50
60982,53,39,8,0,6,47
60983,179,23,124,0,32,147
60984,40,25,7,0,8,32
60985,81,46,17,4,14,67
60986,7,2,3,0,2,5
60987,7,0,6,0,1,6
60988,27,10,12,2,3,24
60989,41,4,29,0,8,33
60990,31,12,12,0,7,24
60991,180,49,53,42,36,144
60992,228,152,20,3,53,175
60993,18,13,2,0,3,15
60994,195,76,36,34,49,146
60995,8,0,6,0,2,6
60996,69,48,9,0,12,57
60997,78,36,23,3,16,62
60998,134,105,11,0,18,116
60999,53,31,14,6,2,51
61000,21,5,5,3,8,13
61001,53,33,14,0,6,47
61002,36,25,2,3,6,30
61003,112,56,37,0,19,93
61004,128,62,37,6,23,105
61005,33,3,6,17,7,26
61006,33,16,4,5,8,25
61007,461,137,191,34,99,362
61008,68,42,13,0,13,55
61009,101,50,23,4,24,77
61010,31,15,9,0,7,24
61011,47,28,10,1,8,39
61012,25,9,10,4,2,23
61013,32,21,9,0,2,30
61014,46,18,20,0,8,38
61015,12,4,3,0,5,7
61016,102,66,6,8,22,80
61017,4,0,2,0,2,2
61018,128,36,65,1,26,102
61019,218,148,30,0,40,178
61020,28,11,15,0,2,26
61021,47,29,8,0,10,37
61022,20,7,6,2,5,15
61023,81,50,11,0,20,61
61024,33,23,2,0,8,25
61025,42,9,15,9,9,33
61026,446,220,119,14,93,353
61027,33,1,26,1,5,28
61028,131,59,28,17,27,104
61029,15,0,11,0,4,11
61030,47,32,7,3,5,42
61031,111,80,11,0,20,91
61032,17,10,2,1,4,13
61033,103,22,50,14,17,86
61034,22,4,12,1,5,17
61035,84,37,9,14,24,60
61036,157,108,26,0,23,134
61037,52,37,4,1,10,42
61038,89,40,28,3,18,71
61039,178,102,32,0,44,134
61040,44,35,2,2,5,39
61041,89,49,25,4,11,78
61042,171,112,11,10,38,133
61043,46,18,20,0,8,38
61044,78,16,40,1,21,57
61045,24,6,14,1,3,21
61046,7,0,3,0,4,3
61047,0,0,0,0,0,0
61048,134,52,51,0,31,103
61049,61,18,33,1,9,52
61050,76,51,9,0,16,60
61051,306,88,147,5,66,240
61052,63,22,30,0,11,52
61053,407,192,119,11,85,322
61054,128,70,23,4,31,97
61055,42,23,9,0,10,32
61056,212,157,22,1,32,180
61057,18,2,11,3,2,16
61058,82,46,20,3,13,69
61059,316,190,57,0,69,247
61060,148,50,41,31,26,122
61061,96,48,20,4,24,72
61062,77,55,4,0,18,59
61063,63,39,14,1,9,54
61064,550,394,40,1,115,435
61065,55,18,23,1,13,42
61066,29,12,12,0,5,24
61067,27,9,12,1,5,22
61068,45,11,24,0,10,35
61069,24,3,19,0,2,22
61070,140,38,79,4,19,121
61071,111,35,40,15,21,90
61072,277,211,17,0,49,228
61073,37,22,6,2,7,30
61074,55,34,10,0,11,44
61075,87,36,34,0,17,70
61076,69,38,10,9,12,57
61077,32,13,13,0,6,26
61078,52,27,15,2,8,44
61079,32,21,9,0,2,30
61080,77,17,37,5,18,59
61081,636,390,104,8,134,502
61082,4,1,3,0,0,4
61083,46,18,20,0,8,38
61084,6,2,0,2,2,4
61085,28,14,7,3,4,24
61086,43,18,14,2,9,34
61087,110,48,29,13,20,90
61088,40,21,11,1,7,33
61089,36,14,14,0,8,28
61090,33,9,17,0,7,26
61091,44,18,15,3,8,36
61092,23,14,3,4,2,21
61093,52,22,17,0,13,39
61094,160,62,43,20,35,125
61095,174,124,14,1,35,139
61096,57,21,18,7,11,46
61097,186,75,44,22,45,141
61098,140,24,52,24,40,100
61099,44,16,16,2,10,34
61100,34,15,11,0,8,26
61101,34,16,9,0,9,25
61102,53,35,6,1,11,42
61103,377,172,125,6,74,303
61104,44,32,5,2,5,39
61105,32,21,9,0,2,30
61106,17,0,13,0,4,13
61107,76,19,37,1,19,57
61108,55,20,19,1,15,40
61109,114,92,6,2,14,100
61110,32,16,2,5,9,23
61111,35,5,18,6,6,29
61112,229,173,9,0,47,182
61113,410,195,132,9,74,336
61114,32,21,9,0,2,30
61115,207,111,34,23,39,168
61116,46,23,15,4,4,42
61117,415,239,87,17,72,343
61118,66,21,28,3,14,52
61119,74,32,36,0,6,68
61120,71,7,8,36,20,51
61121,21,9,5,0,7,14
61122,178,77,53,10,38,140
61123,172,51,46,40,35,137
61124,146,56,26,27,37,109
61125,207,87,66,19,35,172
61126,55,39,2,0,14,41
61127,316,78,155,4,79,237
61128,178,101,33,0,44,134
61129,39,12,7,12,8,31
61130,70,29,13,14,14,56
61131,257,63,133,4,57,200
61132,56,13,33,0,10,46
61133,17,10,0,3,4,13
61134,29,8,14,2,5,24
61135,102,68,1,12,21,81
61136,115,45,37,9,24,91
61137,24,5,11,0,8,16
61138,23,9,9,0,5,18
61139,47,12,29,0,6,41
61140,21,8,7,2,4,17
61141,21,11,7,0,3,18
61142,205,85,16,65,39,166
61143,90,36,28,11,15,75
61144,102,24,55,3,20,82
61145,78,53,10,0,15,63
61146,89,54,26,5,4,85
61147,214,46,55,73,40,174
61148,18,0,12,1,5,13
61149,27,7,10,4,6,21
61150,113,40,33,15,25,88
61151,46,18,20,0,8,38
61152,72,16,44,0,12,60
61153,373,213,86,15,59,314
61154,77,49,15,0,13,64
61155,27,1,18,0,8,19
61156,46,31,8,0,7,39
61157,142,70,18,23,31,111
61158,26,14,6,0,6,20
61159,153,27,63,23,40,113
61160,141,62,25,19,35,106
61161,74,39,12,7,16,58
61162,105,32,46,6,21,84
61163,85,44,14,6,21,64
61164,89,30,39,1,19,70
61165,142,58,32,24,28,114
61166,9,5,0,1,3,6
61167,161,106,23,4,28,133
61168,135,104,6,0,25,110
61169,241,110,67,21,43,198
61170,70,28,27,1,14,56
61171,177,133,5,1,38,139
61172,15,9,1,1,4,11
61173,246,103,15,82,46,200
61174,25,5,18,0,2,23
61175,57,26,12,7,12,45
61176,19,4,7,4,4,15
61177,46,18,20,0,8,38
61178,74,17,35,3,19,55
61179,93,61,21,0,11,82
61180,10,8,1,0,1,9
61181,22,13,6,0,3,19
61182,50,0,33,3,14,36
61183,8,1,6,0,1,7
61184,22,11,5,0,6,16
61185,24,2,20,0,2,22
61186,99,34,26,21,18,81
61187,21,6,11,1,3,18
61188,6,2,2,0,2,4
61189,71,41,19,2,9,62
61190,83,37,30,8,8,75
61191,47,25,11,3,8,39
61192,121,47,40,5,29,92
61193,32,14,11,0,7,25
61194,51,25,16,1,9,42
61195,124,36,40,22,26,98
61196,56,7,41,1,7,49
61197,22,16,2,0,4,18
61198,202,49,40,76,37,165
61199,449,142,183,29,95,354
61200,46,18,20,0,8,38
61201,16,9,4,0,3,13
61202,76,29,34,1,12,64
61203,190,132,12,9,37,153
61204,16,6,9,0,1,15
61205,39,36,0,0,3,36
61206,16,5,9,1,1,15
61207,204,84,64,20,36,168
61208,50,23,16,0,11,39
61209,62,30,14,5,13,49
61210,87,60,6,0,21,66
61211,20,11,3,0,6,14
61212,74,37,26,0,11,63
61213,20,1,13,1,5,15
61214,434,295,45,1,93,341
61215,294,152,98,0,44,250
61216,31,25,3,0,3,28
61217,23,17,1,0,5,18
61218,73,51,9,0,13,60
61219,74,24,33,1,16,58
61220,82,63,1,0,18,64
61221,45,11,21,1,12,33
61222,54,34,13,0,7,47
61223,7,3,2,0,2,5
61224,104,27,26,29,22,82
61225,83,17,32,17,17,66
61226,46,18,20,0,8,38
61227,114,78,19,0,17,97
61228,27,7,10,4,6,21
61229,26,15,4,2,5,21
61230,77,10,53,1,13,64
61231,18,10,3,0,5,13
61232,19,8,7,0,4,15
61233,69,45,11,1,12,57
61234,20,8,4,2,6,14
61235,29,2,16,1,10,19
61236,136,55,55,7,19,117
61237,168,73,53,3,39,129
61238,592,428,42,1,121,471
61239,5,2,2,0,1,4
61240,138,110,6,0,22,116
61241,472,232,95,50,95,377
61242,65,52,1,0,12,53
61243,10,1,7,0,2,8
61244,385,289,20,0,76,309
61245,108,47,21,21,19,89
61246,37,14,14,1,8,29
61247,17,10,0,3,4,13
61248,106,58,10,16,22,84
61249,16,3,8,3,2,14
61250,229,54,119,3,53,176
61251,20,14,2,1,3,17
61252,46,18,20,0,8,38
61253,198,77,37,34,50,148
61254,24,3,17,0,4,20
61255,104,59,22,1,22,82
61256,480,222,158,11,89,391
61257,195,107,24,24,40,155
61258,137,94,17,2,24,113
61259,54,40,8,0,6,48
61260,19,6,1,8,4,15
61261,23,8,8,3,4,19
61262,55,13,24,9,9,46
61263,58,27,21,1,9,49
61264,160,115,11,0,34,126
61265,41,18,16,2,5,36
61266,430,209,112,14,95,335
61267,39,7,25,0,7,32
61268,26,16,7,0,3,23
61269,143,68,40,6,29,114
61270,148,100,22,2,24,124
61271,180,92,34,21,33,147
61272,31,15,4,5,7,24
61273,93,32,24,13,24,69
61274,9,8,0,0,1,8
61275,85,56,15,0,14,71
61276,21,14,1,0,6,15
61277,80,38,5,16,21,59
61278,35,9,15,3,8,27
61279,198,142,11,9,36,162
61280,52,14,17,7,14,38
61281,40,31,1,2,6,34
61282,77,36,27,0,14,63
61283,33,15,10,2,6,27
61284,35,19,10,0,6,29
61285,85,38,32,1,14,71
61286,32,21,9,0,2,30
61287,50,31,5,8,6,44
61288,64,20,24,7,13,51
61289,52,25,14,1,12,40
61290,134,35,71,1,27,107
61291,57,30,6,5,16,41
61292,87,60,11,3,13,74
61293,350,193,88,15,54,296
61294,574,421,37,1,115,459
61295,101,46,22,11,22,79
61296,333,143,120,11,59,274
61297,32,21,9,0,2,30
61298,127,75,22,3,27,100
61299,8,4,1,0,3,5
61300,66,38,10,4,14,52
61301,207,44,55,68,40,167
61302,549,381,50,1,117,432
61303,85,37,26,3,19,66
61304,65,44,5,6,10,55
61305,105,50,35,4,16,89
61306,438,242,65,38,93,345
61307,36,16,9,3,8,28
61308,85,31,27,10,17,68
61309,193,77,34,34,48,145
61310,22,9,4,6,3,19
61311,51,15,24,2,10,41
61312,8,0,8,0,0,8
61313,107,48,36,5,18,89
61314,196,27,134,0,35,161
61315,73,53,4,0,16,57
61316,34,7,20,0,7,27
61317,57,20,26,0,11,46
61318,86,49,3,15,19,67
61319,152,97,30,1,24,128
61320,194,51,22,93,28,166
61321,129,79,30,0,20,109
61322,84,23,37,9,15,69
61323,27,5,14,1,7,20
61324,127,75,22,3,27,100
61325,46,18,20,0,8,38
61326,88,65,5,0,18,70
61327,190,114,14,22,40,150
61328,35,8,20,2,5,30
61329,323,194,59,0,70,253
61330,167,26,102,4,35,132
61331,42,19,11,0,12,30
61332,100,31,39,5,25,75
61333,25,14,3,0,8,17
61334,17,7,5,1,4,13
61335,188,108,23,23,34,154
61336,34,18,10,0,6,28
61337,102,51,25,0,26,76
61338,157,72,50,5,30,127
61339,62,44,8,4,6,56
61340,635,354,156,24,101,534
61341,51,28,4,3,16,35
61342,115,36,49,7,23,92
61343,55,39,6,1,9,46
61344,130,111,3,0,16,114
61345,73,39,22,0,12,61
61346,60,30,13,0,17,43
61347,28,17,4,0,7,21
61348,56,13,20,6,17,39
61349,35,7,17,3,8,27
61350,27,15,5,0,7,20
61351,157,48,83,4,22,135
61352,57,20,24,0,13,44
61353,39,9,22,0,8,31
61354,49,24,11,4,10,39
61355,49,14,23,1,11,38
61356,56,9,37,0,10,46
61357,18,8,9,0,1,17
61358,189,54,100,2,33,156
61359,24,10,3,8,3,21
61360,94,28,38,3,25,69
61361,37,22,9,0,6,31
61362,428,126,162,46,94,334
61363,68,13,31,8,16,52
61364,72,44,15,0,13,59
61365,1,0,0,0,1,0
61366,121,46,42,8,25,96
61367,100,36,24,19,21,79
61368,297,136,95,12,54,243
61369,31,4,22,0,5,26
61370,27,6,16,0,5,22
61371,69,35,13,5,16,53
61372,48,12,22,1,13,35
61373,188,71,48,29,40,148
61374,113,44,25,18,26,87
61375,45,21,10,1,13,32
61376,23,13,4,0,6,17
61377,102,56,18,8,20,82
61378,37,14,5,9,9,28
61379,112,50,33,0,29,83
61380,37,7,24,0,6,31
61381,399,176,111,33,79,320
61382,23,12,2,3,6,17
61383,41,31,4,1,5,36
61384,139,81,13,19,26,113
61385,51,23,18,1,9,42
61386,51,29,13,2,7,44
61387,40,27,8,0,5,35
61388,27,7,10,4,6,21
61389,91,48,17,10,16,75
61390,3,0,0,3,0,3
61391,117,57,16,21,23,94
61392,75,60,2,1,12,63
61393,63,50,1,0,12,51
61394,38,6,4,20,8,30
61395,61,25,8,13,15,46
61396,66,15,31,3,17,49
61397,86,5,56,9,16,70
61398,55,39,6,1,9,46
61399,32,21,9,0,2,30
61400,76,39,17,2,18,58
61401,69,43,13,0,13,56
61402,36,14,4,9,9,27
61403,18,4,10,0,4,14
61404,127,75,22,3,27,100
61405,45,14,21,6,4,41
61406,32,21,9,0,2,30
61407,9,5,2,0,2,7
61408,12,5,5,1,1,11
61409,128,42,47,16,23,105
61410,284,136,84,3,61,223
61411,10,2,7,0,1,9
61412,26,15,7,0,4,22
61413,108,82,7,0,19,89
61414,42,21,14,0,7,35
61415,5,0,4,0,1,4
61416,673,390,153,18,112,561
61417,45,9,30,0,6,39
61418,42,27,7,0,8,34
61419,350,187,92,15,56,294
61420,121,89,7,0,25,96
61421,92,36,16,21,19,73
61422,53,26,3,15,9,44
61423,52,33,9,0,10,42
61424,60,32,7,5,16,44
61425,77,41,24,0,12,65
61426,115,54,45,3,13,102
61427,105,80,5,0,20,85
61428,39,24,8,0,7,32
61429,103,43,13,15,32,71
61430,123,45,36,17,25,98
61431,88,45,25,2,16,72
61432,39,14,18,0,7,32
61433,117,64,10,21,22,95
61434,11,3,6,0,2,9
61435,86,34,29,4,19,67
61436,144,93,14,10,27,117
61437,63,29,22,3,9,54
61438,60,31,11,2,16,44
61439,55,29,18,0,8,47
61440,158,59,49,23,27,131
61441,174,80,49,15,30,144
61442,78,26,22,12,18,60
61443,44,19,15,0,10,34
61444,16,8,5,0,3,13
61445,61,29,14,4,14,47
61446,56,38,5,0,13,43
61447,37,22,5,1,9,28
61448,66,35,5,13,13,53
61449,195,141,16,2,36,159
61450,155,102,26,6,21,134
61451,133,104,11,0,18,115
61452,84,54,14,0,16,68
61453,30,6,17,0,7,23
61454,53,35,7,0,11,42
61455,42,9,20,7,6,36
61456,48,29,7,1,11,37
61457,131,44,50,13,24,107
61458,63,34,14,0,15,48
61459,23,5,17,0,1,22
61460,152,62,37,19,34,118
61461,82,15,47,3,17,65
61462,17,14,0,0,3,14
61463,61,18,23,5,15,46
61464,206,55,103,14,34,172
61465,8,5,2,0,1,7
61466,347,204,70,0,73,274
61467,24,4,10,7,3,21
61468,44,30,6,0,8,36
61469,159,67,33,21,38,121
61470,24,1,19,0,4,20
61471,55,26,12,6,11,44
61472,46,4,30,1,11,35
61473,122,62,22,12,26,96
61474,16,7,4,0,5,11
61475,7,2,3,0,2,5
61476,17,0,13,0,4,13
61477,428,196,140,8,84,344
61478,26,10,6,0,10,16
61479,112,31,60,0,21,91
61480,31,17,12,0,2,29
61481,32,21,9,0,2,30
61482,31,6,16,2,7,24
61483,163,77,47,7,32,131
61484,95,21,32,24,18,77
61485,58,48,0,1,9,49
61486,18,5,6,2,5,13
61487,45,14,25,0,6,39
61488,244,123,65,0,56,188
61489,76,5,54,1,16,60
61490,68,36,21,2,9,59
61491,128,63,42,4,19,109
61492,222,61,110,14,37,185
61493,295,37,202,2,54,241
61494,344,188,99,0,57,287
61495,2,0,1,0,1,1
61496,54,5,35,1,13,41
61497,43,2,9,26,6,37
61498,41,11,18,5,7,34
61499,116,32,34,27,23,93
61500,73,31,20,1,21,52
61501,69,19,30,0,20,49
61502,255,182,14,3,56,199
61503,112,74,21,0,17,95
61504,24,11,9,0,4,20
61505,18,9,9,0,0,18
61506,22,10,8,1,3,19
61507,35,21,7,0,7,28
61508,33,14,7,1,11,22
61509,39,11,18,2,8,31
61510,74,38,19,0,17,57
61511,177,100,33,0,44,133
61512,86,41,22,1,22,64
61513,64,36,17,0,11,53
61514,35,8,17,1,9,26
61515,5,2,2,0,1,4
61516,17,6,7,1,3,14
61517,43,11,18,4,10,33
61518,302,187,50,0,65,237
61519,36,25,4,0,7,29
61520,13,3,7,0,3,10
61521,88,56,18,0,14,74
61522,54,18,22,4,10,44
61523,41,11,18,1,11,30
61524,70,37,22,1,10,60
61525,65,34,16,4,11,54
61526,253,29,173,2,49,204
61527,80,37,30,4,9,71
61528,35,17,8,3,7,28
61529,43,19,18,0,6,37
61530,31,20,4,4,3,28
61531,28,7,17,2,2,26
61532,110,34,35,15,26,84
61533,73,20,44,1,8,65
61534,77,18,45,0,14,63
61535,101,66,15,3,17,84
61536,25,9,13,0,3,22
61537,170,82,50,4,34,136
61538,672,394,142,18,118,554
61539,209,106,34,32,37,172
61540,55,15,21,10,9,46
61541,284,150,76,13,45,239
61542,202,110,31,23,38,164
61543,76,10,43,5,18,58
61544,75,58,6,1,10,65
61545,85,35,9,22,19,66
61546,47,13,24,0,10,37
61547,85,69,3,0,13,72
61548,38,12,21,1,4,34
61549,8,2,6,0,0,8
61550,4,2,1,0,1,3
61551,59,17,23,4,15,44
61552,67,16,31,2,18,49
61553,40,15,15,3,7,33
61554,137,85,27,0,25,112
61555,24,10,7,0,7,17
61556,27,7,11,2,7,20
61557,55,24,19,0,12,43
61558,115,67,23,7,18,97
61559,90,54,20,3,13,77
61560,69,37,15,0,17,52
61561,162,68,34,21,39,123
61562,431,320,20,0,91,340
61563,206,19,148,2,37,169
61564,536,382,41,1,112,424
61565,81,17,40,10,14,67
61566,47,29,10,0,8,39
61567,418,193,127,12,86,332
61568,178,101,33,0,44,134
61569,6,4,0,1,1,5
61570,61,49,1,0,11,50
61571,63,19,21,8,15,48
61572,45,0,36,2,7,38
61573,9,3,4,1,1,8
61574,57,24,5,15,13,44
61575,85,57,11,3,14,71
61576,114,51,45,1,17,97
61577,34,15,11,0,8,26
61578,113,27,65,0,21,92
61579,102,46,37,0,19,83
61580,45,20,15,0,10,35
61581,65,18,27,12,8,57
61582,152,89,36,1,26,126
61583,54,8,35,0,11,43
61584,31,19,7,1,4,27
61585,74,41,17,2,14,60
61586,76,10,43,5,18,58
61587,56,3,41,1,11,45
61588,110,51,19,16,24,86
61589,102,26,53,3,20,82
61590,176,58,87,0,31,145
61591,36,9,20,0,7,29
61592,33,13,16,0,4,29
61593,57,13,39,0,5,52
61594,80,62,5,4,9,71
61595,10,3,5,1,1,9
61596,241,128,68,9,36,205
61597,11,4,6,0,1,10
61598,98,55,26,0,17,81
61599,18,4,10,0,4,14
61600,276,75,34,121,46,230
61601,40,15,11,2,12,28
61602,84,59,7,0,18,66
61603,31,14,9,1,7,24
61604,25,4,16,0,5,20
61605,22,16,2,0,4,18
61606,161,81,44,4,32,129
61607,145,91,29,0,25,120
61608,54,34,10,0,10,44
61609,2,1,0,0,1,1
61610,12,5,4,0,3,9
61611,215,89,37,38,51,164
61612,184,122,13,9,40,144
61613,192,108,41,0,43,149
61614,25,11,7,4,3,22
61615,34,19,6,2,7,27
61616,13,4,3,1,5,8
61617,86,45,21,1,19,67
61618,57,14,23,7,13,44
61619,76,49,8,0,19,57
61620,33,17,2,5,9,24
61621,338,245,17,2,74,264
61622,80,29,34,6,11,69
61623,91,42,33,1,15,76
61624,106,41,44,11,10,96
61625,32,21,9,0,2,30
61626,17,3,10,1,3,14
61627,323,81,157,5,80,243
61628,15,2,7,0,6,9
61629,457,238,114,14,91,366
61630,29,3,24,0,2,27
61631,40,31,1,2,6,34
61632,14,9,4,0,1,13
61633,33,6,20,0,7,26
61634,112,66,18,3,25,87
61635,2,0,2,0,0,2
61636,170,6,137,0,27,143
61637,27,7,10,4,6,21
61638,12,6,4,0,2,10
61639,133,48,29,26,30,103
61640,199,101,50,0,48,151
61641,98,46,12,21,19,79
61642,103,48,24,3,28,75
61643,27,14,9,0,4,23
61644,11,0,7,0,4,7
61645,11,8,2,0,1,10
61646,32,21,9,0,2,30
61647,73,57,2,0,14,59
61648,113,46,39,6,22,91
61649,135,78,14,19,24,111
61650,27,9,15,1,2,25
61651,1,0,1,0,0,1
61652,221,74,83,15,49,172
61653,42,29,1,2,10,32
61654,36,6,21,2,7,29
61655,278,176,42,0,60,218
61656,5,1,1,1,2,3
61657,28,11,10,0,7,21
61658,57,30,19,0,8,49
61659,533,383,38,1,111,422
61660,6,3,2,0,1,5
61661,102,65,10,5,22,80
61662,50,22,15,3,10,40
61663,94,60,9,5,20,74
61664,55,9,31,4,11,44
61665,32,2,22,2,6,26
61666,151,24,99,1,27,124
61667,1267,508,171,336,252,1015
61668,10,1,9,0,0,10
61669,5,1,3,0,1,4
61670,32,21,9,0,2,30
61671,60,26,19,1,14,46
61672,429,203,138,12,76,353
61673,78,21,33,0,24,54
61674,460,118,191,46,105,355
61675,241,164,59,2,16,225
61676,175,124,14,2,35,140
61677,353,164,88,29,72,281
61678,204,77,40,38,49,155
61679,90,33,37,2,18,72
61680,34,9,14,5,6,28
61681,86,64,9,1,12,74
61682,40,18,15,0,7,33
61683,28,12,6,6,4,24
61684,40,35,0,1,4,36
61685,272,117,88,14,53,219
61686,182,87,55,1,39,143
61687,76,40,13,9,14,62
61688,94,44,21,7,22,72
61689,29,13,12,0,4,25
61690,78,25,22,11,20,58
61691,324,195,61,0,68,256
61692,37,7,25,1,4,33
61693,43,20,4,15,4,39
61694,32,18,5,3,6,26
61695,36,25,1,0,10,26
61696,115,72,15,4,24,91
61697,17,4,5,4,4,13
61698,63,43,9,0,11,52
61699,17,2,14,0,1,16
61700,76,16,44,3,13,63
61701,139,55,56,5,23,116
61702,205,103,32,34,36,169
61703,149,87,27,1,34,115
61704,59,21,9,20,9,50
61705,108,62,19,3,24,84
61706,48,15,21,0,12,36
61707,34,9,17,2,6,28
61708,45,7,30,5,3,42
61709,60,35,10,4,11,49
61710,127,37,65,0,25,102
61711,36,16,13,2,5,31
61712,33,14,15,1,3,30
61713,177,78,25,29,45,132
61714,46,18,20,0,8,38
61715,18,5,9,0,4,14
61716,37,5,13,11,8,29
61717,114,67,19,9,19,95
61718,57,9,35,3,10,47
61719,36,9,4,18,5,31
61720,513,273,86,47,107,406
61721,38,18,8,5,7,31
61722,27,16,3,0,8,19
61723,41,5,31,0,5,36
61724,55,27,11,0,17,38
61725,201,105,34,27,35,166
61726,23,6,12,1,4,19
61727,66,36,3,17,10,56
61728,44,27,11,0,6,38
61729,55,25,20,1,9,46
61730,68,34,23,1,10,58
61731,48,7,30,2,9,39
61732,61,18,33,1,9,52
61733,56,34,7,2,13,43
61734,56,2,46,1,7,49
61735,66,15,36,1,14,52
61736,78,56,4,0,18,60
61737,63,12,30,4,17,46
61738,8,6,2,0,0,8
61739,392,104,190,8,90,302
61740,87,31,36,10,10,77
61741,418,108,175,45,90,328
61742,42,8,23,3,8,34
61743,13,12,1,0,0,13
61744,154,104,3,15,32,122
61745,48,34,3,0,11,37
61746,10,7,1,0,2,8
61747,694,409,142,20,123,571
61748,95,65,6,0,24,71
61749,630,362,136,18,114,516
61750,24,6,12,0,6,18
61751,233,64,103,14,52,181
61752,12,0,11,0,1,11
61753,29,11,15,0,3,26
61754,25,2,14,0,9,16
61755,79,25,28,15,11,68
61756,18,9,4,0,5,13
61757,317,154,108,5,50,267
61758,34,15,9,2,8,26
61759,45,33,4,0,8,37
61760,252,185,11,3,53,199
61761,2,2,0,0,0,2
61762,109,39,30,13,27,82
61763,119,42,42,7,28,91
61764,266,16,199,0,51,215
61765,32,21,9,0,2,30
61766,103,35,38,6,24,79
61767,49,19,25,0,5,44
61768,9,6,0,0,3,6
61769,65,11,44,0,10,55
61770,255,189,12,0,54,201
61771,26,4,14,2,6,20
61772,20,3,0,10,7,13
61773,24,8,6,2,8,16
61774,51,25,3,14,9,42
61775,26,5,15,2,4,22
61776,26,14,6,0,6,20
61777,32,12,12,0,8,24
61778,393,181,129,8,75,318
61779,283,194,20,2,67,216
61780,41,2,28,4,7,34
61781,87,64,4,1,18,69
61782,17,8,7,0,2,15
61783,73,45,15,3,10,63
61784,68,48,5,5,10,58
61785,409,194,130,9,76,333
61786,0,0,0,0,0,0
61787,266,19,199,2,46,220
61788,100,47,15,24,14,86
61789,4,3,0,0,1,3
61790,76,26,28,12,10,66
61791,27,13,9,0,5,22
61792,10,6,1,0,3,7
61793,40,26,5,0,9,31
61794,96,63,20,0,13,83
61795,404,192,136,7,69,335
61796,6,3,2,1,0,6
61797,15,2,2,10,1,14
61798,138,84,29,0,25,113
61799,1086,393,449,46,198,888
61800,3,2,0,1,0,3
61801,40,11,14,7,8,32
61802,4,1,2,0,1,3
61803,11,7,3,1,0,11
61804,2,0,2,0,0,2
61805,107,68,28,0,11,96
61806,20,6,0,8,6,14
61807,136,104,4,2,26,110
61808,41,32,1,0,8,33
61809,61,32,2,18,9,52
61810,464,134,195,36,99,365
61811,32,19,6,1,6,26
61812,24,17,3,0,4,20
61813,32,21,9,0,2,30
61814,19,8,6,0,5,14
61815,52,20,18,1,13,39
61816,78,63,0,5,10,68
61817,67,43,8,2,14,53
61818,39,17,17,2,3,36
61819,60,40,5,2,13,47
61820,115,47,35,8,25,90
61821,273,203,15,1,54,219
61822,38,20,4,4,10,28
61823,135,32,73,1,29,106
61824,34,16,12,0,6,28
61825,224,136,39,7,42,182
61826,11,5,4,0,2,9
61827,72,18,37,3,14,58
61828,16,2,10,1,3,13
61829,118,84,22,2,10,108
61830,19,6,9,3,1,18
61831,9,3,3,0,3,6
61832,276,92,126,14,44,232
61833,23,16,4,0,3,20
61834,104,20,62,1,21,83
61835,138,84,21,4,29,109
61836,55,34,10,0,11,44
61837,64,30,18,4,12,52
61838,23,10,6,4,3,20
61839,123,85,11,2,25,98
61840,103,68,1,12,22,81
61841,199,101,50,0,48,151
61842,50,26,17,0,7,43
61843,105,49,20,18,18,87
61844,15,2,7,0,6,9
61845,19,7,10,0,2,17
61846,491,264,82,43,102,389
61847,43,13,13,9,8,35
61848,91,38,33,1,19,72
61849,138,37,50,18,33,105
61850,46,22,15,0,9,37
61851,446,220,119,14,93,353
61852,46,18,20,0,8,38
61853,71,35,12,7,17,54
61854,442,142,185,15,100,342
61855,36,7,19,2,8,28
61856,180,81,60,5,34,146
61857,188,79,57,18,34,154
61858,356,206,74,0,76,280
61859,38,11,17,2,8,30
61860,42,16,14,1,11,31
61861,164,106,27,0,31,133
61862,40,23,11,0,6,34
61863,469,219,146,12,92,377
61864,38,22,8,1,7,31
61865,35,13,16,0,6,29
61866,30,5,15,1,9,21
61867,141,26,89,1,25,116
61868,27,6,15,2,4,23
61869,57,9,37,2,9,48
61870,348,190,89,15,54,294
61871,37,19,8,1,9,28
61872,30,16,10,1,3,27
61873,123,76,24,0,23,100
61874,106,55,30,4,17,89
61875,81,36,32,0,13,68
61876,248,58,25,124,41,207
61877,2,1,0,0,1,1
61878,2,1,1,0,0,2
61879,62,34,13,1,14,48
61880,54,23,23,1,7,47
61881,175,87,52,6,30,145
61882,152,24,99,1,28,124
61883,15,5,7,0,3,12
61884,88,38,18,8,24,64
61885,102,38,38,9,17,85
61886,240,104,76,17,43,197
61887,245,158,33,4,50,195
61888,17,2,10,0,5,12
61889,128,74,20,3,31,97
61890,72,27,22,8,15,57
61891,95,64,11,0,20,75
61892,23,6,14,0,3,20
61893,12,3,4,1,4,8
61894,12,5,5,0,2,10
61895,68,34,17,2,15,53
61896,44,16,12,2,14,30
61897,22,11,5,0,6,16
61898,64,28,22,0,14,50
61899,250,104,56,36,54,196
61900,82,43,25,3,11,71
61901,194,77,34,34,49,145
61902,23,10,7,0,6,17
61903,47,31,8,0,8,39
61904,20,15,0,1,4,16
61905,68,26,33,0,9,59
61906,13,9,3,0,1,12
61907,53,12,26,1,14,39
61908,70,25,20,6,19,51
61909,175,30,105,4,36,139
61910,35,23,7,0,5,30
61911,376,200,85,11,80,296
61912,46,8,27,0,11,35
61913,14,9,0,2,3,11
61914,24,16,5,0,3,21
61915,10,5,2,0,3,7
61916,17,13,1,0,3,14
61917,41,28,4,2,7,34
61918,15,2,6,1,6,9
61919,187,52,31,71,33,154
61920,115,78,23,0,14,101
61921,104,57,25,4,18,86
61922,78,45,18,2,13,65
61923,14,3,9,0,2,12
61924,35,19,10,0,6,29
61925,461,160,158,47,96,365
61926,53,14,28,0,11,42
61927,23,15,3,0,5,18
61928,44,17,12,1,14,30
61929,18,9,4,0,5,13
61930,43,13,18,1,11,32
61931,55,33,15,2,5,50
61932,23,4,3,11,5,18
61933,6,1,4,0,1,5
61934,15,5,7,1,2,13
61935,73,29,7,22,15,58
61936,94,25,50,0,19,75
61937,94,38,35,4,17,77
61938,196,131,21,0,44,152
61939,35,16,10,0,9,26
61940,61,22,32,0,7,54
61941,72,39,13,8,12,60
61942,44,14,21,2,7,37
61943,151,85,33,6,27,124
61944,81,31,35,1,14,67
61945,207,33,93,33,48,159
61946,44,8,18,9,9,35
61947,23,9,5,1,8,15
61948,58,44,2,0,12,46
61949,128,66,12,23,27,101
61950,31,10,12,0,9,22
61951,20,0,14,4,2,18
61952,473,223,154,13,83,390
61953,32,21,9,0,2,30
61954,28,13,7,2,6,22
61955,25,11,6,0,8,17
61956,47,26,13,1,7,40
61957,20,12,4,1,3,17
61958,73,45,14,3,11,62
61959,19,8,2,2,7,12
61960,75,30,27,3,15,60
61961,205,13,154,0,38,167
61962,170,50,57,26,37,133
61963,32,6,18,2,6,26
61964,35,19,4,3,9,26
61965,210,45,55,70,40,170
61966,166,109,26,6,25,141
61967,8,4,4,0,0,8
61968,52,32,11,2,7,45
61969,134,100,6,0,28,106
61970,73,27,34,3,9,64
61971,54,0,35,3,16,38
61972,159,91,21,20,27,132
61973,34,1,27,0,6,28
61974,107,48,35,0,24,83
61975,124,86,12,2,24,100
61976,52,8,34,0,10,42
61977,25,9,6,2,8,17
61978,100,35,26,21,18,82
61979,31,4,22,0,5,26
61980,42,23,10,0,9,33
61981,168,96,19,18,35,133
61982,52,4,38,0,10,42
61983,54,31,10,3,10,44
61984,9,0,9,0,0,9
61985,39,23,10,0,6,33
61986,568,416,35,1,116,452
61987,147,116,6,0,25,122
61988,205,88,43,26,48,157
61989,31,15,7,0,9,22
61990,109,42,12,35,20,89
61991,123,48,36,10,29,94
61992,47,12,23,0,12,35
61993,103,1,84,0,18,85
61994,32,21,9,0,2,30
61995,9,7,0,0,2,7
61996,41,28,4,1,8,33
61997,125,28,39,24,34,91
61998,46,35,0,0,11,35
61999,26,9,8,0,9,17
62000,202,103,51,0,48,154
62001,60,28,14,9,9,51
62002,74,30,7,22,15,59
62003,84,23,19,19,23,61
62004,110,55,36,0,19,91
62005,35,16,10,0,9,26
62006,65,33,12,5,15,50
62007,62,33,8,8,13,49
62008,80,66,3,2,9,71
62009,46,33,4,0,9,37
62010,40,11,19,0,10,30
62011,474,239,89,46,100,374
62012,31,10,10,2,9,22
62013,35,9,15,4,7,28
62014,78,34,30,0,14,64
62015,15,4,7,0,4,11
62016,102,42,44,0,16,86
62017,184,60,56,25,43,141
62018,158,67,35,24,32,126
62019,513,258,97,54,104,409
62020,38,34,0,0,4,34
62021,14,6,4,0,4,10
62022,282,146,95,0,41,241
62023,92,21,53,2,16,76
62024,72,18,33,0,21,51
62025,32,21,9,0,2,30
62026,153,46,64,4,39,114
62027,31,10,10,3,8,23
62028,94,39,35,5,15,79
62029,46,18,20,0,8,38
62030,32,21,9,0,2,30
62031,130,69,24,13,24,106
62032,20,0,15,0,5,15
62033,32,21,9,0,2,30
62034,60,32,14,2,12,48
62035,8,1,6,0,1,7
62036,185,53,31,70,31,154
62037,212,87,14,75,36,176
62038,244,186,13,0,45,199
62039,191,80,44,22,45,146
62040,154,23,102,1,28,126
62041,98,62,23,0,13,85
62042,37,5,20,5,7,30
62043,198,131,22,0,45,153
62044,292,37,199,2,54,238
62045,70,41,5,8,16,54
62046,205,56,51,59,39,166
62047,17,6,8,0,3,14
62048,139,33,66,4,36,103
62049,45,27,9,0,9,36
62050,35,20,9,0,6,29
62051,21,10,6,0,5,16
62052,13,3,5,2,3,10
62053,189,107,42,9,31,158
62054,66,17,8,27,14,52
62055,37,22,6,2,7,30
62056,24,6,14,1,3,21
62057,54,15,27,5,7,47
62058,66,46,7,2,11,55
62059,42,7,28,0,7,35
62060,78,38,22,6,12,66
62061,53,33,2,3,15,38
62062,408,190,136,11,71,337
62063,22,12,2,5,3,19
62064,60,48,2,0,10,50
62065,51,18,13,7,13,38
62066,200,109,30,23,38,162
62067,76,50,8,3,15,61
62068,440,203,146,11,80,360
62069,36,13,16,0,7,29
62070,62,40,9,0,13,49
62071,66,10,49,0,7,59
62072,20,5,7,3,5,15
62073,44,36,2,0,6,38
62074,61,44,7,0,10,51
62075,67,29,22,6,10,57
62076,470,139,191,37,103,367
62077,22,8,9,3,2,20
62078,106,40,43,9,14,92
62079,11,6,0,3,2,9
62080,32,21,9,0,2,30
62081,618,379,106,8,125,493
62082,136,73,33,0,30,106
62083,519,250,107,57,105,414
62084,57,0,39,3,15,42
62085,32,21,9,0,2,30
62086,343,192,78,6,67,276
62087,11,8,1,0,2,9
62088,94,43,32,4,15,79
62089,15,11,2,0,2,13
62090,127,98,1,1,27,100
62091,37,23,6,1,7,30
62092,34,2,24,0,8,26
62093,15,9,3,0,3,12
62094,60,36,14,1,9,51
62095,59,29,15,6,9,50
62096,60,37,8,2,13,47
62097,49,20,19,0,10,39
62098,79,23,42,2,12,67
62099,342,166,96,17,63,279
62100,13,6,6,0,1,12
62101,84,34,22,13,15,69
62102,170,83,49,4,34,136
62103,112,70,17,3,22,90
62104,146,20,91,9,26,120
62105,72,27,16,8,21,51
62106,143,92,14,10,27,116
62107,166,99,38,1,28,138
62108,219,57,111,5,46,173
62109,39,22,10,1,6,33
62110,50,26,11,3,10,40
62111,524,231,132,45,116,408
62112,17,10,0,3,4,13
62113,67,37,18,0,12,55
62114,267,64,48,113,42,225
62115,249,21,181,2,45,204
62116,313,76,177,4,56,257
62117,22,9,6,3,4,18
62118,3,2,1,0,0,3
62119,13,10,1,0,2,11
62120,136,47,42,22,25,111
62121,30,4,14,7,5,25
62122,46,6,25,10,5,41
62123,53,12,25,8,8,45
62124,26,9,10,0,7,19
62125,105,47,27,12,19,86
62126,231,79,90,14,48,183
62127,27,13,5,0,9,18
62128,342,146,120,6,70,272
62129,178,131,13,1,33,145
62130,44,8,29,0,7,37
62131,32,21,9,0,2,30
62132,94,56,20,0,18,76
62133,29,6,10,7,6,23
62134,10,1,9,0,0,10
62135,59,21,22,5,11,48
62136,520,287,117,17,99,421
62137,73,25,21,10,17,56
62138,13,3,8,0,2,11
62139,134,51,47,15,21,113
62140,93,39,24,20,10,83
62141,65,20,6,28,11,54
62142,51,30,14,1,6,45
62143,194,54,24,86,30,164
62144,65,19,27,10,9,56
62145,26,14,6,0,6,20
62146,13,6,6,0,1,12
62147,78,51,14,0,13,65
62148,41,26,4,6,5,36
62149,195,77,35,33,50,145
62150,415,309,20,0,86,329
62151,122,51,18,18,35,87
62152,40,18,13,0,9,31
62153,148,109,9,0,30,118
62154,82,39,23,3,17,65
62155,96,51,24,4,17,79
62156,152,91,28,0,33,119
62157,329,197,62,0,70,259
62158,479,224,152,13,90,389
62159,30,22,4,0,4,26
62160,135,58,32,20,25,110
62161,73,21,27,8,17,56
62162,22,10,8,1,3,19
62163,94,57,14,3,20,74
62164,108,55,24,7,22,86
62165,50,31,5,6,8,42
62166,168,129,7,0,32,136
62167,285,162,58,11,54,231
62168,6,4,0,0,2,4
62169,56,28,10,3,15,41
62170,31,19,4,0,8,23
62171,140,29,59,20,32,108
62172,276,68,72,79,57,219
62173,260,119,72,24,45,215
62174,1,0,1,0,0,1
62175,8,2,5,0,1,7
62176,81,41,18,2,20,61
62177,28,18,4,0,6,22
62178,53,23,16,1,13,40
62179,63,17,29,5,12,51
62180,76,31,35,1,9,67
62181,34,15,9,2,8,26
62182,114,63,26,6,19,95
62183,7,4,2,0,1,6
62184,20,11,6,0,3,17
62185,22,8,6,2,6,16
62186,79,35,12,9,23,56
62187,80,37,5,16,22,58
62188,43,29,1,0,13,30
62189,10,4,3,0,3,7
62190,50,36,4,3,7,43
62191,38,16,11,2,9,29
62192,213,86,14,76,37,176
62193,29,18,6,0,5,24
62194,95,60,19,2,14,81
62195,396,207,113,3,73,323
62196,36,17,7,0,12,24
62197,194,131,19,0,44,150
62198,93,51,18,5,19,74
62199,150,91,29,0,30,120
62200,85,66,1,0,18,67
62201,46,18,20,0,8,38
62202,398,205,103,9,81,317
62203,51,22,23,1,5,46
62204,12,7,2,2,1,11
62205,42,8,24,3,7,35
62206,642,371,150,17,104,538
62207,41,13,14,6,8,33
62208,159,105,24,1,29,130
62209,40,8,24,1,7,33
62210,74,33,7,14,20,54
62211,91,52,20,0,19,72
62212,39,16,11,3,9,30
62213,9,2,3,4,0,9
62214,79,38,28,0,13,66
62215,49,41,2,0,6,43
62216,80,59,6,0,15,65
62217,22,16,3,1,2,20
62218,142,49,62,6,25,117
62219,37,9,14,6,8,29
62220,138,75,33,0,30,108
62221,22,12,8,0,2,20
62222,63,11,39,0,13,50
62223,23,12,4,1,6,17
62224,58,26,16,0,16,42
62225,152,76,27,16,33,119
62226,46,18,20,0,8,38
62227,55,34,10,0,11,44
62228,24,5,15,0,4,20
62229,51,15,24,2,10,41
62230,163,120,3,1,39,124
62231,15,3,10,0,2,13
62232,20,6,0,8,6,14
62233,60,29,7,10,14,46
62234,79,40,20,1,18,61
62235,62,40,12,1,9,53
62236,31,25,2,0,4,27
62237,87,42,32,4,9,78
62238,12,4,4,2,2,10
62239,60,24,28,0,8,52
62240,71,7,47,5,12,59
62241,24,6,10,5,3,21
62242,73,31,20,1,21,52
62243,34,9,14,4,7,27
62244,109,33,37,16,23,86
62245,45,24,11,1,9,36
62246,33,6,21,0,6,27
62247,22,14,7,0,1,21
62248,19,7,8,0,4,15
62249,15,14,0,0,1,14
62250,115,56,26,4,29,86
62251,82,46,20,0,16,66
62252,20,10,8,0,2,18
62253,80,41,20,2,17,63
62254,51,37,1,2,11,40
62255,135,49,33,19,34,101
62256,209,139,23,0,47,162
62257,32,21,9,0,2,30
62258,24,6,17,0,1,23
62259,91,58,16,0,17,74
62260,218,112,60,0,46,172
62261,82,17,39,4,22,60
62262,115,32,43,14,26,89
62263,204,88,48,24,44,160
62264,56,29,13,5,9,47
62265,65,27,24,1,13,52
62266,66,39,15,3,9,57
62267,11,6,1,0,4,7
62268,79,15,40,6,18,61
62269,346,182,102,3,59,287
62270,95,47,29,2,17,78
62271,56,5,6,31,14,42
62272,103,48,33,5,17,86
62273,149,87,27,1,34,115
62274,251,69,31,109,42,209
62275,67,12,43,0,12,55
62276,265,197,15,0,53,212
62277,43,30,6,1,6,37
62278,103,45,35,7,16,87
62279,36,16,9,1,10,26
62280,121,53,42,6,20,101
62281,303,152,91,1,59,244
62282,14,11,0,0,3,11
62283,32,21,9,0,2,30
62284,36,15,15,1,5,31
62285,66,36,17,0,13,53
62286,385,218,89,0,78,307
62287,21,10,6,0,5,16
62288,92,49,18,3,22,70
62289,61,26,19,3,13,48
62290,46,17,20,2,7,39
62291,80,64,1,4,11,69
62292,138,80,22,3,33,105
62293,30,2,23,2,3,27
62294,32,21,9,0,2,30
62295,76,15,47,0,14,62
62296,51,21,13,3,14,37
62297,104,67,11,4,22,82
62298,75,43,16,0,16,59
62299,46,31,1,2,12,34
62300,136,91,14,5,26,110
62301,32,21,9,0,2,30
62302,47,15,19,2,11,36
62303,160,97,41,13,9,151
62304,41,26,7,0,8,33
62305,52,36,5,3,8,44
62306,78,25,28,14,11,67
62307,13,5,5,0,3,10
62308,82,39,12,10,21,61
62309,663,392,140,17,114,549
62310,11,7,2,0,2,9
62311,76,37,19,8,12,64
62312,80,31,24,7,18,62
62313,113,28,55,0,30,83
62314,19,3,0,9,7,12
62315,69,50,8,0,11,58
62316,117,47,40,7,23,94
62317,111,74,13,1,23,88
62318,341,146,120,6,69,272
62319,32,14,11,0,7,25
62320,83,43,18,10,12,71
62321,25,4,14,0,7,18
62322,478,129,203,39,107,371
62323,107,46,36,9,16,91
62324,38,19,9,1,9,29
62325,207,113,31,23,40,167
62326,93,29,36,5,23,70
62327,129,101,8,2,18,111
62328,22,1,17,0,4,18
62329,35,18,11,0,6,29
62330,14,10,0,0,4,10
62331,47,21,13,4,9,38
62332,434,206,142,12,74,360
62333,38,23,8,1,6,32
62334,233,133,23,29,48,185
62335,680,406,134,23,117,563
62336,163,38,16,84,25,138
62337,59,19,12,21,7,52
62338,184,146,11,0,27,157
62339,55,25,13,6,11,44
62340,5,0,0,0,5,0
62341,79,37,5,16,21,58
62342,10,7,2,0,1,9
62343,136,73,33,0,30,106
62344,11,5,4,0,2,9
62345,25,10,11,0,4,21
62346,64,44,9,1,10,54
62347,244,188,9,1,46,198
62348,9,3,3,0,3,6
62349,167,83,54,5,25,142
62350,25,18,1,0,6,19
62351,110,44,10,37,19,91
62352,105,38,25,20,22,83
62353,361,199,90,15,57,304
62354,63,36,11,1,15,48
62355,19,7,10,0,2,17
62356,200,13,149,0,38,162
62357,54,25,19,1,9,45
62358,145,89,15,11,30,115
62359,68,27,12,20,9,59
62360,56,24,22,0,10,46
62361,67,47,6,0,14,53
62362,34,6,23,0,5,29
62363,65,31,22,0,12,53
62364,42,13,14,6,9,33
62365,86,21,48,3,14,72
62366,7,6,0,0,1,6
62367,111,49,29,2,31,80
62368,54,2,44,0,8,46
62369,398,232,87,0,79,319
62370,435,206,141,12,76,359
62371,236,165,27,3,41,195
62372,66,32,17,2,15,51
62373,32,15,9,1,7,25
62374,245,102,15,83,45,200
62375,63,24,22,1,16,47
62376,65,34,23,0,8,57
62377,171,54,92,4,21,150
62378,127,75,22,3,27,100
62379,91,54,28,5,4,87
62380,101,24,48,10,19,82
62381,395,225,89,0,81,314
62382,447,143,182,21,101,346
62383,12,5,5,0,2,10
62384,72,41,14,3,14,58
62385,92,37,23,14,18,74
62386,17,4,7,2,4,13
62387,10,1,7,0,2,8
62388,126,98,6,0,22,104
62389,121,66,44,2,9,112
62390,43,9,18,8,8,35
62391,75,29,26,1,19,56
62392,72,55,6,0,11,61
62393,132,49,55,12,16,116
62394,19,2,15,0,2,17
62395,32,21,9,0,2,30
62396,273,172,41,0,60,213
62397,22,1,18,0,3,19
62398,39,10,18,4,7,32
62399,10,8,1,0,1,9
62400,7,2,3,2,0,7
62401,44,31,1,1,11,33
62402,127,75,22,3,27,100
62403,31,1,23,0,7,24
62404,11,8,0,0,3,8
62405,5,1,3,0,1,4
62406,8,5,3,0,0,8
62407,1,0,1,0,0,1
62408,15,5,9,0,1,14
62409,134,54,51,0,29,105
62410,41,6,25,0,10,31
62411,113,65,24,7,17,96
62412,101,36,39,1,25,76
62413,52,11,33,0,8,44
62414,247,102,55,36,54,193
62415,34,9,21,0,4,30
62416,26,9,12,2,3,23
62417,122,46,48,0,28,94
62418,54,2,45,0,7,47
62419,57,22,16,5,14,43
62420,460,137,198,31,94,366
62421,36,8,20,0,8,28
62422,55,24,14,1,16,39
62423,434,127,167,47,93,341
62424,32,18,3,4,7,25
62425,17,5,9,0,3,14
62426,54,30,13,0,11,43
62427,119,66,35,1,17,102
62428,58,38,7,0,13,45
62429,92,42,26,1,23,69
62430,106,31,53,4,18,88
62431,24,15,3,0,6,18
62432,424,210,104,27,83,341
62433,115,46,35,8,26,89
62434,327,200,54,10,63,264
62435,423,205,111,17,90,333
62436,24,15,5,0,4,20
62437,31,6,17,2,6,25
62438,155,79,50,2,24,131
62439,29,5,20,0,4,25
62440,31,10,13,0,8,23
62441,37,9,25,1,2,35
62442,55,39,3,0,13,42
62443,21,12,3,0,6,15
62444,105,57,22,7,19,86
62445,110,34,35,13,28,82
62446,62,27,22,0,13,49
62447,55,39,6,1,9,46
62448,48,12,26,1,9,39
62449,101,23,42,14,22,79
62450,65,42,12,0,11,54
62451,31,10,13,0,8,23
62452,112,87,5,0,20,92
62453,52,30,10,0,12,40
62454,99,42,18,14,25,74
62455,202,89,56,20,37,165
62456,50,36,0,0,14,36
62457,15,5,8,0,2,13
62458,13,1,7,0,5,8
62459,86,64,4,1,17,69
62460,112,8,73,10,21,91
62461,56,14,18,13,11,45
62462,281,19,208,0,54,227
62463,29,12,9,1,7,22
62464,96,44,21,7,24,72
62465,126,53,31,19,23,103
62466,39,2,19,13,5,34
62467,3,1,2,0,0,3
62468,32,11,10,2,9,23
62469,68,33,19,0,16,52
62470,76,54,12,1,9,67
62471,117,55,32,3,27,90
62472,46,18,20,0,8,38
62473,104,26,58,3,17,87
62474,224,130,50,0,44,180
62475,3,1,2,0,0,3
62476,38,23,5,3,7,31
62477,10,3,5,0,2,8
62478,70,52,3,0,15,55
62479,74,44,16,1,13,61
62480,199,100,50,0,49,150
62481,33,3,23,2,5,28
62482,248,188,13,0,47,201
62483,53,35,10,0,8,45
62484,111,49,34,2,26,85
62485,30,9,7,6,8,22
62486,61,24,27,0,10,51
62487,613,353,128,18,114,499
62488,231,157,58,4,12,219
62489,66,28,15,10,13,53
62490,126,75,21,3,27,99
62491,78,43,18,5,12,66
62492,290,198,68,3,21,269
62493,82,30,40,0,12,70
62494,29,10,11,0,8,21
62495,26,8,15,0,3,23
62496,13,6,4,0,3,10
62497,31,14,10,1,6,25
62498,8,5,2,0,1,7
62499,34,13,16,1,4,30
62500,434,128,164,46,96,338
62501,26,4,16,0,6,20
62502,4,2,0,0,2,2
62503,51,13,19,11,8,43
62504,36,6,20,4,6,30
62505,32,21,9,0,2,30
62506,171,107,22,3,39,132
62507,170,52,86,0,32,138
62508,117,32,65,0,20,97
62509,144,63,31,18,32,112
62510,177,110,5,21,41,136
62511,34,27,0,0,7,27
62512,208,92,63,19,34,174
62513,37,26,7,1,3,34
62514,47,12,24,0,11,36
62515,21,9,8,1,3,18
62516,31,4,22,0,5,26
62517,15,6,7,0,2,13
62518,53,3,40,3,7,46
62519,49,33,6,2,8,41
62520,92,41,15,7,29,63
62521,56,35,14,5,2,54
62522,49,33,1,4,11,38
62523,20,11,4,1,4,16
62524,59,15,35,1,8,51
62525,37,24,2,0,11,26
62526,69,15,28,9,17,52
62527,70,33,16,13,8,62
62528,54,32,6,5,11,43
62529,30,17,7,2,4,26
62530,46,13,11,13,9,37
62531,123,51,31,18,23,100
62532,32,21,9,0,2,30
62533,83,29,34,4,16,67
62534,125,90,5,5,25,100
62535,300,127,106,6,61,239
62536,71,30,22,0,19,52
62537,32,21,9,0,2,30
62538,102,62,22,0,18,84
62539,350,185,91,15,59,291
62540,69,26,29,3,11,58
62541,12,7,2,0,3,9
62542,15,2,8,0,5,10
62543,96,59,18,12,7,89
62544,455,118,196,40,101,354
62545,127,75,22,3,27,100
62546,86,42,25,2,17,69
62547,171,50,95,4,22,149
62548,22,3,12,1,6,16
62549,647,359,163,21,104,543
62550,16,12,3,0,1,15
62551,19,7,7,1,4,15
62552,30,3,17,0,10,20
62553,39,25,9,0,5,34
62554,60,21,32,0,7,53
62555,121,53,42,0,26,95
62556,21,4,13,0,4,17
62557,86,39,31,1,15,71
62558,82,21,45,3,13,69
62559,46,18,20,0,8,38
62560,74,17,35,3,19,55
62561,64,41,9,0,14,50
62562,456,339,24,0,93,363
62563,65,12,43,1,9,56
62564,9,3,5,0,1,8
62565,351,255,18,2,76,275
62566,546,349,85,4,108,438
62567,26,13,7,0,6,20
62568,257,94,109,5,49,208
62569,73,36,13,8,16,57
62570,46,18,20,0,8,38
62571,42,17,4,13,8,34
62572,460,248,118,18,76,384
62573,83,39,31,4,9,74
62574,38,18,13,1,6,32
62575,76,24,27,8,17,59
62576,449,215,93,44,97,352
62577,92,39,21,10,22,70
62578,47,14,25,1,7,40
62579,25,8,11,0,6,19
62580,73,50,13,0,10,63
62581,130,85,27,0,18,112
62582,24,0,20,0,4,20
62583,65,31,7,10,17,48
62584,19,5,10,0,4,15
62585,52,16,28,3,5,47
62586,45,0,34,0,11,34
62587,38,10,19,1,8,30
62588,46,18,20,0,8,38
62589,322,145,109,6,62,260
62590,472,219,153,11,89,383
62591,26,15,8,0,3,23
62592,29,4,17,2,6,23
62593,35,9,15,4,7,28
62594,54,2,46,0,6,48
62595,0,0,0,0,0,0
62596,5,3,0,0,2,3
62597,361,265,22,0,74,287
62598,261,102,56,39,64,197
62599,32,14,11,0,7,25
62600,28,18,4,0,6,22
62601,100,39,30,9,22,78
62602,113,27,33,30,23,90
62603,319,167,85,15,52,267
62604,3,1,1,0,1,2
62605,37,15,9,3,10,27
62606,30,11,5,8,6,24
62607,11,9,0,0,2,9
62608,60,29,16,0,15,45
62609,38,20,3,5,10,28
62610,98,49,32,0,17,81
62611,7,2,3,2,0,7
62612,14,1,7,4,2,12
62613,283,77,35,124,47,236
62614,24,4,13,0,7,17
62615,82,42,15,11,14,68
62616,202,54,112,4,32,170
62617,26,1,19,1,5,21
62618,90,22,51,9,8,82
62619,36,6,24,1,5,31
62620,19,11,3,1,4,15
62621,85,56,15,0,14,71
62622,143,110,6,0,27,116
62623,31,17,4,3,7,24
62624,94,35,21,19,19,75
62625,9,6,1,0,2,7
62626,30,13,9,2,6,24
62627,31,6,14,5,6,25
62628,62,23,21,1,17,45
62629,126,75,21,3,27,99
62630,89,33,38,1,17,72
62631,6,4,0,0,2,4
62632,71,54,1,0,16,55
62633,46,9,26,3,8,38
62634,262,67,41,111,43,219
62635,46,18,20,0,8,38
62636,47,24,12,1,10,37
62637,25,10,1,5,9,16
62638,449,221,122,12,94,355
62639,96,53,25,0,18,78
62640,37,9,23,1,4,33
62641,29,19,5,0,5,24
62642,34,3,21,0,10,24
62643,32,21,9,0,2,30
62644,32,21,9,0,2,30
62645,62,44,8,4,6,56
62646,198,78,37,33,50,148
62647,137,48,64,0,25,112
62648,59,29,12,5,13,46
62649,220,20,159,2,39,181
62650,211,50,30,95,36,175
62651,222,44,59,78,41,181
62652,74,25,39,0,10,64
62653,75,43,11,6,15,60
62654,134,74,27,5,28,106
62655,82,42,16,8,16,66
62656,193,89,80,0,24,169
62657,85,44,27,0,14,71
62658,56,15,27,0,14,42
62659,60,33,16,1,10,50
62660,91,54,15,1,21,70
62661,43,9,17,9,8,35
62662,22,15,0,0,7,15
62663,3,0,1,1,1,2
62664,89,62,6,9,12,77
62665,45,21,13,2,9,36
62666,32,21,9,0,2,30
62667,9,3,3,0,3,6
62668,23,1,19,0,3,20
62669,95,29,23,25,18,77
62670,47,6,29,0,12,35
62671,23,9,9,0,5,18
62672,1025,385,403,46,191,834
62673,161,10,90,28,33,128
62674,493,349,42,1,101,392
62675,86,22,51,0,13,73
62676,139,102,6,4,27,112
62677,67,37,10,9,11,56
62678,38,9,18,4,7,31
62679,39,13,18,0,8,31
62680,43,12,13,9,9,34
62681,49,29,6,2,12,37
62682,52,23,12,9,8,44
62683,73,34,28,0,11,62
62684,32,21,9,0,2,30
62685,91,49,17,10,15,76
62686,126,45,43,13,25,101
62687,34,17,10,0,7,27
62688,40,21,10,0,9,31
62689,102,31,45,7,19,83
62690,131,70,30,7,24,107
62691,42,13,14,6,9,33
62692,108,36,43,11,18,90
62693,213,114,48,0,51,162
62694,50,30,2,3,15,35
62695,37,15,4,10,8,29
62696,134,56,42,0,36,98
62697,46,22,10,1,13,33
62698,70,35,13,7,15,55
62699,80,25,26,9,20,60
62700,167,86,40,0,41,126
62701,45,22,15,0,8,37
62702,9,5,2,0,2,7
62703,48,28,14,0,6,42
62704,7,0,4,1,2,5
62705,42,11,21,0,10,32
62706,128,52,42,14,20,108
62707,46,18,20,0,8,38
62708,26,11,8,4,3,23
62709,45,22,12,0,11,34
62710,218,74,81,15,48,170
62711,153,66,48,9,30,123
62712,88,47,26,4,11,77
62713,36,6,22,0,8,28
62714,49,30,9,0,10,39
62715,97,26,49,0,22,75
62716,104,27,26,29,22,82
62717,41,14,23,0,4,37
62718,272,53,162,4,53,219
62719,478,187,147,44,100,378
62720,44,30,2,1,11,33
62721,90,52,14,0,24,66
62722,370,189,98,19,64,306
62723,210,114,34,19,43,167
62724,105,27,27,29,22,83
62725,8,4,3,0,1,7
62726,110,37,44,11,18,92
62727,103,44,20,14,25,78
62728,40,7,26,1,6,34
62729,26,16,7,0,3,23
62730,20,12,4,1,3,17
62731,37,5,5,20,7,30
62732,247,62,132,1,52,195
62733,178,47,19,84,28,150
62734,57,28,13,9,7,50
62735,10,0,6,0,4,6
62736,75,32,18,7,18,57
62737,61,17,29,2,13,48
62738,10,2,7,0,1,9
62739,37,19,9,1,8,29
62740,15,6,4,0,5,10
62741,63,43,2,2,16,47
62742,18,1,12,1,4,14
62743,42,6,27,3,6,36
62744,73,37,9,17,10,63
62745,31,1,23,0,7,24
62746,41,12,12,8,9,32
62747,21,10,9,0,2,19
62748,99,27,48,8,16,83
62749,55,6,39,0,10,45
62750,144,47,46,17,34,110
62751,11,5,3,1,2,9
62752,38,22,7,3,6,32
62753,20,0,15,0,5,15
62754,202,50,117,0,35,167
62755,303,212,19,4,68,235
62756,117,43,30,16,28,89
62757,66,40,6,8,12,54
62758,232,87,53,37,55,177
62759,598,335,148,21,94,504
62760,36,11,19,0,6,30
62761,51,26,10,7,8,43
62762,53,38,4,1,10,43
62763,136,28,51,30,27,109
62764,10,6,0,0,4,6
62765,33,24,4,0,5,28
62766,84,29,31,12,12,72
62767,49,30,12,0,7,42
62768,335,254,19,0,62,273
62769,116,37,48,7,24,92
62770,32,21,9,0,2,30
62771,45,12,19,0,14,31
62772,332,247,14,2,69,263
62773,118,32,65,0,21,97
62774,69,13,36,6,14,55
62775,98,66,9,3,20,78
62776,117,90,8,2,17,100
62777,67,37,10,2,18,49
62778,41,32,1,0,8,33
62779,93,42,30,5,16,77
62780,179,128,14,1,36,143
62781,33,10,8,7,8,25
62782,68,29,24,4,11,57
62783,3,2,1,0,0,3
62784,102,49,34,1,18,84
62785,102,26,50,4,22,80
62786,63,44,4,6,9,54
62787,170,86,32,22,30,140
62788,18,5,9,0,4,14
62789,143,107,9,0,27,116
62790,91,27,46,0,18,73
62791,2,0,1,1,0,2
62792,83,21,46,3,13,70
62793,200,95,68,1,36,164
62794,51,14,19,3,15,36
62795,101,36,26,21,18,83
62796,41,2,27,0,12,29
62797,57,41,3,1,12,45
62798,65,48,2,0,15,50
62799,217,43,57,77,40,177
62800,31,15,8,1,7,24
62801,27,8,10,1,8,19
62802,82,42,7,14,19,63
62803,121,68,32,12,9,112
62804,109,38,42,11,18,91
62805,32,21,9,0,2,30
62806,44,18,20,1,5,39
62807,64,30,13,9,12,52
62808,390,227,83,17,63,327
62809,99,48,30,5,16,83
62810,44,4,27,4,9,35
62811,107,39,40,3,25,82
62812,46,20,5,16,5,41
62813,7,1,4,1,1,6
62814,17,1,14,0,2,15
62815,46,18,20,0,8,38
62816,6,1,4,0,1,5
62817,48,6,28,4,10,38
62818,13,1,7,0,5,8
62819,32,21,9,0,2,30
62820,161,117,13,1,30,131
62821,32,13,11,2,6,26
62822,23,8,8,1,6,17
62823,107,28,42,13,24,83
62824,30,17,9,0,4,26
62825,40,21,12,0,7,33
62826,43,16,12,1,14,29
62827,126,52,51,2,21,105
62828,83,35,21,13,14,69
62829,14,9,2,0,3,11
62830,30,13,10,0,7,23
62831,542,306,119,16,101,441
62832,120,58,38,4,20,100
62833,3,0,3,0,0,3
62834,486,250,116,15,105,381
62835,168,46,54,34,34,134
62836,527,388,32,0,107,420
62837,163,38,15,85,25,138
62838,13,3,8,0,2,11
62839,29,12,10,0,7,22
62840,33,9,17,0,7,26
62841,62,23,21,1,17,45
62842,79,47,21,0,11,68
62843,78,45,18,2,13,65
62844,10,3,5,1,1,9
62845,81,41,17,7,16,65
62846,34,18,3,5,8,26
62847,25,2,18,0,5,20
62848,62,44,8,4,6,56
62849,70,37,12,6,15,55
62850,72,36,10,8,18,54
62851,73,39,15,6,13,60
62852,55,34,10,0,11,44
62853,14,11,0,0,3,11
62854,63,22,27,1,13,50
62855,121,85,23,3,10,111
62856,5,5,0,0,0,5
62857,35,15,15,0,5,30
62858,52,20,5,18,9,43
62859,13,4,4,4,1,12
62860,119,53,24,19,23,96
62861,33,12,3,15,3,30
62862,163,29,103,1,30,133
62863,42,30,4,1,7,35
62864,43,19,15,2,7,36
62865,37,9,25,1,2,35
62866,261,137,88,0,36,225
62867,38,5,26,0,7,31
62868,178,52,45,46,35,143
62869,126,67,15,16,28,98
62870,30,12,13,0,5,25
62871,47,24,17,0,6,41
62872,102,46,29,1,26,76
62873,50,22,17,3,8,42
62874,73,50,9,1,13,60
62875,37,9,25,1,2,35
62876,220,150,30,0,40,180
62877,25,10,10,2,3,22
62878,14,2,8,3,1,13
62879,175,84,26,25,40,135
62880,221,149,31,0,41,180
62881,32,21,9,0,2,30
62882,14,9,0,2,3,11
62883,8,0,6,0,2,6
62884,46,18,20,0,8,38
62885,39,5,24,4,6,33
62886,14,5,5,0,4,10
62887,213,117,33,23,40,173
62888,126,2,106,0,18,108
62889,336,168,106,5,57,279
62890,60,37,8,3,12,48
62891,49,28,11,0,10,39
62892,378,200,96,8,74,304
62893,9,6,2,0,1,8
62894,18,1,11,5,1,17
62895,92,46,33,0,13,79
62896,179,91,29,28,31,148
62897,672,393,142,18,119,553
62898,139,57,52,3,27,112
62899,51,37,2,1,11,40
62900,8,1,6,0,1,7
62901,27,10,13,1,3,24
62902,152,113,17,0,22,130
62903,111,43,24,20,24,87
62904,29,5,19,0,5,24
62905,14,5,8,0,1,13
62906,99,39,26,12,22,77
62907,162,82,22,27,31,131
62908,64,22,27,0,15,49
62909,131,55,29,22,25,106
62910,109,63,15,9,22,87
62911,73,19,38,1,15,58
62912,386,223,85,0,78,308
62913,30,22,3,0,5,25
62914,188,108,23,23,34,154
62915,28,7,12,1,8,20
62916,47,17,16,5,9,38
62917,65,17,26,0,22,43
62918,141,87,21,4,29,112
62919,49,24,15,0,10,39
62920,9,5,3,0,1,8
62921,12,3,8,0,1,11
62922,203,88,58,20,37,166
62923,75,31,15,8,21,54
62924,176,100,19,20,37,139
62925,52,18,21,2,11,41
62926,81,25,37,5,14,67
62927,40,18,9,6,7,33
62928,44,24,17,0,3,41
62929,29,21,2,0,6,23
62930,380,221,81,0,78,302
62931,33,6,22,1,4,29
62932,43,34,1,2,6,37
62933,42,16,15,0,11,31
62934,248,183,13,1,51,197
62935,99,42,34,5,18,81
62936,137,50,41,17,29,108
62937,36,5,24,0,7,29
62938,53,34,6,0,13,40
62939,69,17,44,2,6,63
62940,86,44,25,0,17,69
62941,29,6,14,4,5,24
62942,136,77,31,5,23,113
62943,209,89,44,28,48,161
62944,26,8,11,0,7,19
62945,4,1,3,0,0,4
62946,15,6,2,4,3,12
62947,17,10,2,0,5,12
62948,15,0,14,0,1,14
62949,63,18,33,1,11,52
62950,18,9,4,1,4,14
62951,17,1,12,1,3,14
62952,107,49,39,1,18,89
62953,139,85,21,4,29,110
62954,31,6,13,5,7,24
62955,38,5,26,0,7,31
62956,278,75,150,1,52,226
62957,49,19,21,0,9,40
62958,79,42,16,4,17,62
62959,30,4,17,0,9,21
62960,44,36,2,0,6,38
62961,362,161,126,6,69,293
62962,181,72,57,7,45,136
62963,18,9,4,1,4,14
62964,29,11,11,1,6,23
62965,296,184,48,0,64,232
62966,62,30,21,0,11,51
62967,24,10,9,1,4,20
62968,190,104,56,0,30,160
62969,93,51,27,2,13,80
62970,46,18,20,0,8,38
62971,51,15,26,0,10,41
62972,62,32,13,1,16,46
62973,109,44,15,17,33,76
62974,63,16,32,2,13,50
62975,46,28,9,4,5,41
62976,43,6,15,11,11,32
62977,34,6,20,0,8,26
62978,447,205,151,11,80,367
62979,42,15,20,1,6,36
62980,72,20,37,0,15,57
62981,75,29,23,6,17,58
62982,115,62,24,4,25,90
62983,197,98,50,0,49,148
62984,92,40,29,3,20,72
62985,12,5,3,2,2,10
62986,16,11,4,0,1,15
62987,32,21,9,0,2,30
62988,28,14,6,0,8,20
62989,23,10,2,3,8,15
62990,30,14,12,3,1,29
62991,0,0,0,0,0,0
62992,32,21,9,0,2,30
62993,65,30,19,2,14,51
62994,41,31,0,2,8,33
62995,39,13,16,0,10,29
62996,3,1,2,0,0,3
62997,62,25,21,3,13,49
62998,62,41,10,2,9,53
62999,35,6,15,6,8,27
63000,57,26,22,0,9,48
63001,23,5,12,0,6,17
63002,94,37,39,2,16,78
63003,99,41,37,3,18,81
63004,399,228,91,0,80,319
63005,32,21,9,0,2,30
63006,33,20,6,1,6,27
63007,37,8,20,0,9,28
63008,11,4,5,0,2,9
63009,59,26,23,0,10,49
63010,170,124,21,0,25,145
63011,39,18,5,5,11,28
63012,11,2,9,0,0,11
63013,66,22,34,0,10,56
63014,193,125,25,7,36,157
63015,34,10,14,5,5,29
63016,479,264,104,12,99,380
63017,118,67,32,10,9,109
63018,34,13,13,0,8,26
63019,20,2,11,1,6,14
63020,11,5,3,0,3,8
63021,231,107,77,0,47,184
63022,73,28,23,5,17,56
63023,82,31,32,0,19,63
63024,85,32,30,2,21,64
63025,152,81,32,7,32,120
63026,6,1,3,0,2,4
63027,38,26,1,1,10,28
63028,31,0,11,16,4,27
63029,27,12,8,2,5,22
63030,280,60,147,3,70,210
63031,50,41,0,0,9,41
63032,166,71,54,3,38,128
63033,85,22,42,4,17,68
63034,42,11,23,1,7,35
63035,30,7,16,2,5,25
63036,33,17,8,3,5,28
63037,401,190,110,16,85,316
63038,36,20,8,0,8,28
63039,84,43,21,1,19,65
63040,146,109,9,0,28,118
63041,17,13,0,0,4,13
63042,34,10,17,2,5,29
63043,93,48,18,11,16,77
63044,69,34,22,0,13,56
63045,10,4,5,0,1,9
63046,87,46,12,2,27,60
63047,85,33,16,16,20,65
63048,32,21,9,0,2,30
63049,27,11,4,7,5,22
63050,128,82,18,3,25,103
63051,30,21,0,0,9,21
63052,14,6,4,0,4,10
63053,357,158,124,6,69,288
63054,119,37,57,3,22,97
63055,43,9,23,5,6,37
63056,501,264,91,45,101,400
63057,112,74,24,3,11,101
63058,66,26,30,0,10,56
63059,86,57,15,0,14,72
63060,48,28,14,0,6,42
63061,26,8,11,0,7,19
63062,56,14,23,1,18,38
63063,43,17,13,3,10,33
63064,47,27,13,1,6,41
63065,159,39,16,80,24,135
63066,50,7,32,2,9,41
63067,8,5,2,0,1,7
63068,63,23,27,1,12,51
63069,100,34,42,7,17,83
63070,77,39,23,2,13,64
63071,263,63,133,7,60,203
63072,64,23,31,2,8,56
63073,10,2,6,0,2,8
63074,18,2,10,0,6,12
63075,489,332,47,1,109,380
63076,40,21,11,1,7,33
63077,34,13,11,3,7,27
63078,292,74,42,129,47,245
63079,33,13,10,0,10,23
63080,99,40,47,0,12,87
63081,2,0,2,0,0,2
63082,109,74,14,1,20,89
63083,60,26,17,6,11,49
63084,57,19,16,8,14,43
63085,0,0,0,0,0,0
63086,33,8,16,0,9,24
63087,29,5,21,2,1,28
63088,32,21,9,0,2,30
63089,675,391,144,21,119,556
63090,59,28,19,0,12,47
63091,26,12,9,0,5,21
63092,37,22,6,2,7,30
63093,74,41,18,0,15,59
63094,72,16,45,0,11,61
63095,55,34,10,0,11,44
63096,193,127,26,5,35,158
63097,154,72,43,0,39,115
63098,385,171,133,11,70,315
63099,56,31,20,0,5,51
63100,51,36,2,1,12,39
63101,190,132,12,9,37,153
63102,46,6,32,0,8,38
63103,342,159,85,27,71,271
63104,15,2,7,1,5,10
63105,93,48,14,2,29,64
63106,77,25,31,9,12,65
63107,40,17,15,0,8,32
63108,76,40,13,9,14,62
63109,288,124,104,10,50,238
63110,6,0,5,0,1,5
63111,176,18,95,26,37,139
63112,115,50,40,4,21,94
63113,95,46,33,4,12,83
63114,53,33,5,0,15,38
63115,149,65,32,18,34,115
63116,136,62,50,4,20,116
63117,68,23,27,2,16,52
63118,53,37,3,1,12,41
63119,35,6,16,6,7,28
63120,133,94,15,0,24,109
63121,0,0,0,0,0,0
63122,63,26,20,6,11,52
63123,46,18,20,0,8,38
63124,50,17,23,0,10,40
63125,64,15,23,3,23,41
63126,51,30,13,0,8,43
63127,20,14,2,1,3,17
63128,83,25,33,15,10,73
63129,288,80,36,127,45,243
63130,47,16,17,0,14,33
63131,173,84,24,25,40,133
63132,19,2,11,0,6,13
63133,47,10,27,1,9,38
63134,2,0,2,0,0,2
63135,31,14,10,0,7,24
63136,63,22,27,1,13,50
63137,91,32,25,12,22,69
63138,56,32,3,11,10,46
63139,42,19,12,4,7,35
63140,11,1,5,0,5,6
63141,24,10,7,3,4,20
63142,40,12,18,0,10,30
63143,36,9,20,0,7,29
63144,17,4,8,0,5,12
63145,173,128,5,1,39,134
63146,196,41,68,42,45,151
63147,339,140,123,6,70,269
63148,23,12,6,1,4,19
63149,191,47,29,81,34,157
63150,20,11,4,1,4,16
63151,146,15,101,2,28,118
63152,111,52,39,0,20,91
63153,46,9,15,12,10,36
63154,36,13,19,1,3,33
63155,55,26,14,3,12,43
63156,53,20,24,0,9,44
63157,72,4,53,0,15,57
63158,62,31,8,8,15,47
63159,78,23,31,5,19,59
63160,91,20,47,10,14,77
63161,266,138,92,0,36,230
63162,278,176,42,0,60,218
63163,10,9,0,0,1,9
63164,37,22,1,7,7,30
63165,433,216,112,11,94,339
63166,32,21,9,0,2,30
63167,179,108,55,4,12,167
63168,65,14,35,1,15,50
63169,110,28,30,22,30,80
63170,152,111,6,5,30,122
63171,81,31,8,27,15,66
63172,44,31,2,0,11,33
63173,634,363,135,19,117,517
63174,27,17,4,0,6,21
63175,57,25,13,7,12,45
63176,160,115,11,0,34,126
63177,27,14,8,0,5,22
63178,56,10,22,13,11,45
63179,190,51,108,4,27,163
63180,71,14,45,0,12,59
63181,14,5,5,0,4,10
63182,142,62,53,1,26,116
63183,51,17,20,2,12,39
63184,37,14,10,6,7,30
63185,39,11,15,3,10,29
63186,200,102,50,0,48,152
63187,122,24,43,22,33,89
63188,76,54,2,2,18,58
63189,99,53,19,4,23,76
63190,27,13,10,0,4,23
63191,28,5,12,4,7,21
63192,67,35,16,3,13,54
63193,55,20,28,0,7,48
63194,38,16,3,8,11,27
63195,27,1,18,0,8,19
63196,0,0,0,0,0,0
63197,42,14,14,1,13,29
63198,437,140,157,43,97,340
63199,46,7,30,0,9,37
63200,121,37,44,16,24,97
63201,205,138,29,4,34,171
63202,35,11,12,5,7,28
63203,297,38,203,2,54,243
63204,22,16,2,0,4,18
63205,265,122,95,6,42,223
63206,38,20,3,5,10,28
63207,85,45,19,4,17,68
63208,8,4,2,1,1,7
63209,14,7,2,0,5,9
63210,28,0,25,0,3,25
63211,23,22,0,0,1,22
63212,103,43,18,20,22,81
63213,6,2,3,0,1,5
63214,10,3,5,0,2,8
63215,25,15,4,0,6,19
63216,63,20,26,7,10,53
63217,133,78,27,3,25,108
63218,88,45,25,2,16,72
63219,76,43,16,1,16,60
63220,53,18,28,0,7,46
63221,10,7,3,0,0,10
63222,477,233,95,49,100,377
63223,164,31,106,1,26,138
63224,32,14,12,0,6,26
63225,39,26,1,8,4,35
63226,29,18,5,0,6,23
63227,156,80,45,1,30,126
63228,17,6,6,0,5,12
63229,61,24,27,0,10,51
63230,31,4,25,0,2,29
63231,157,62,60,6,29,128
63232,14,1,10,0,3,11
63233,30,16,6,1,7,23
63234,152,67,54,1,30,122
63235,19,4,5,8,2,17
63236,103,53,24,0,26,77
63237,19,8,6,1,4,15
63238,527,377,41,1,108,419
63239,391,226,87,0,78,313
63240,26,8,13,0,5,21
63241,74,41,17,0,16,58
63242,261,197,15,0,49,212
63243,33,15,10,2,6,27
63244,24,7,8,0,9,15
63245,38,9,19,0,10,28
63246,309,159,83,15,52,257
63247,147,112,4,2,29,118
63248,219,148,30,1,40,179
63249,2,1,1,0,0,2
63250,88,24,40,8,16,72
63251,9,3,3,0,3,6
63252,149,74,50,0,25,124
63253,81,1,61,0,19,62
63254,222,125,28,26,43,179
63255,60,42,5,1,12,48
63256,595,337,145,19,94,501
63257,41,18,10,6,7,34
63258,116,34,60,0,22,94
63259,45,29,5,1,10,35
63260,5,0,0,0,5,0
63261,6,3,1,1,1,5
63262,82,66,4,2,10,72
63263,40,8,19,6,7,33
63264,90,45,19,4,22,68
63265,68,46,5,3,14,54
63266,293,40,201,2,50,243
63267,23,14,3,4,2,21
63268,438,328,20,0,90,348
63269,80,25,25,9,21,59
63270,54,22,15,1,16,38
63271,32,21,9,0,2,30
63272,66,46,12,0,8,58
63273,33,14,8,4,7,26
63274,31,11,11,2,7,24
63275,4,0,3,0,1,3
63276,41,10,4,20,7,34
63277,80,35,32,0,13,67
63278,26,18,3,0,5,21
63279,130,67,13,23,27,103
63280,462,191,121,49,101,361
63281,47,17,19,2,9,38
63282,63,44,8,0,11,52
63283,126,68,24,12,22,104
63284,13,2,10,0,1,12
63285,22,4,5,6,7,15
63286,53,34,13,0,6,47
63287,166,116,13,0,37,129
63288,24,10,4,6,4,20
63289,70,38,10,10,12,58
63290,90,71,0,4,15,75
63291,246,130,70,0,46,200
63292,72,33,25,2,12,60
63293,106,29,40,12,25,81
63294,396,180,134,11,71,325
63295,12,7,3,0,2,10
63296,22,3,14,1,4,18
63297,140,100,16,0,24,116
63298,66,32,14,0,20,46
63299,39,10,26,0,3,36
63300,52,42,1,0,9,43
63301,221,124,45,14,38,183
63302,100,46,13,21,20,80
63303,70,20,39,1,10,60
63304,94,45,35,0,14,80
63305,10,1,6,0,3,7
63306,105,36,26,25,18,87
63307,65,27,22,6,10,55
63308,166,99,38,1,28,138
63309,188,104,54,0,30,158
63310,34,15,10,0,9,25
63311,485,259,111,13,102,383
63312,256,120,67,24,45,211
63313,12,4,5,0,3,9
63314,36,16,9,3,8,28
63315,86,32,17,10,27,59
63316,34,13,16,2,3,31
63317,12,1,10,0,1,11
63318,3,0,2,0,1,2
63319,65,47,1,0,17,48
63320,400,121,173,24,82,318
63321,575,420,39,1,115,460
63322,77,25,32,8,12,65
63323,263,202,15,0,46,217
63324,45,6,27,5,7,38
63325,62,44,8,4,6,56
63326,47,13,14,7,13,34
63327,29,19,3,4,3,26
63328,30,9,15,0,6,24
63329,229,174,6,2,47,182
63330,32,13,12,2,5,27
63331,23,5,14,0,4,19
63332,128,91,9,2,26,102
63333,7,3,3,0,1,6
63334,31,10,11,4,6,25
63335,46,18,22,0,6,40
63336,82,51,15,0,16,66
63337,107,51,30,4,22,85
63338,29,2,22,1,4,25
63339,48,16,9,13,10,38
63340,56,30,18,0,8,48
63341,26,3,18,0,5,21
63342,18,13,3,0,2,16
63343,30,23,0,0,7,23
63344,157,66,54,8,29,128
63345,161,59,68,0,34,127
63346,23,14,3,4,2,21
63347,21,0,20,0,1,20
63348,79,20,39,8,12,67
63349,633,367,133,18,115,518
63350,38,27,7,0,4,34
63351,20,1,7,10,2,18
63352,627,375,119,18,115,512
63353,191,110,25,21,35,156
63354,56,25,15,2,14,42
63355,173,70,52,7,44,129
63356,97,24,53,3,17,80
63357,442,139,181,21,101,341
63358,76,44,16,3,13,63
63359,38,4,27,0,7,31
63360,99,22,48,12,17,82
63361,138,40,47,19,32,106
63362,38,23,7,0,8,30
63363,413,134,145,48,86,327
63364,202,103,49,0,50,152
63365,3,0,1,0,2,1
63366,4,1,2,0,1,3
63367,393,198,101,12,82,311
63368,102,78,4,2,18,84
63369,206,115,30,23,38,168
63370,138,10,81,18,29,109
63371,296,145,87,4,60,236
63372,30,7,21,0,2,28
63373,6,0,5,0,1,5
63374,73,27,34,3,9,64
63375,42,23,10,0,9,33
63376,142,10,81,19,32,110
63377,226,64,111,14,37,189
63378,92,41,28,3,20,72
63379,41,30,2,0,9,32
63380,36,14,11,3,8,28
63381,20,3,0,10,7,13
63382,62,17,21,6,18,44
63383,331,176,78,20,57,274
63384,124,66,15,14,29,95
63385,39,2,30,1,6,33
63386,26,13,3,1,9,17
63387,112,24,57,0,31,81
63388,45,24,3,11,7,38
63389,17,4,8,1,4,13
63390,123,70,12,14,27,96
63391,41,13,14,6,8,33
63392,81,48,14,0,19,62
63393,82,56,9,3,14,68
63394,62,27,20,4,11,51
63395,25,14,3,0,8,17
63396,32,15,13,0,4,28
63397,212,73,98,4,37,175
63398,19,1,12,0,6,13
63399,101,60,27,1,13,88
63400,152,47,46,24,35,117
63401,18,4,10,0,4,14
63402,121,65,10,23,23,98
63403,60,13,31,0,16,44
63404,353,200,76,19,58,295
63405,49,31,9,0,9,40
63406,78,41,15,8,14,64
63407,39,5,29,0,5,34
63408,46,18,20,0,8,38
63409,88,42,21,4,21,67
63410,33,21,3,1,8,25
63411,85,44,24,4,13,72
63412,44,10,16,7,11,33
63413,120,49,46,6,19,101
63414,2,1,1,0,0,2
63415,52,34,7,0,11,41
63416,213,149,48,2,14,199
63417,269,201,15,0,53,216
63418,15,1,12,0,2,13
63419,31,13,11,2,5,26
63420,172,89,42,0,41,131
63421,95,42,28,1,24,71
63422,108,59,21,6,22,86
63423,69,11,44,0,14,55
63424,408,205,79,40,84,324
63425,26,11,8,0,7,19
63426,22,3,13,0,6,16
63427,35,23,3,0,9,26
63428,176,21,94,24,37,139
63429,57,21,16,6,14,43
63430,77,30,26,1,20,57
63431,32,21,9,0,2,30
63432,89,46,28,1,14,75
63433,172,83,27,22,40,132
63434,60,23,23,4,10,50
63435,51,21,13,3,14,37
63436,182,100,52,0,30,152
63437,32,21,9,0,2,30
63438,23,0,19,0,4,19
63439,141,62,31,18,30,111
63440,20,9,4,2,5,15
63441,5,1,1,1,2,3
63442,41,15,14,5,7,34
63443,68,45,12,0,11,57
63444,119,41,34,13,31,88
63445,55,39,6,1,9,46
63446,22,11,6,0,5,17
63447,169,48,78,5,38,131
63448,59,25,18,0,16,43
63449,66,24,5,28,9,57
63450,48,18,16,1,13,35
63451,155,100,3,17,35,120
63452,6,2,3,0,1,5
63453,32,21,9,0,2,30
63454,42,10,13,8,11,31
63455,40,16,15,0,9,31
63456,63,42,4,0,17,46
63457,49,3,8,25,13,36
63458,293,81,39,128,45,248
63459,56,26,6,12,12,44
63460,10,1,3,2,4,6
63461,2,1,0,0,1,1
63462,142,63,31,18,30,112
63463,21,10,9,0,2,19
63464,31,4,19,2,6,25
63465,360,162,124,6,68,292
63466,87,63,6,0,18,69
63467,33,0,28,0,5,28
63468,83,35,22,12,14,69
63469,40,14,15,1,10,30
63470,73,20,25,12,16,57
63471,78,50,16,0,12,66
63472,20,8,5,1,6,14
63473,36,18,12,0,6,30
63474,80,30,34,2,14,66
63475,269,61,141,7,60,209
63476,15,9,4,0,2,13
63477,56,26,22,1,7,49
63478,60,14,29,2,15,45
63479,27,4,14,2,7,20
63480,21,7,4,6,4,17
63481,20,8,6,0,6,14
63482,21,4,8,4,5,16
63483,33,25,2,2,4,29
63484,47,34,2,0,11,36
63485,93,9,62,5,17,76
63486,19,7,5,1,6,13
63487,40,21,13,0,6,34
63488,72,44,12,2,14,58
63489,168,73,50,12,33,135
63490,274,63,56,100,55,219
63491,29,4,17,2,6,23
63492,10,5,2,0,3,7
63493,29,17,5,0,7,22
63494,7,1,4,0,2,5
63495,270,110,59,38,63,207
63496,69,27,23,2,17,52
63497,178,101,20,17,40,138
63498,405,229,94,0,82,323
63499,39,26,7,0,6,33
63500,105,38,25,20,22,83
63501,38,26,1,1,10,28
63502,100,41,24,13,22,78
63503,32,18,10,0,4,28
63504,218,54,70,44,50,168
63505,102,79,7,0,16,86
63506,668,389,152,17,110,558
63507,48,22,16,2,8,40
63508,80,31,32,0,17,63
63509,27,9,11,2,5,22
63510,88,31,21,18,18,70
63511,164,123,4,1,36,128
63512,391,226,87,0,78,313
63513,442,203,138,12,89,353
63514,34,26,2,0,6,28
63515,198,77,37,34,50,148
63516,67,37,24,2,4,63
63517,33,3,23,1,6,27
63518,32,21,9,0,2,30
63519,59,15,20,7,17,42
63520,72,42,6,10,14,58
63521,114,42,37,7,28,86
63522,20,9,5,2,4,16
63523,67,32,27,0,8,59
63524,35,2,26,0,7,28
63525,247,190,13,0,44,203
63526,37,23,8,0,6,31
63527,37,15,14,0,8,29
63528,107,36,31,15,25,82
63529,74,4,53,0,17,57
63530,235,12,178,0,45,190
63531,19,8,5,4,2,17
63532,8,0,4,0,4,4
63533,32,21,9,0,2,30
63534,63,41,8,0,14,49
63535,27,10,14,0,3,24
63536,172,52,88,0,32,140
63537,675,395,143,18,119,556
63538,67,39,18,1,9,58
63539,86,36,28,1,21,65
63540,195,126,24,9,36,159
63541,28,16,5,0,7,21
63542,71,40,15,0,16,55
63543,237,156,22,3,56,181
63544,126,67,28,5,26,100
63545,59,49,0,1,9,50
63546,42,18,16,1,7,35
63547,41,14,15,2,10,31
63548,200,110,30,21,39,161
63549,92,51,17,6,18,74
63550,48,3,32,3,10,38
63551,40,18,14,0,8,32
63552,180,8,141,0,31,149
63553,124,55,18,18,33,91
63554,14,5,5,0,4,10
63555,161,70,50,3,38,123
63556,66,17,3,33,13,53
63557,16,1,7,0,8,8
63558,17,7,4,1,5,12
63559,23,4,10,2,7,16
63560,56,38,12,0,6,50
63561,111,41,47,0,23,88
63562,27,11,12,1,3,24
63563,105,27,27,29,22,83
63564,46,13,11,13,9,37
63565,175,11,131,0,33,142
63566,30,17,8,0,5,25
63567,33,5,22,0,6,27
63568,15,3,9,0,3,12
63569,73,31,28,2,12,61
63570,78,7,58,1,12,66
63571,24,7,10,0,7,17
63572,21,14,1,3,3,18
63573,67,37,12,4,14,53
63574,1,1,0,0,0,1
63575,265,184,18,4,59,206
63576,107,45,37,6,19,88
63577,109,20,55,15,19,90
63578,125,45,37,19,24,101
63579,71,19,36,9,7,64
63580,11,1,5,0,5,6
63581,38,23,5,3,7,31
63582,42,20,17,0,5,37
63583,112,57,11,18,26,86
63584,138,82,30,0,26,112
63585,224,87,14,82,41,183
63586,3,0,1,0,2,1
63587,309,234,19,0,56,253
63588,41,15,14,5,7,34
63589,26,14,2,5,5,21
63590,34,13,13,0,8,26
63591,52,20,24,0,8,44
63592,88,52,20,4,12,76
63593,110,38,43,11,18,92
63594,225,75,85,15,50,175
63595,57,11,34,4,8,49
63596,45,17,15,4,9,36
63597,156,12,94,21,29,127
63598,19,13,4,0,2,17
63599,115,47,26,18,24,91
63600,186,100,26,23,37,149
63601,29,7,16,3,3,26
63602,94,53,23,0,18,76
63603,307,121,120,10,56,251
63604,30,13,8,5,4,26
63605,103,76,10,1,16,87
63606,96,29,24,25,18,78
63607,40,21,11,1,7,33
63608,36,8,18,0,10,26
63609,11,3,6,1,1,10
63610,309,234,19,0,56,253
63611,11,6,3,1,1,10
63612,30,13,9,1,7,23
63613,54,34,5,1,14,40
63614,53,24,17,4,8,45
63615,50,36,5,0,9,41
63616,39,24,8,0,7,32
63617,51,13,20,10,8,43
63618,32,12,12,1,7,25
63619,347,189,89,15,54,293
63620,171,124,11,6,30,141
63621,9,4,2,0,3,6
63622,642,370,151,17,104,538
63623,48,18,17,0,13,35
63624,166,78,52,3,33,133
63625,30,5,15,1,9,21
63626,32,23,2,1,6,26
63627,116,39,39,9,29,87
63628,118,58,22,16,22,96
63629,64,42,11,2,9,55
63630,72,36,19,3,14,58
63631,80,44,24,0,12,68
63632,432,129,163,47,93,339
63633,65,43,7,1,14,51
63634,128,68,32,0,28,100
63635,40,21,13,0,6,34
63636,54,10,30,0,14,40
63637,52,31,9,1,11,41
63638,89,33,36,2,18,71
63639,102,37,26,21,18,84
63640,48,26,6,4,12,36
63641,7,1,3,0,3,4
63642,100,38,37,8,17,83
63643,12,1,10,0,1,11
63644,82,39,25,2,16,66
63645,186,147,8,0,31,155
63646,193,40,52,65,36,157
63647,39,8,17,2,12,27
63648,17,6,10,1,0,17
63649,83,57,7,0,19,64
63650,53,20,24,0,9,44
63651,181,132,7,11,31,150
63652,131,50,39,17,25,106
63653,33,13,11,1,8,25
63654,649,382,138,17,112,537
63655,82,40,29,1,12,70
63656,20,9,5,2,4,16
63657,39,24,8,0,7,32
63658,189,78,44,22,45,144
63659,138,62,27,21,28,110
63660,151,84,20,20,27,124
63661,464,211,157,10,86,378
63662,244,102,15,83,44,200
63663,178,73,43,20,42,136
63664,448,210,151,7,80,368
63665,7,2,4,0,1,6
63666,80,34,26,6,14,66
63667,44,18,21,0,5,39
63668,59,31,16,0,12,47
63669,175,132,5,1,37,138
63670,70,39,13,2,16,54
63671,10,1,5,0,4,6
63672,8,4,2,1,1,7
63673,46,18,20,0,8,38
63674,118,64,28,0,26,92
63675,43,8,20,5,10,33
63676,187,50,62,36,39,148
63677,252,103,91,16,42,210
63678,35,17,9,1,8,27
63679,79,52,5,10,12,67
63680,3,2,1,0,0,3
63681,48,20,16,0,12,36
63682,178,101,33,0,44,134
63683,144,73,35,0,36,108
63684,43,12,20,2,9,34
63685,269,201,15,0,53,216
63686,65,41,14,1,9,56
63687,2,1,0,0,1,1
63688,58,38,7,0,13,45
63689,165,98,38,1,28,137
63690,54,23,18,0,13,41
63691,65,27,30,0,8,57
63692,38,15,15,0,8,30
63693,35,26,3,1,5,30
63694,32,21,9,0,2,30
63695,136,70,35,5,26,110
63696,81,31,34,2,14,67
63697,60,27,11,8,14,46
63698,239,91,54,37,57,182
63699,9,1,4,4,0,9
63700,602,418,55,1,128,474
63701,180,120,24,5,31,149
63702,44,24,14,0,6,38
63703,80,38,5,16,21,59
63704,38,19,9,1,9,29
63705,185,47,94,5,39,146
63706,30,0,22,0,8,22
63707,53,28,14,0,11,42
63708,46,18,20,0,8,38
63709,96,34,38,10,14,82
63710,129,78,27,0,24,105
63711,89,42,26,3,18,71
63712,146,37,76,1,32,114
63713,24,10,8,0,6,18
63714,37,15,14,0,8,29
63715,81,51,7,4,19,62
63716,49,31,6,3,9,40
63717,43,36,2,0,5,38
63718,19,8,4,2,5,14
63719,346,187,89,15,55,291
63720,96,27,50,0,19,77
63721,58,29,8,8,13,45
63722,59,44,4,0,11,48
63723,102,29,39,14,20,82
63724,40,6,24,0,10,30
63725,112,52,21,15,24,88
63726,62,31,17,0,14,48
63727,106,48,35,5,18,88
63728,68,27,16,13,12,56
63729,146,72,46,0,28,118
63730,20,6,7,0,7,13
63731,92,30,32,6,24,68
63732,219,149,30,0,40,179
63733,138,80,22,3,33,105
63734,331,252,19,0,60,271
63735,293,37,200,2,54,239
63736,32,21,9,0,2,30
63737,60,31,11,2,16,44
63738,56,36,12,3,5,51
63739,12,5,3,1,3,9
63740,66,50,2,0,14,52
63741,24,18,3,0,3,21
63742,65,51,2,0,12,53
63743,81,41,26,0,14,67
63744,23,2,17,0,4,19
63745,384,197,89,13,85,299
63746,296,145,87,2,62,234
63747,59,28,15,0,16,43
63748,8,2,4,0,2,6
63749,21,9,7,0,5,16
63750,20,9,3,1,7,13
63751,45,16,15,0,14,31
63752,234,156,33,0,45,189
63753,81,52,7,1,21,60
63754,118,63,22,11,22,96
63755,69,36,16,1,16,53
63756,109,77,12,2,18,91
63757,27,9,11,0,7,20
63758,103,42,23,19,19,84
63759,378,278,19,2,79,299
63760,35,9,15,4,7,28
63761,44,21,6,7,10,34
63762,19,6,10,0,3,16
63763,6,4,0,2,0,6
63764,70,35,24,1,10,60
63765,40,5,25,0,10,30
63766,61,23,25,1,12,49
63767,63,16,29,9,9,54
63768,39,21,13,0,5,34
63769,343,144,127,6,66,277
63770,371,175,87,34,75,296
63771,56,13,39,0,4,52
63772,25,6,11,5,3,22
63773,114,38,36,12,28,86
63774,66,25,18,8,15,51
63775,10,5,2,0,3,7
63776,101,27,48,4,22,79
63777,11,3,6,0,2,9
63778,5,2,2,0,1,4
63779,11,3,6,0,2,9
63780,28,8,11,1,8,20
63781,46,18,20,0,8,38
63782,35,9,15,3,8,27
63783,27,10,8,3,6,21
63784,43,14,15,4,10,33
63785,44,14,24,0,6,38
63786,16,5,10,0,1,15
63787,356,196,89,15,56,300
63788,629,365,147,16,101,528
63789,20,0,12,0,8,12
63790,74,39,12,7,16,58
63791,77,5,56,1,15,62
63792,66,37,18,0,11,55
63793,356,257,19,0,80,276
63794,9,1,6,1,1,8
63795,13,1,10,0,2,11
63796,115,42,29,25,19,96
63797,39,18,14,1,6,33
63798,21,8,7,0,6,15
63799,14,1,10,1,2,12
63800,32,21,9,0,2,30
63801,20,4,9,0,7,13
63802,91,39,39,3,10,81
63803,13,5,4,0,4,9
63804,19,7,8,0,4,15
63805,17,5,7,1,4,13
63806,431,296,43,1,91,340
63807,91,34,21,8,28,63
63808,2,1,1,0,0,2
63809,25,3,18,1,3,22
63810,30,9,14,0,7,23
63811,544,336,79,7,122,422
63812,13,3,8,1,1,12
63813,11,0,10,0,1,10
63814,97,36,37,10,14,83
63815,43,11,20,0,12,31
63816,441,148,154,48,91,350
63817,16,4,9,0,3,13
63818,141,102,18,0,21,120
63819,78,41,30,1,6,72
63820,144,39,61,8,36,108
63821,192,49,64,35,44,148
63822,94,43,32,4,15,79
63823,60,31,11,2,16,44
63824,17,9,4,2,2,15
63825,24,14,3,0,7,17
63826,13,1,9,0,3,10
63827,349,98,168,6,77,272
63828,10,3,3,0,4,6
63829,21,2,15,0,4,17
63830,34,13,9,7,5,29
63831,46,18,20,0,8,38
63832,117,24,40,26,27,90
63833,55,22,20,1,12,43
63834,34,26,4,0,4,30
63835,161,68,34,21,38,123
63836,21,14,1,3,3,18
63837,31,11,12,0,8,23
63838,589,413,52,1,123,466
63839,93,48,13,2,30,63
63840,37,11,16,0,10,27
63841,14,1,11,1,1,13
63842,165,105,24,0,36,129
63843,58,34,12,0,12,46
63844,13,4,5,0,4,9
63845,326,163,91,4,68,258
63846,97,42,34,3,18,79
63847,14,3,6,0,5,9
63848,26,2,19,1,4,22
63849,59,42,4,1,12,47
63850,115,54,23,15,23,92
63851,15,2,10,0,3,12
63852,205,152,17,2,34,171
63853,11,4,4,0,3,8
63854,56,27,14,3,12,44
63855,28,12,7,0,9,19
63856,24,12,9,0,3,21
63857,49,26,12,1,10,39
63858,34,17,11,2,4,30
63859,139,80,23,3,33,106
63860,128,70,31,0,27,101
63861,38,3,30,1,4,34
63862,110,86,3,0,21,89
63863,144,48,37,29,30,114
63864,74,42,18,0,14,60
63865,134,93,24,0,17,117
63866,40,10,24,0,6,34
63867,286,79,39,122,46,240
63868,38,5,26,0,7,31
63869,24,11,11,0,2,22
63870,139,65,46,5,23,116
63871,32,19,7,0,6,26
63872,89,10,52,6,21,68
63873,38,22,3,0,13,25
63874,39,9,18,5,7,32
63875,46,18,20,0,8,38
63876,17,12,3,0,2,15
63877,46,18,20,0,8,38
63878,76,45,14,1,16,60
63879,439,140,184,24,91,348
63880,32,21,9,0,2,30
63881,479,239,91,48,101,378
63882,65,37,11,4,13,52
63883,10,1,8,0,1,9
63884,11,1,5,0,5,6
63885,33,8,18,4,3,30
63886,58,20,27,0,11,47
63887,33,15,13,0,5,28
63888,295,50,190,2,53,242
63889,3,0,3,0,0,3
63890,104,33,39,5,27,77
63891,63,36,14,0,13,50
63892,5,2,1,0,2,3
63893,16,11,4,0,1,15
63894,14,11,2,0,1,13
63895,12,1,5,0,6,6
63896,38,28,1,0,9,29
63897,30,10,11,0,9,21
63898,17,11,3,0,3,14
63899,23,8,11,0,4,19
63900,47,15,18,2,12,35
63901,347,267,20,0,60,287
63902,475,233,93,56,93,382
63903,33,16,7,1,9,24
63904,137,80,21,2,34,103
63905,355,189,90,15,61,294
63906,59,32,15,1,11,48
63907,15,2,5,0,8,7
63908,94,34,19,11,30,64
63909,19,7,6,0,6,13
63910,233,79,90,15,49,184
63911,22,16,2,0,4,18
63912,81,36,31,0,14,67
63913,46,14,24,1,7,39
63914,46,18,20,0,8,38
63915,180,93,51,0,36,144
63916,305,133,104,4,64,241
63917,29,2,22,1,4,25
63918,32,7,14,3,8,24
63919,78,44,15,2,17,61
63920,203,127,38,3,35,168
63921,158,107,24,0,27,131
63922,181,48,97,4,32,149
63923,34,8,18,0,8,26
63924,77,22,22,14,19,58
63925,96,32,5,46,13,83
63926,40,16,12,3,9,31
63927,112,50,30,13,19,93
63928,4,0,4,0,0,4
63929,465,253,102,13,97,368
63930,53,38,5,1,9,44
63931,46,25,11,0,10,36
63932,90,54,17,6,13,77
63933,180,93,49,0,38,142
63934,45,21,13,6,5,40
63935,42,14,17,3,8,34
63936,89,62,10,1,16,73
63937,94,59,12,2,21,73
63938,32,3,19,1,9,23
63939,358,197,103,0,58,300
63940,153,66,48,5,34,119
63941,119,48,46,0,25,94
63942,55,15,21,10,9,46
63943,46,33,2,0,11,35
63944,40,32,2,0,6,34
63945,3,1,0,0,2,1
63946,121,76,30,0,15,106
63947,61,29,13,6,13,48
63948,8,2,4,0,2,6
63949,190,11,144,0,35,155
63950,212,85,37,41,49,163
63951,63,42,4,0,17,46
63952,21,7,12,0,2,19
63953,80,24,33,18,5,75
63954,176,82,40,18,36,140
63955,81,38,27,6,10,71
63956,93,22,45,3,23,70
63957,62,15,31,0,16,46
63958,29,9,15,0,5,24
63959,148,36,81,1,30,118
63960,48,26,16,0,6,42
63961,69,26,16,14,13,56
63962,68,25,26,4,13,55
63963,65,54,0,1,10,55
63964,176,50,54,37,35,141
63965,131,103,2,0,26,105
63966,42,0,34,0,8,34
63967,51,28,11,0,12,39
63968,67,18,29,0,20,47
63969,2,0,1,0,1,1
63970,39,30,1,0,8,31
63971,181,85,51,9,36,145
63972,30,10,7,6,7,23
63973,109,52,25,5,27,82
63974,46,24,12,0,10,36
63975,34,14,16,0,4,30
63976,15,5,5,0,5,10
63977,108,49,31,2,26,82
63978,21,14,5,0,2,19
63979,46,18,20,0,8,38
63980,132,68,21,18,25,107
63981,90,70,1,0,19,71
63982,35,16,10,0,9,26
63983,132,63,37,5,27,105
63984,32,2,25,2,3,29
63985,48,21,16,2,9,39
63986,274,51,168,4,51,223
63987,90,33,38,4,15,75
63988,264,99,110,6,49,215
63989,37,17,15,0,5,32
63990,37,12,10,2,13,24
63991,204,74,58,28,44,160
63992,176,47,57,38,34,142
63993,32,21,9,0,2,30
63994,80,48,12,3,17,63
63995,146,61,49,8,28,118
63996,87,27,44,2,14,73
63997,48,23,4,11,10,38
63998,142,79,31,8,24,118
63999,48,24,10,0,14,34
64000,100,31,41,10,18,82
64001,67,27,27,3,10,57
64002,17,3,9,1,4,13
64003,73,24,22,11,16,57
64004,89,32,32,4,21,68
64005,90,39,29,3,19,71
64006,33,20,6,1,6,27
64007,4,3,1,0,0,4
64008,152,52,75,0,25,127
64009,255,189,15,0,51,204
64010,15,6,3,2,4,11
64011,122,45,34,14,29,93
64012,32,1,25,1,5,27
64013,23,7,12,0,4,19
64014,62,43,5,1,13,49
64015,107,23,43,21,20,87
64016,44,20,13,0,11,33
64017,89,29,19,22,19,70
64018,52,31,11,0,10,42
64019,36,17,13,0,6,30
64020,145,72,20,22,31,114
64021,89,69,1,0,19,70
64022,548,392,43,1,112,436
64023,9,2,3,0,4,5
64024,12,7,2,1,2,10
64025,11,3,6,0,2,9
64026,436,200,100,49,87,349
64027,66,19,22,9,16,50
64028,35,24,5,2,4,31
64029,82,44,16,10,12,70
64030,51,28,4,3,16,35
64031,33,27,1,0,5,28
64032,17,5,9,0,3,14
64033,46,18,20,0,8,38
64034,1057,390,421,46,200,857
64035,76,19,37,7,13,63
64036,46,18,20,0,8,38
64037,20,8,8,0,4,16
64038,68,39,16,0,13,55
64039,23,6,12,0,5,18
64040,141,86,28,0,27,114
64041,541,376,49,1,115,426
64042,36,20,10,0,6,30
64043,138,57,40,15,26,112
64044,285,196,19,4,66,219
64045,194,61,81,14,38,156
64046,179,132,13,1,33,146
64047,42,24,7,0,11,31
64048,33,9,17,0,7,26
64049,21,9,8,0,4,17
64050,203,134,32,1,36,167
64051,298,81,34,136,47,251
64052,60,15,28,9,8,52
64053,58,27,23,2,6,52
64054,40,23,15,0,2,38
64055,69,16,37,1,15,54
64056,33,26,1,0,6,27
64057,64,34,14,0,16,48
64058,84,54,15,4,11,73
64059,63,42,4,0,17,46
64060,44,26,14,0,4,40
64061,71,46,9,5,11,60
64062,77,36,5,15,21,56
64063,42,14,19,0,9,33
64064,293,83,145,5,60,233
64065,34,9,20,0,5,29
64066,45,20,13,4,8,37
64067,12,11,1,0,0,12
64068,115,67,19,5,24,91
64069,85,27,31,12,15,70
64070,252,195,10,0,47,205
64071,236,156,35,0,45,191
64072,48,25,9,1,13,35
64073,106,45,38,3,20,86
64074,42,13,23,1,5,37
64075,139,54,46,9,30,109
64076,464,230,89,44,101,363
64077,47,18,13,1,15,32
64078,223,170,9,0,44,179
64079,43,19,13,1,10,33
64080,14,4,8,0,2,12
64081,15,8,4,0,3,12
64082,100,46,27,3,24,76
64083,344,187,88,15,54,290
64084,33,9,17,0,7,26
64085,43,23,13,0,7,36
64086,39,23,12,0,4,35
64087,34,18,12,0,4,30
64088,82,49,15,0,18,64
64089,72,28,19,9,16,56
64090,95,69,9,0,17,78
64091,68,32,11,9,16,52
64092,7,4,2,0,1,6
64093,88,47,12,2,27,61
64094,346,147,126,6,67,279
64095,363,168,117,14,64,299
64096,37,19,9,1,8,29
64097,38,15,4,10,9,29
64098,46,18,20,0,8,38
64099,46,18,20,0,8,38
64100,92,41,27,1,23,69
64101,24,13,8,2,1,23
64102,65,43,7,1,14,51
64103,83,38,25,3,17,66
64104,83,40,30,4,9,74
64105,70,23,31,2,14,56
64106,56,38,12,0,6,50
64107,52,4,9,23,16,36
64108,34,23,3,0,8,26
64109,12,0,12,0,0,12
64110,15,5,5,0,5,10
64111,76,38,20,0,18,58
64112,17,6,5,1,5,12
64113,76,39,17,2,18,58
64114,70,36,15,2,17,53
64115,23,8,4,3,8,15
64116,43,11,14,9,9,34
64117,105,38,25,20,22,83
64118,34,19,9,1,5,29
64119,46,11,16,7,12,34
64120,73,53,7,3,10,63
64121,35,9,16,2,8,27
64122,54,29,14,0,11,43
64123,34,16,14,0,4,30
64124,67,39,3,13,12,55
64125,9,5,2,0,2,7
64126,53,29,16,0,8,45
64127,8,0,5,1,2,6
64128,123,83,14,3,23,100
64129,16,9,4,0,3,13
64130,102,68,1,12,21,81
64131,34,22,7,1,4,30
64132,372,217,68,7,80,292
64133,221,95,14,76,36,185
64134,388,177,128,5,78,310
64135,32,21,9,0,2,30
64136,7,4,2,0,1,6
64137,34,19,5,2,8,26
64138,189,150,9,2,28,161
64139,48,16,21,3,8,40
64140,37,6,23,0,8,29
64141,7,4,1,0,2,5
64142,14,2,9,0,3,11
64143,24,17,2,0,5,19
64144,131,40,61,7,23,108
64145,114,24,57,0,33,81
64146,28,12,6,6,4,24
64147,82,50,15,0,17,65
64148,17,3,11,0,3,14
64149,49,24,15,0,10,39
64150,40,18,13,1,8,32
64151,80,40,21,0,19,61
64152,32,21,9,0,2,30
64153,19,2,11,0,6,13
64154,12,8,1,3,0,12
64155,73,34,20,0,19,54
64156,171,89,45,4,33,138
64157,365,208,80,0,77,288
64158,70,23,19,22,6,64
64159,223,86,14,82,41,182
64160,56,37,7,0,12,44
64161,201,83,34,38,46,155
64162,257,111,87,16,43,214
64163,42,8,16,11,7,35
64164,46,18,20,0,8,38
64165,1083,396,438,46,203,880
64166,393,119,159,30,85,308
64167,40,13,17,2,8,32
64168,61,33,13,1,14,47
64169,139,23,60,24,32,107
64170,87,66,5,4,12,75
64171,58,4,7,30,17,41
64172,14,9,2,0,3,11
64173,6,4,1,0,1,5
64174,32,4,21,0,7,25
64175,170,84,53,3,30,140
64176,35,9,17,2,7,28
64177,57,35,7,7,8,49
64178,157,102,3,17,35,122
64179,19,7,6,0,6,13
64180,69,22,25,8,14,55
64181,54,17,30,0,7,47
64182,29,15,10,0,4,25
64183,53,32,12,0,9,44
64184,108,34,38,10,26,82
64185,354,160,111,11,72,282
64186,47,17,19,2,9,38
64187,66,25,29,1,11,55
64188,219,74,82,15,48,171
64189,106,55,28,5,18,88
64190,86,34,35,0,17,69
64191,117,38,21,26,32,85
64192,35,26,0,2,7,28
64193,32,21,9,0,2,30
64194,35,14,6,7,8,27
64195,66,45,13,0,8,58
64196,32,2,23,0,7,25
64197,110,38,37,5,30,80
64198,33,9,17,0,7,26
64199,10,3,5,0,2,8
64200,52,38,5,1,8,44
64201,28,7,16,2,3,25
64202,44,15,6,17,6,38
64203,61,17,33,3,8,53
64204,653,362,162,24,105,548
64205,21,10,4,2,5,16
64206,660,383,151,18,108,552
64207,111,48,29,14,20,91
64208,67,26,26,0,15,52
64209,144,71,37,0,36,108
64210,383,169,133,11,70,313
64211,86,34,29,2,21,65
64212,241,175,10,0,56,185
64213,155,110,22,0,23,132
64214,18,1,14,0,3,15
64215,59,12,29,4,14,45
64216,28,10,14,0,4,24
64217,25,10,4,8,3,22
64218,206,84,87,4,31,175
64219,18,5,0,7,6,12
64220,91,27,49,0,15,76
64221,136,25,78,0,33,103
64222,60,23,23,3,11,49
64223,66,23,32,1,10,56
64224,162,69,54,3,36,126
64225,73,27,10,17,19,54
64226,122,75,24,0,23,99
64227,91,50,11,10,20,71
64228,326,147,107,6,66,260
64229,76,21,35,7,13,63
64230,16,3,8,3,2,14
64231,56,3,41,1,11,45
64232,50,35,2,1,12,38
64233,55,33,15,2,5,50
64234,177,126,15,2,34,143
64235,6,3,1,0,2,4
64236,49,10,25,2,12,37
64237,65,32,20,0,13,52
64238,58,2,41,0,15,43
64239,37,10,19,0,8,29
64240,26,13,6,0,7,19
64241,26,8,13,0,5,21
64242,15,4,6,0,5,10
64243,49,1,39,0,9,40
64244,134,28,49,30,27,107
64245,32,21,9,0,2,30
64246,31,22,5,0,4,27
64247,95,63,9,4,19,76
64248,15,11,0,0,4,11
64249,22,7,10,1,4,18
64250,142,66,44,11,21,121
64251,47,35,2,0,10,37
64252,15,10,4,1,0,15
64253,174,86,54,0,34,140
64254,112,49,42,1,20,92
64255,57,24,19,5,9,48
64256,55,35,7,1,12,43
64257,60,38,11,0,11,49
64258,434,105,187,46,96,338
64259,26,8,6,7,5,21
64260,59,31,7,5,16,43
64261,22,13,2,4,3,19
64262,120,58,38,4,20,100
64263,58,15,34,1,8,50
64264,184,82,58,10,34,150
64265,128,39,34,23,32,96
64266,9,7,0,0,2,7
64267,220,120,52,13,35,185
64268,127,82,16,4,25,102
64269,51,26,10,7,8,43
64270,133,42,51,17,23,110
64271,47,33,2,1,11,36
64272,46,18,20,0,8,38
64273,27,9,14,0,4,23
64274,60,46,2,0,12,48
64275,12,4,4,1,3,9
64276,95,59,12,2,22,73
64277,18,13,2,0,3,15
64278,53,28,17,1,7,46
64279,21,11,4,0,6,15
64280,12,5,4,1,2,10
64281,44,33,5,0,6,38
64282,210,76,76,10,48,162
64283,43,10,24,0,9,34
64284,71,21,26,8,16,55
64285,22,14,2,0,6,16
64286,143,30,48,34,31,112
64287,86,32,33,12,9,77
64288,104,10,63,10,21,83
64289,14,2,9,0,3,11
64290,68,24,31,1,12,56
64291,131,67,30,9,25,106
64292,30,23,0,0,7,23
64293,10,8,0,0,2,8
64294,66,34,15,1,16,50
64295,26,12,7,0,7,19
64296,124,54,43,6,21,103
64297,92,30,21,23,18,74
64298,218,148,30,0,40,178
64299,62,34,11,4,13,49
64300,17,6,8,1,2,15
64301,201,84,33,38,46,155
64302,17,3,11,0,3,14
64303,33,3,6,17,7,26
64304,54,25,15,4,10,44
64305,45,31,1,2,11,34
64306,15,7,1,3,4,11
64307,267,18,199,2,48,219
64308,35,16,10,0,9,26
64309,35,17,13,0,5,30
64310,31,13,10,0,8,23
64311,44,19,14,0,11,33
64312,31,17,8,0,6,25
64313,102,65,10,5,22,80
64314,30,13,10,1,6,24
64315,126,75,21,3,27,99
64316,95,48,15,2,30,65
64317,90,38,21,8,23,67
64318,203,103,50,0,50,153
64319,67,25,16,9,17,50
64320,32,21,9,0,2,30
64321,162,49,88,4,21,141
64322,33,4,20,2,7,26
64323,82,46,18,0,18,64
64324,160,72,63,7,18,142
64325,91,40,16,17,18,73
64326,125,72,21,6,26,99
64327,27,0,23,0,4,23
64328,147,98,28,0,21,126
64329,25,9,12,0,4,21
64330,8,1,7,0,0,8
64331,20,5,11,1,3,17
64332,27,10,12,2,3,24
64333,57,2,30,19,6,51
64334,42,6,25,0,11,31
64335,140,47,45,22,26,114
64336,27,1,18,0,8,19
64337,36,15,5,8,8,28
64338,202,133,23,0,46,156
64339,72,18,26,12,16,56
64340,130,97,6,0,27,103
64341,14,0,13,0,1,13
64342,82,28,7,31,16,66
64343,73,30,25,3,15,58
64344,44,0,30,3,11,33
64345,67,45,13,0,9,58
64346,78,32,8,18,20,58
64347,61,21,24,4,12,49
64348,109,37,43,11,18,91
64349,38,10,16,6,6,32
64350,67,32,20,1,14,53
64351,120,25,42,22,31,89
64352,111,49,30,13,19,92
64353,221,82,93,4,42,179
64354,21,1,4,13,3,18
64355,46,18,20,0,8,38
64356,33,9,18,2,4,29
64357,62,33,5,11,13,49
64358,588,425,44,1,118,470
64359,95,42,33,4,16,79
64360,63,52,1,0,10,53
64361,23,6,14,0,3,20
64362,78,5,55,1,17,61
64363,56,28,9,5,14,42
64364,68,6,48,1,13,55
64365,62,14,43,0,5,57
64366,2,1,1,0,0,2
64367,510,266,94,47,103,407
64368,35,16,11,0,8,27
64369,21,10,7,0,4,17
64370,17,8,4,0,5,12
64371,41,25,8,0,8,33
64372,68,45,10,0,13,55
64373,75,35,25,0,15,60
64374,389,171,133,10,75,314
64375,281,94,133,5,49,232
64376,5,2,1,0,2,3
64377,32,13,11,0,8,24
64378,141,44,49,22,26,115
64379,73,30,31,3,9,64
64380,16,8,3,4,1,15
64381,212,152,11,7,42,170
64382,33,22,5,1,5,28
64383,76,49,8,3,16,60
64384,47,20,23,1,3,44
64385,47,23,16,2,6,41
64386,9,3,2,0,4,5
64387,95,26,47,1,21,74
64388,454,337,21,0,96,358
64389,12,1,5,0,6,6
64390,152,54,38,30,30,122
64391,86,46,18,2,20,66
64392,24,9,8,0,7,17
64393,21,7,10,3,1,20
64394,19,6,1,8,4,15
64395,77,5,25,37,10,67
64396,190,87,52,13,38,152
64397,656,377,145,18,116,540
64398,40,25,9,0,6,34
64399,44,31,7,0,6,38
64400,428,141,148,48,91,337
64401,31,10,11,0,10,21
64402,92,62,8,3,19,73
64403,86,20,48,0,18,68
64404,447,323,32,0,92,355
64405,45,16,18,0,11,34
64406,36,11,21,0,4,32
64407,67,38,18,1,10,57
64408,5,4,1,0,0,5
64409,49,30,6,2,11,38
64410,32,21,9,0,2,30
64411,9,7,1,0,1,8
64412,52,9,28,1,14,38
64413,55,25,13,6,11,44
64414,14,2,5,1,6,8
64415,37,23,8,0,6,31
64416,182,13,135,0,34,148
64417,66,28,11,8,19,47
64418,27,15,7,0,5,22
64419,66,15,25,3,23,43
64420,8,4,1,0,3,5
64421,4,1,2,0,1,3
64422,92,26,53,1,12,80
64423,186,105,21,19,41,145
64424,16,2,7,2,5,11
64425,414,126,175,29,84,330
64426,36,10,17,0,9,27
64427,89,29,39,5,16,73
64428,4,2,1,1,0,4
64429,64,28,20,2,14,50
64430,62,28,19,4,11,51
64431,103,44,29,6,24,79
64432,46,19,5,9,13,33
64433,224,97,14,76,37,187
64434,39,15,14,6,4,35
64435,19,8,6,2,3,16
64436,203,85,33,38,47,156
64437,30,9,7,5,9,21
64438,37,22,4,1,10,27
64439,63,28,23,0,12,51
64440,89,35,23,14,17,72
64441,67,52,6,0,9,58
64442,16,0,12,0,4,12
64443,189,123,52,1,13,176
64444,119,41,34,13,31,88
64445,142,61,42,14,25,117
64446,67,39,3,13,12,55
64447,24,7,10,2,5,19
64448,27,6,11,2,8,19
64449,90,40,19,8,23,67
64450,62,34,15,0,13,49
64451,253,139,32,32,50,203
64452,109,48,30,12,19,90
64453,35,12,9,6,8,27
64454,342,147,120,6,69,273
64455,30,20,3,0,7,23
64456,29,13,12,0,4,25
64457,73,37,23,1,12,61
64458,155,76,54,0,25,130
64459,31,6,10,7,8,23
64460,500,275,80,43,102,398
64461,46,30,2,9,5,41
64462,29,19,2,0,8,21
64463,360,156,126,11,67,293
64464,89,40,34,1,14,75
64465,62,27,22,0,13,49
64466,490,354,32,0,104,386
64467,14,2,8,3,1,13
64468,23,3,16,0,4,19
64469,39,4,26,0,9,30
64470,27,10,12,0,5,22
64471,135,81,30,3,21,114
64472,161,109,27,0,25,136
64473,20,9,3,3,5,15
64474,71,35,12,7,17,54
64475,53,28,10,7,8,45
64476,132,97,5,2,28,104
64477,55,12,13,22,8,47
64478,20,0,16,2,2,18
64479,119,97,3,3,16,103
64480,107,50,34,5,18,89
64481,24,5,13,2,4,20
64482,81,55,7,0,19,62
64483,198,52,110,4,32,166
64484,23,14,2,0,7,16
64485,157,9,91,27,30,127
64486,40,5,15,11,9,31
64487,94,25,41,18,10,84
64488,37,6,24,0,7,30
64489,202,59,109,5,29,173
64490,30,13,10,0,7,23
64491,3,1,1,0,1,2
64492,46,18,20,0,8,38
64493,42,6,26,0,10,32
64494,23,13,8,0,2,21
64495,91,32,31,9,19,72
64496,163,82,48,1,32,131
64497,23,9,10,1,3,20
64498,266,134,63,16,53,213
64499,500,354,43,1,102,398
64500,32,27,3,0,2,30
64501,50,18,21,0,11,39
64502,17,7,7,0,3,14
64503,17,7,6,0,4,13
64504,23,21,0,0,2,21
64505,13,7,3,1,2,11
64506,47,9,24,1,13,34
64507,48,34,9,0,5,43
64508,61,46,4,0,11,50
64509,14,3,7,1,3,11
64510,27,15,10,2,0,27
64511,60,20,27,1,12,48
64512,95,48,15,2,30,65
64513,21,10,9,0,2,19
64514,22,1,14,1,6,16
64515,146,66,44,0,36,110
64516,195,63,60,28,44,151
64517,120,59,16,19,26,94
64518,5,5,0,0,0,5
64519,277,104,102,25,46,231
64520,77,50,8,5,14,63
64521,24,4,18,0,2,22
64522,127,42,34,28,23,104
64523,230,21,165,2,42,188
64524,49,29,2,3,15,34
64525,7,1,3,0,3,4
64526,37,21,9,0,7,30
64527,22,6,11,1,4,18
64528,39,25,4,0,10,29
64529,76,40,16,2,18,58
64530,37,9,19,0,9,28
64531,66,30,18,3,15,51
64532,30,23,0,0,7,23
64533,67,21,27,3,16,51
64534,103,56,10,14,23,80
64535,98,44,15,13,26,72
64536,68,27,4,25,12,56
64537,34,7,21,0,6,28
64538,59,21,33,0,5,54
64539,97,51,29,1,16,81
64540,18,14,0,0,4,14
64541,25,12,7,5,1,24
64542,53,23,14,6,10,43
64543,345,149,122,6,68,277
64544,38,11,14,3,10,28
64545,53,33,11,3,6,47
64546,37,15,14,0,8,29
64547,93,42,37,0,14,79
64548,41,15,14,5,7,34
64549,182,129,14,1,38,144
64550,30,13,6,0,11,19
64551,76,4,55,0,17,59
64552,67,4,52,2,9,58
64553,324,159,89,12,64,260
64554,33,15,7,0,11,22
64555,47,12,23,0,12,35
64556,62,33,18,0,11,51
64557,110,64,18,4,24,86
64558,67,43,11,5,8,59
64559,95,35,34,9,17,78
64560,19,10,5,0,4,15
64561,155,97,33,1,24,131
64562,45,20,7,10,8,37
64563,51,24,16,1,10,41
64564,167,102,43,13,9,158
64565,325,193,64,0,68,257
64566,36,17,10,0,9,27
64567,4,2,1,0,1,3
64568,45,21,13,6,5,40
64569,401,202,108,9,82,319
64570,53,18,20,3,12,41
64571,24,8,10,4,2,22
64572,42,29,1,2,10,32
64573,26,10,10,0,6,20
64574,10,4,3,0,3,7
64575,106,58,29,1,18,88
64576,104,47,20,15,22,82
64577,32,21,9,0,2,30
64578,227,52,72,52,51,176
64579,53,37,6,1,9,44
64580,90,42,26,3,19,71
64581,75,51,7,0,17,58
64582,394,183,135,7,69,325
64583,317,161,89,15,52,265
64584,26,9,13,1,3,23
64585,21,9,8,0,4,17
64586,53,26,3,15,9,44
64587,94,29,49,0,16,78
64588,60,31,11,2,16,44
64589,43,14,24,0,5,38
64590,102,69,1,12,20,82
64591,31,1,23,0,7,24
64592,491,294,102,9,86,405
64593,152,74,30,13,35,117
64594,120,70,29,0,21,99
64595,50,11,31,0,8,42
64596,149,110,8,5,26,123
64597,79,27,26,6,20,59
64598,28,12,9,3,4,24
64599,91,54,17,0,20,71
64600,46,18,20,0,8,38
64601,116,54,47,3,12,104
64602,150,79,47,0,24,126
64603,150,24,98,1,27,123
64604,131,21,85,1,24,107
64605,72,36,9,17,10,62
64606,45,16,14,4,11,34
64607,33,16,9,0,8,25
64608,38,18,16,0,4,34
64609,60,4,43,4,9,51
64610,89,58,10,7,14,75
64611,61,31,18,0,12,49
64612,34,17,10,0,7,27
64613,144,72,36,0,36,108
64614,49,19,25,0,5,44
64615,52,29,9,4,10,42
64616,94,21,40,12,21,73
64617,71,40,3,15,13,58
64618,134,52,43,2,37,97
64619,40,21,10,0,9,31
64620,126,40,53,7,26,100
64621,33,25,0,2,6,27
64622,59,15,35,1,8,51
64623,71,43,14,2,12,59
64624,43,6,29,0,8,35
64625,52,20,15,6,11,41
64626,46,20,18,0,8,38
64627,177,89,41,8,39,138
64628,71,43,15,0,13,58
64629,62,19,24,6,13,49
64630,31,9,15,0,7,24
64631,46,18,20,0,8,38
64632,94,38,24,12,20,74
64633,161,12,93,24,32,129
64634,54,34,7,3,10,44
64635,164,70,35,21,38,126
64636,62,34,19,0,9,53
64637,2,0,1,0,1,1
64638,31,15,9,0,7,24
64639,42,23,10,4,5,37
64640,52,7,32,8,5,47
64641,93,74,3,0,16,77
64642,76,10,43,5,18,58
64643,67,33,15,0,19,48
64644,6,2,1,0,3,3
64645,77,39,20,0,18,59
64646,122,35,63,0,24,98
64647,44,10,17,6,11,33
64648,158,121,2,1,34,124
64649,68,3,57,0,8,60
64650,224,75,85,15,49,175
64651,193,74,45,31,43,150
64652,50,16,15,10,9,41
64653,53,0,34,3,16,37
64654,469,220,145,12,92,377
64655,46,18,20,0,8,38
64656,75,33,23,7,12,63
64657,98,60,12,2,24,74
64658,29,13,8,1,7,22
64659,14,3,7,2,2,12
64660,57,20,26,0,11,46
64661,10,7,1,0,2,8
64662,58,30,5,11,12,46
64663,53,19,17,7,10,43
64664,66,39,3,13,11,55
64665,156,91,28,1,36,120
64666,41,20,4,9,8,33
64667,42,14,17,3,8,34
64668,32,16,7,0,9,23
64669,78,13,50,0,15,63
64670,17,6,5,0,6,11
64671,121,36,53,7,25,96
64672,32,21,9,0,2,30
64673,50,19,22,0,9,41
64674,11,2,6,0,3,8
64675,39,2,19,13,5,34
64676,90,24,45,8,13,77
64677,17,4,8,0,5,12
64678,14,5,7,2,0,14
64679,25,18,0,0,7,18
64680,32,17,8,1,6,26
64681,114,2,94,0,18,96
64682,66,23,32,1,10,56
64683,143,87,30,0,26,117
64684,189,108,24,23,34,155
64685,46,18,20,0,8,38
64686,246,103,15,82,46,200
64687,33,15,10,0,8,25
64688,64,38,13,0,13,51
64689,420,218,97,24,81,339
64690,47,10,27,1,9,38
64691,10,5,4,0,1,9
64692,66,14,31,9,12,54
64693,414,124,176,29,85,329
64694,31,8,13,2,8,23
64695,18,4,8,0,6,12
64696,555,307,119,13,116,439
64697,78,29,37,0,12,66
64698,32,21,9,0,2,30
64699,77,55,2,2,18,59
64700,54,20,10,17,7,47
64701,2,2,0,0,0,2
64702,23,9,9,0,5,18
64703,45,12,19,0,14,31
64704,32,21,9,0,2,30
64705,39,13,19,1,6,33
64706,128,41,49,15,23,105
64707,63,42,13,0,8,55
64708,37,21,9,0,7,30
64709,2,0,2,0,0,2
64710,436,128,183,33,92,344
64711,51,6,33,0,12,39
64712,5,2,2,1,0,5
64713,640,357,157,24,102,538
64714,622,418,68,2,134,488
64715,117,95,3,3,16,101
64716,73,34,16,14,9,64
64717,46,18,20,0,8,38
64718,176,38,100,9,29,147
64719,36,20,8,2,6,30
64720,111,79,17,0,15,96
64721,233,156,32,0,45,188
64722,30,23,0,0,7,23
64723,5,0,2,1,2,3
64724,52,37,5,0,10,42
64725,121,49,44,4,24,97
64726,22,17,4,1,0,22
64727,39,7,22,2,8,31
64728,113,47,15,18,33,80
64729,34,9,21,0,4,30
64730,6,3,2,0,1,5
64731,64,42,5,0,17,47
64732,221,91,41,38,51,170
64733,56,25,14,6,11,45
64734,38,20,10,0,8,30
64735,64,42,12,1,9,55
64736,28,16,8,0,4,24
64737,79,40,16,5,18,61
64738,6,0,4,0,2,4
64739,220,150,30,0,40,180
64740,6,3,1,0,2,4
64741,91,30,39,7,15,76
64742,438,206,141,11,80,358
64743,495,271,106,15,103,392
64744,341,144,121,6,70,271
64745,91,31,26,14,20,71
64746,29,2,22,1,4,25
64747,44,6,30,0,8,36
64748,653,380,132,19,122,531
64749,85,53,17,4,11,74
64750,58,52,2,0,4,54
64751,127,75,22,3,27,100
64752,115,47,35,7,26,89
64753,55,12,32,0,11,44
64754,176,81,55,1,39,137
64755,32,21,9,0,2,30
64756,218,148,30,0,40,178
64757,9,2,5,1,1,8
64758,47,26,13,1,7,40
64759,5,1,1,1,2,3
64760,55,34,7,1,13,42
64761,15,8,4,0,3,12
64762,88,39,28,3,18,70
64763,281,176,43,0,62,219
64764,395,112,186,7,90,305
64765,145,70,28,21,26,119
64766,6,1,1,0,4,2
64767,437,127,166,47,97,340
64768,165,103,4,18,40,125
64769,152,27,64,21,40,112
64770,146,45,34,39,28,118
64771,32,21,9,0,2,30
64772,36,26,3,0,7,29
64773,65,4,51,2,8,57
64774,35,2,26,0,7,28
64775,31,15,13,0,3,28
64776,39,2,19,13,5,34
64777,72,37,17,0,18,54
64778,57,17,18,8,14,43
64779,138,83,20,2,33,105
64780,11,0,8,2,1,10
64781,137,37,69,1,30,107
64782,138,34,74,1,29,109
64783,26,10,10,1,5,21
64784,55,20,21,2,12,43
64785,32,21,9,0,2,30
64786,153,54,39,30,30,123
64787,71,32,21,0,18,53
64788,119,67,21,4,27,92
64789,146,55,54,15,22,124
64790,17,4,12,1,0,17
64791,10,0,6,0,4,6
64792,31,20,6,0,5,26
64793,5,3,2,0,0,5
64794,49,21,18,1,9,40
64795,27,14,8,0,5,22
64796,49,29,6,2,12,37
64797,322,143,118,5,56,266
64798,409,104,175,37,93,316
64799,28,19,5,0,4,24
64800,38,25,7,1,5,33
64801,109,48,30,12,19,90
64802,165,124,3,1,37,128
64803,30,5,15,1,9,21
64804,70,19,29,0,22,48
64805,23,10,10,0,3,20
64806,26,20,3,1,2,24
64807,32,21,0,6,5,27
64808,130,29,50,21,30,100
64809,43,32,0,0,11,32
64810,21,7,8,0,6,15
64811,558,331,122,14,91,467
64812,16,8,5,0,3,13
64813,82,43,25,3,11,71
64814,143,72,18,23,30,113
64815,70,27,28,4,11,59
64816,39,1,33,1,4,35
64817,138,46,50,19,23,115
64818,195,50,110,2,33,162
64819,77,36,5,15,21,56
64820,42,0,29,0,13,29
64821,90,47,23,4,16,74
64822,46,18,20,0,8,38
64823,35,24,3,0,8,27
64824,144,77,29,7,31,113
64825,51,27,14,0,10,41
64826,81,38,5,16,22,59
64827,689,389,165,23,112,577
64828,44,21,6,7,10,34
64829,7,3,3,0,1,6
64830,115,24,57,15,19,96
64831,27,11,10,1,5,22
64832,48,19,22,1,6,42
64833,267,58,144,5,60,207
64834,506,267,86,46,107,399
64835,30,6,16,0,8,22
64836,158,83,45,5,25,133
64837,15,7,6,0,2,13
64838,20,5,11,0,4,16
64839,27,4,17,0,6,21
64840,35,10,17,1,7,28
64841,183,49,19,88,27,156
64842,56,34,9,0,13,43
64843,46,18,20,0,8,38
64844,32,21,9,0,2,30
64845,36,13,15,1,7,29
64846,92,31,30,5,26,66
64847,40,12,23,0,5,35
64848,10,6,0,0,4,6
64849,349,85,173,5,86,263
64850,206,100,70,0,36,170
64851,119,32,65,0,22,97
64852,3,1,0,0,2,1
64853,48,31,5,2,10,38
64854,5,2,3,0,0,5
64855,139,47,33,28,31,108
64856,38,18,16,0,4,34
64857,63,52,1,0,10,53
64858,58,8,40,0,10,48
64859,127,77,26,0,24,103
64860,64,42,5,0,17,47
64861,29,6,14,1,8,21
64862,297,224,18,1,54,243
64863,18,13,1,0,4,14
64864,55,28,14,0,13,42
64865,172,103,11,23,35,137
64866,47,25,7,9,6,41
64867,242,182,7,3,50,192
64868,86,57,15,0,14,72
64869,2,1,0,0,1,1
64870,47,9,31,0,7,40
64871,69,42,17,0,10,59
64872,166,85,37,7,37,129
64873,30,5,15,1,9,21
64874,43,28,7,3,5,38
64875,127,66,15,15,31,96
64876,5,2,3,0,0,5
64877,108,43,15,17,33,75
64878,418,249,67,7,95,323
64879,26,15,0,6,5,21
64880,284,134,87,12,51,233
64881,31,24,0,0,7,24
64882,23,17,2,0,4,19
64883,135,37,44,20,34,101
64884,61,22,29,2,8,53
64885,307,122,121,9,55,252
64886,16,4,6,1,5,11
64887,236,50,138,2,46,190
64888,198,133,21,0,44,154
64889,11,3,8,0,0,11
64890,27,14,8,0,5,22
64891,60,43,7,1,9,51
64892,19,1,16,0,2,17
64893,244,102,15,83,44,200
64894,40,0,27,0,13,27
64895,111,36,54,4,17,94
64896,113,50,34,2,27,86
64897,37,15,10,4,8,29
64898,30,19,6,1,4,26
64899,31,16,6,1,8,23
64900,19,0,17,0,2,17
64901,54,35,10,2,7,47
64902,22,4,10,0,8,14
64903,556,325,123,15,93,463
64904,288,149,84,0,55,233
64905,49,16,25,0,8,41
64906,118,63,22,11,22,96
64907,42,6,26,0,10,32
64908,148,30,55,24,39,109
64909,234,126,35,29,44,190
64910,51,3,9,23,16,35
64911,34,1,27,1,5,29
64912,32,21,9,0,2,30
64913,104,49,17,16,22,82
64914,22,14,2,0,6,16
64915,216,119,51,3,43,173
64916,83,40,30,4,9,74
64917,105,75,11,11,8,97
64918,174,90,48,8,28,146
64919,340,141,123,6,70,270
64920,85,28,30,8,19,66
64921,126,91,9,0,26,100
64922,148,58,39,21,30,118
64923,14,4,2,6,2,12
64924,61,33,10,0,18,43
64925,12,6,2,2,2,10
64926,130,38,67,0,25,105
64927,55,33,11,0,11,44
64928,111,65,23,7,16,95
64929,124,83,29,0,12,112
64930,21,1,4,13,3,18
64931,34,13,16,1,4,30
64932,55,34,10,0,11,44
64933,32,21,9,0,2,30
64934,173,54,87,0,32,141
64935,203,31,94,33,45,158
64936,43,12,15,8,8,35
64937,117,69,27,0,21,96
64938,38,6,24,4,4,34
64939,48,20,17,3,8,40
64940,5,2,0,0,3,2
64941,66,7,46,0,13,53
64942,75,28,27,2,18,57
64943,9,3,3,1,2,7
64944,29,16,5,0,8,21
64945,147,37,76,1,33,114
64946,37,8,20,1,8,29
64947,334,191,74,5,64,270
64948,179,127,14,1,37,142
64949,40,8,18,0,14,26
64950,45,27,12,0,6,39
64951,34,28,2,0,4,30
64952,45,22,13,2,8,37
64953,61,35,13,3,10,51
64954,129,77,20,7,25,104
64955,140,53,56,7,24,116
64956,23,12,5,0,6,17
64957,27,9,12,1,5,22
64958,92,40,14,21,17,75
64959,16,12,3,0,1,15
64960,41,7,14,10,10,31
64961,10,5,4,1,0,10
64962,136,93,19,1,23,113
64963,36,18,13,0,5,31
64964,36,9,20,0,7,29
64965,180,56,58,25,41,139
64966,31,8,15,1,7,24
64967,27,12,9,3,3,24
64968,103,34,26,25,18,85
64969,27,3,17,0,7,20
64970,37,8,16,1,12,25
64971,13,6,5,0,2,11
64972,35,1,28,1,5,30
64973,10,9,0,0,1,9
64974,69,23,28,6,12,57
64975,194,101,32,27,34,160
64976,32,23,2,0,7,25
64977,41,29,5,0,7,34
64978,61,14,36,3,8,53
64979,83,35,36,0,12,71
64980,34,22,7,0,5,29
64981,14,8,1,0,5,9
64982,61,44,6,1,10,51
64983,38,7,11,16,4,34
64984,382,168,133,11,70,312
64985,46,18,20,0,8,38
64986,25,9,12,1,3,22
64987,16,7,9,0,0,16
64988,139,30,53,26,30,109
64989,151,98,27,1,25,126
64990,42,15,15,5,7,35
64991,275,86,131,14,44,231
64992,48,13,16,12,7,41
64993,15,5,7,0,3,12
64994,369,104,142,37,86,283
64995,44,7,26,4,7,37
64996,395,133,159,18,85,310
64997,52,15,24,4,9,43
64998,29,10,11,0,8,21
64999,233,156,32,0,45,188
65000,111,62,21,7,21,90
65001,527,271,111,37,108,419
65002,53,30,12,0,11,42
65003,652,384,140,17,111,541
65004,125,68,10,24,23,102
65005,25,1,16,0,8,17
65006,45,20,13,1,11,34
65007,18,4,9,0,5,13
65008,57,40,2,0,15,42
65009,19,5,12,0,2,17
65010,46,18,20,0,8,38
65011,25,5,1,16,3,22
65012,288,71,66,92,59,229
65013,18,2,10,0,6,12
65014,439,209,123,14,93,346
65015,4,2,1,0,1,3
65016,56,22,6,17,11,45
65017,36,8,18,1,9,27
65018,157,80,46,1,30,127
65019,87,26,46,0,15,72
65020,2,0,2,0,0,2
65021,80,26,42,0,12,68
65022,24,14,5,0,5,19
65023,72,20,30,8,14,58
65024,45,13,25,0,7,38
65025,29,12,12,1,4,25
65026,213,114,48,0,51,162
65027,134,39,62,3,30,104
65028,16,4,6,3,3,13
65029,89,64,9,1,15,74
65030,138,35,68,4,31,107
65031,336,140,120,6,70,266
65032,68,45,12,0,11,57
65033,32,22,7,0,3,29
65034,36,8,17,1,10,26
65035,74,23,31,8,12,62
65036,77,49,15,0,13,64
65037,45,28,8,2,7,38
65038,17,8,1,3,5,12
65039,9,3,3,0,3,6
65040,23,9,10,0,4,19
65041,25,10,7,0,8,17
65042,271,64,46,115,46,225
65043,47,10,32,1,4,43
65044,5,4,1,0,0,5
65045,32,10,4,11,7,25
65046,157,69,31,21,36,121
65047,46,18,20,0,8,38
65048,50,20,21,1,8,42
65049,102,55,20,8,19,83
65050,235,156,62,2,15,220
65051,46,23,8,2,13,33
65052,11,1,8,0,2,9
65053,72,36,19,0,17,55
65054,108,47,25,8,28,80
65055,174,85,55,7,27,147
65056,54,31,8,0,15,39
65057,149,63,32,21,33,116
65058,32,15,11,0,6,26
65059,13,3,7,1,2,11
65060,45,24,15,0,6,39
65061,162,68,35,21,38,124
65062,34,9,16,1,8,26
65063,61,15,39,0,7,54
65064,30,15,11,0,4,26
65065,95,32,5,45,13,82
65066,18,9,5,0,4,14
65067,17,10,2,1,4,13
65068,74,33,13,8,20,54
65069,53,35,11,0,7,46
65070,283,97,128,14,44,239
65071,259,15,194,0,50,209
65072,135,76,22,4,33,102
65073,52,13,26,4,9,43
65074,68,29,26,0,13,55
65075,83,32,30,4,17,66
65076,70,34,19,1,16,54
65077,16,11,2,2,1,15
65078,173,106,31,6,30,143
65079,31,9,11,4,7,24
65080,27,14,5,0,8,19
65081,40,28,1,1,10,30
65082,35,21,7,0,7,28
65083,290,110,105,25,50,240
65084,21,12,1,4,4,17
65085,46,18,20,0,8,38
65086,12,5,3,0,4,8
65087,80,38,5,16,21,59
65088,22,0,20,0,2,20
65089,41,29,4,1,7,34
65090,123,87,16,0,20,103
65091,174,58,57,26,33,141
65092,63,52,1,0,10,53
65093,61,36,14,1,10,51
65094,315,240,19,0,56,259
65095,39,24,8,0,7,32
65096,32,8,15,1,8,24
65097,78,26,28,2,22,56
65098,303,163,75,16,49,254
65099,30,2,22,1,5,25
65100,8,0,3,0,5,3
65101,38,3,27,0,8,30
65102,32,21,9,0,2,30
65103,32,21,9,0,2,30
65104,318,85,153,6,74,244
65105,56,17,25,4,10,46
65106,107,84,7,0,16,91
65107,23,3,14,0,6,17
65108,49,25,3,14,7,42
65109,495,265,82,43,105,390
65110,59,25,17,1,16,43
65111,43,13,21,1,8,35
65112,21,4,14,0,3,18
65113,2,0,2,0,0,2
65114,208,84,34,41,49,159
65115,516,283,113,13,107,409
65116,53,3,40,3,7,46
65117,136,73,33,0,30,106
65118,90,29,32,12,17,73
65119,90,47,12,2,29,61
65120,33,3,6,17,7,26
65121,75,33,14,9,19,56
65122,33,20,6,1,6,27
65123,66,18,32,4,12,54
65124,51,0,32,3,16,35
65125,65,14,30,4,17,48
65126,142,110,13,0,19,123
65127,33,20,4,1,8,25
65128,143,88,16,19,20,123
65129,88,28,19,22,19,69
65130,110,48,15,17,30,80
65131,55,15,33,0,7,48
65132,71,23,32,4,12,59
65133,3,2,0,0,1,2
65134,50,34,9,0,7,43
65135,43,28,7,1,7,36
65136,128,70,26,5,27,101
65137,162,69,57,16,20,142
65138,165,58,53,25,29,136
65139,35,17,12,0,6,29
65140,97,51,22,4,20,77
65141,66,34,10,8,14,52
65142,14,6,3,3,2,12
65143,121,74,25,0,22,99
65144,76,44,19,0,13,63
65145,18,4,9,0,5,13
65146,279,94,133,5,47,232
65147,60,42,5,1,12,48
65148,165,55,73,0,37,128
65149,437,118,178,45,96,341
65150,209,87,62,18,42,167
65151,20,11,4,0,5,15
65152,43,26,8,0,9,34
65153,73,25,21,10,17,56
65154,8,2,4,0,2,6
65155,28,17,7,0,4,24
65156,147,64,54,1,28,119
65157,32,7,16,4,5,27
65158,15,4,6,0,5,10
65159,161,69,34,20,38,123
65160,120,46,35,14,25,95
65161,29,1,21,0,7,22
65162,68,30,25,0,13,55
65163,74,25,29,5,15,59
65164,121,51,30,18,22,99
65165,44,21,18,0,5,39
65166,144,57,56,7,24,120
65167,46,18,20,0,8,38
65168,8,5,2,0,1,7
65169,102,36,38,6,22,80
65170,73,25,14,25,9,64
65171,31,4,22,0,5,26
65172,210,140,23,0,47,163
65173,46,18,20,0,8,38
65174,115,46,41,8,20,95
65175,24,10,3,8,3,21
65176,39,22,7,2,8,31
65177,348,179,100,4,65,283
65178,70,24,22,1,23,47
65179,134,61,42,10,21,113
65180,41,10,21,1,9,32
65181,32,21,9,0,2,30
65182,68,30,24,0,14,54
65183,101,50,32,0,19,82
65184,134,90,16,3,25,109
65185,184,108,20,23,33,151
65186,114,51,23,22,18,96
65187,40,13,17,3,7,33
65188,222,130,20,25,47,175
65189,45,18,17,3,7,38
65190,48,16,19,5,8,40
65191,44,11,24,3,6,38
65192,84,18,41,9,16,68
65193,213,61,105,1,46,167
65194,25,8,4,5,8,17
65195,67,28,14,14,11,56
65196,215,131,34,3,47,168
65197,34,15,11,0,8,26
65198,35,23,6,0,6,29
65199,64,45,8,0,11,53
65200,48,24,11,1,12,36
65201,354,193,101,0,60,294
65202,2,0,0,0,2,0
65203,165,124,4,1,36,129
65204,46,18,20,0,8,38
65205,101,45,13,21,22,79
65206,53,33,5,0,15,38
65207,89,65,6,0,18,71
65208,73,39,11,4,19,54
65209,25,9,9,0,7,18
65210,559,388,50,1,120,439
65211,616,400,81,4,131,485
65212,16,14,1,0,1,15
65213,45,15,16,3,11,34
65214,177,85,41,14,37,140
65215,36,22,3,0,11,25
65216,79,32,32,3,12,67
65217,56,13,20,6,17,39
65218,359,159,125,6,69,290
65219,37,22,6,2,7,30
65220,68,29,27,0,12,56
65221,48,15,17,9,7,41
65222,61,27,13,8,13,48
65223,193,95,59,0,39,154
65224,7,1,3,0,3,4
65225,85,27,43,2,13,72
65226,38,18,14,0,6,32
65227,249,126,59,14,50,199
65228,154,113,17,0,24,130
65229,35,22,4,4,5,30
65230,138,84,27,0,27,111
65231,9,2,4,0,3,6
65232,2,0,1,0,1,1
65233,22,1,13,1,7,15
65234,2,0,1,1,0,2
65235,142,62,32,22,26,116
65236,33,11,15,0,7,26
65237,45,15,16,7,7,38
65238,86,44,26,2,14,72
65239,17,7,8,0,2,15
65240,22,9,7,0,6,16
65241,57,33,10,0,14,43
65242,63,37,13,2,11,52
65243,141,26,89,1,25,116
65244,26,9,0,7,10,16
65245,195,76,36,34,49,146
65246,87,29,24,11,23,64
65247,75,40,10,3,22,53
65248,34,7,21,0,6,28
65249,105,52,35,0,18,87
65250,101,66,9,5,21,80
65251,32,1,25,0,6,26
65252,17,4,8,0,5,12
65253,535,302,116,17,100,435
65254,15,1,13,0,1,14
65255,218,131,17,26,44,174
65256,51,38,0,3,10,41
65257,140,66,46,5,23,117
65258,33,26,2,0,5,28
65259,59,5,9,28,17,42
65260,71,37,16,0,18,53
65261,12,2,9,0,1,11
65262,14,7,2,0,5,9
65263,53,24,20,2,7,46
65264,20,0,15,0,5,15
65265,23,13,6,0,4,19
65266,435,135,179,23,98,337
65267,680,399,142,20,119,561
65268,124,69,22,6,27,97
65269,79,54,9,0,16,63
65270,51,27,12,1,11,40
65271,56,25,20,0,11,45
65272,88,69,0,4,15,73
65273,111,44,33,8,26,85
65274,56,20,26,2,8,48
65275,25,2,20,0,3,22
65276,68,39,14,2,13,55
65277,151,79,38,0,34,117
65278,68,45,12,0,11,57
65279,29,12,14,0,3,26
65280,121,49,29,25,18,103
65281,63,33,17,1,12,51
65282,114,49,25,16,24,90
65283,69,46,9,0,14,55
65284,76,5,43,8,20,56
65285,79,61,6,2,10,69
65286,63,24,23,1,15,48
65287,72,14,46,0,12,60
65288,373,210,90,15,58,315
65289,27,18,4,3,2,25
65290,124,60,26,4,34,90
65291,254,189,13,1,51,203
65292,153,59,38,22,34,119
65293,11,3,4,0,4,7
65294,21,6,1,8,6,15
65295,214,60,21,101,32,182
65296,13,1,9,0,3,10
65297,37,24,5,1,7,30
65298,74,40,16,4,14,60
65299,250,192,13,0,45,205
65300,29,21,2,0,6,23
65301,356,209,74,0,73,283
65302,39,13,20,0,6,33
65303,417,116,197,8,96,321
65304,63,42,4,0,17,46
65305,333,200,64,0,69,264
65306,32,21,9,0,2,30
65307,15,4,8,0,3,12
65308,99,30,40,3,26,73
65309,152,117,9,1,25,127
65310,270,73,146,1,50,220
65311,336,167,109,3,57,279
65312,54,6,38,0,10,44
65313,150,80,32,7,31,119
65314,70,55,1,0,14,56
65315,14,2,9,0,3,11
65316,173,135,7,0,31,142
65317,64,10,44,0,10,54
65318,60,32,9,1,18,42
65319,107,23,53,0,31,76
65320,61,36,17,1,7,54
65321,19,2,11,0,6,13
65322,81,53,15,0,13,68
65323,140,66,42,11,21,119
65324,489,241,96,56,96,393
65325,474,217,158,13,86,388
65326,84,43,28,3,10,74
65327,46,18,20,0,8,38
65328,430,128,161,47,94,336
65329,122,42,42,10,28,94
65330,228,62,124,5,37,191
65331,43,19,15,0,9,34
65332,23,0,20,0,3,20
65333,40,8,18,0,14,26
65334,43,23,13,0,7,36
65335,69,37,11,6,15,54
65336,129,89,18,3,19,110
65337,31,18,12,0,1,30
65338,25,9,13,0,3,22
65339,74,25,26,1,22,52
65340,37,15,14,0,8,29
65341,163,126,7,0,30,133
65342,147,58,31,27,31,116
65343,162,57,51,25,29,133
65344,26,8,14,1,3,23
65345,71,33,24,2,12,59
65346,46,18,20,0,8,38
65347,76,24,27,8,17,59
65348,438,137,181,21,99,339
65349,137,49,57,0,31,106
65350,22,6,10,2,4,18
65351,181,103,33,0,45,136
65352,180,13,133,0,34,146
65353,33,5,7,11,10,23
65354,12,1,9,0,2,10
65355,24,18,3,0,3,21
65356,24,9,6,3,6,18
65357,153,42,12,71,28,125
65358,72,49,5,6,12,60
65359,32,21,9,0,2,30
65360,49,8,31,3,7,42
65361,38,3,28,1,6,32
65362,51,15,16,10,10,41
65363,399,131,167,13,88,311
65364,440,243,115,0,82,358
65365,13,7,3,1,2,11
65366,21,2,11,1,7,14
65367,76,34,29,0,13,63
65368,105,48,30,4,23,82
65369,23,8,10,3,2,21
65370,150,96,30,1,23,127
65371,38,19,9,1,9,29
65372,68,38,11,3,16,52
65373,40,19,7,2,12,28
65374,104,48,29,4,23,81
65375,170,48,13,81,28,142
65376,78,48,11,2,17,61
65377,76,17,46,0,13,63
65378,20,2,11,1,6,14
65379,61,31,13,8,9,52
65380,130,44,50,12,24,106
65381,64,15,23,3,23,41
65382,67,41,16,0,10,57
65383,22,13,4,0,5,17
65384,610,422,57,1,130,480
65385,51,16,28,0,7,44
65386,9,3,3,0,3,6
65387,65,14,26,3,22,43
65388,49,29,12,0,8,41
65389,44,2,35,0,7,37
65390,94,47,21,2,24,70
65391,32,13,10,0,9,23
65392,73,31,20,1,21,52
65393,186,137,15,3,31,155
65394,598,413,56,1,128,470
65395,74,22,32,4,16,58
65396,29,8,12,1,8,21
65397,88,39,8,26,15,73
65398,60,33,9,12,6,54
65399,63,40,11,2,10,53
65400,66,50,12,0,4,62
65401,32,21,9,0,2,30
65402,80,9,50,5,16,64
65403,46,28,9,4,5,41
65404,35,3,25,0,7,28
65405,108,76,9,6,17,91
65406,397,189,97,31,80,317
65407,101,41,26,13,21,80
65408,118,42,48,0,28,90
65409,45,6,30,0,9,36
65410,171,72,55,5,39,132
65411,61,15,34,1,11,50
65412,57,17,29,0,11,46
65413,36,12,16,0,8,28
65414,308,69,160,5,74,234
65415,35,9,16,0,10,25
65416,32,21,9,0,2,30
65417,60,42,9,0,9,51
65418,46,18,20,0,8,38
65419,5,0,4,0,1,4
65420,97,49,34,0,14,83
65421,88,34,37,0,17,71
65422,24,13,4,1,6,18
65423,29,6,14,1,8,21
65424,115,50,26,15,24,91
65425,404,194,109,22,79,325
65426,22,12,1,7,2,20
65427,23,7,12,0,4,19
65428,36,4,16,7,9,27
65429,16,2,10,1,3,13
65430,137,94,11,5,27,110
65431,31,19,3,0,9,22
65432,64,13,30,4,17,47
65433,194,100,36,22,36,158
65434,32,9,19,0,4,28
65435,148,71,43,0,34,114
65436,20,7,6,0,7,13
65437,318,166,85,15,52,266
65438,133,99,3,2,29,104
65439,35,14,11,3,7,28
65440,54,11,28,5,10,44
65441,125,77,26,0,22,103
65442,35,12,14,0,9,26
65443,95,33,29,12,21,74
65444,15,9,4,0,2,13
65445,204,84,64,20,36,168
65446,71,43,14,0,14,57
65447,70,15,43,1,11,59
65448,155,74,44,6,31,124
65449,534,352,75,4,103,431
65450,401,285,33,0,83,318
65451,88,44,19,4,21,67
65452,62,31,17,5,9,53
65453,100,39,28,12,21,79
65454,115,24,57,0,34,81
65455,50,21,18,1,10,40
65456,6,1,3,0,2,4
65457,49,21,12,6,10,39
65458,17,2,13,0,2,15
65459,56,3,41,1,11,45
65460,25,13,11,0,1,24
65461,41,30,0,0,11,30
65462,118,42,41,12,23,95
65463,90,38,24,11,17,73
65464,83,30,37,1,15,68
65465,28,2,12,8,6,22
65466,154,96,28,0,30,124
65467,42,11,21,2,8,34
65468,40,8,18,0,14,26
65469,56,3,41,1,11,45
65470,53,21,15,1,16,37
65471,117,49,15,18,35,82
65472,156,100,22,2,32,124
65473,49,11,30,0,8,41
65474,91,35,19,8,29,62
65475,140,59,54,1,26,114
65476,171,129,5,1,36,135
65477,22,5,9,2,6,16
65478,15,12,1,0,2,13
65479,28,10,10,6,2,26
65480,13,5,3,0,5,8
65481,151,24,99,1,27,124
65482,82,39,25,0,18,64
65483,96,53,23,4,16,80
65484,26,7,6,6,7,19
65485,203,106,34,31,32,171
65486,53,27,18,0,8,45
65487,14,3,6,0,5,9
65488,53,30,16,0,7,46
65489,80,36,23,3,18,62
65490,112,40,43,11,18,94
65491,219,74,81,15,49,170
65492,279,96,126,15,42,237
65493,46,18,20,0,8,38
65494,86,39,32,0,15,71
65495,24,17,0,0,7,17
65496,127,75,22,3,27,100
65497,34,7,13,4,10,24
65498,26,15,0,6,5,21
65499,76,39,23,2,12,64
65500,67,36,14,4,13,54
65501,4,1,2,0,1,3
65502,92,20,32,22,18,74
65503,479,227,152,11,89,390
65504,86,45,18,9,14,72
65505,180,79,62,10,29,151
65506,48,10,15,13,10,38
65507,343,147,120,6,70,273
65508,57,22,23,3,9,48
65509,32,21,9,0,2,30
65510,69,33,13,10,13,56
65511,324,140,118,2,64,260
65512,81,51,15,8,7,74
65513,25,18,0,0,7,18
65514,85,28,37,9,11,74
65515,98,44,28,1,25,73
65516,85,37,26,3,19,66
65517,25,18,1,0,6,19
65518,122,74,28,0,20,102
65519,10,0,9,0,1,9
65520,300,83,138,6,73,227
65521,47,16,20,1,10,37
65522,18,5,9,1,3,15
65523,58,40,2,2,14,44
65524,436,135,177,26,98,338
65525,97,27,21,29,20,77
65526,56,30,18,0,8,48
65527,30,3,19,3,5,25
65528,16,6,9,0,1,15
65529,29,12,14,0,3,26
65530,29,23,2,0,4,25
65531,164,68,35,22,39,125
65532,49,31,11,0,7,42
65533,122,68,22,2,30,92
65534,47,16,25,0,6,41
65535,59,9,37,4,9,50
65536,254,192,15,0,47,207
65537,57,31,13,3,10,47
65538,155,9,88,27,31,124
65539,47,7,29,0,11,36
65540,68,27,22,2,17,51
65541,19,2,11,0,6,13
65542,96,27,55,2,12,84
65543,38,13,17,0,8,30
65544,121,72,9,14,26,95
65545,46,18,20,0,8,38
65546,38,20,9,1,8,30
65547,109,46,39,2,22,87
65548,160,106,24,1,29,131
65549,197,142,16,2,37,160
65550,15,5,8,0,2,13
65551,9,3,3,1,2,7
65552,19,2,15,0,2,17
65553,43,33,2,0,8,35
65554,46,1,13,26,6,40
65555,15,6,7,0,2,13
65556,186,93,56,0,37,149
65557,98,61,8,8,21,77
65558,37,9,23,1,4,33
65559,137,103,4,2,28,109
65560,59,19,30,0,10,49
65561,189,76,72,3,38,151
65562,130,38,67,0,25,105
65563,46,28,9,4,5,41
65564,48,8,34,0,6,42
65565,65,48,2,0,15,50
65566,14,9,4,0,1,13
65567,70,26,32,5,7,63
65568,77,42,11,8,16,61
65569,250,102,19,83,46,204
65570,54,42,2,0,10,44
65571,239,129,34,34,42,197
65572,267,150,32,33,52,215
65573,202,82,32,41,47,155
65574,193,62,60,27,44,149
65575,38,20,9,1,8,30
65576,141,83,21,2,35,106
65577,31,10,10,6,5,26
65578,72,47,12,2,11,61
65579,25,1,17,3,4,21
65580,428,198,133,13,84,344
65581,9,0,6,0,3,6
65582,253,153,55,4,41,212
65583,155,71,31,17,36,119
65584,22,11,6,1,4,18
65585,104,41,28,12,23,81
65586,19,15,3,0,1,18
65587,17,4,7,2,4,13
65588,111,80,9,2,20,91
65589,97,58,19,0,20,77
65590,74,27,30,3,14,60
65591,59,34,10,0,15,44
65592,55,14,29,1,11,44
65593,57,6,37,1,13,44
65594,25,13,7,2,3,22
65595,459,125,189,39,106,353
65596,126,42,46,7,31,95
65597,34,16,10,0,8,26
65598,68,34,19,0,15,53
65599,89,55,19,3,12,77
65600,194,40,53,62,39,155
65601,35,16,10,0,9,26
65602,18,9,7,0,2,16
65603,82,26,25,12,19,63
65604,9,0,5,2,2,7
65605,69,16,36,7,10,59
65606,32,16,7,0,9,23
65607,43,19,13,6,5,38
65608,360,198,90,15,57,303
65609,46,18,20,0,8,38
65610,107,42,19,14,32,75
65611,50,20,12,7,11,39
65612,79,31,34,1,13,66
65613,34,14,10,0,10,24
65614,41,21,5,7,8,33
65615,27,3,19,0,5,22
65616,21,5,5,4,7,14
65617,425,122,191,14,98,327
65618,12,6,2,0,4,8
65619,279,24,202,2,51,228
65620,79,21,41,2,15,64
65621,43,23,13,0,7,36
65622,36,5,24,3,4,32
65623,124,39,67,0,18,106
65624,70,38,14,1,17,53
65625,51,27,8,5,11,40
65626,74,34,27,0,13,61
65627,7,4,0,0,3,4
65628,587,423,43,1,120,467
65629,128,41,49,14,24,104
65630,15,7,6,0,2,13
65631,58,26,19,2,11,47
65632,14,4,7,0,3,11
65633,80,24,35,1,20,60
65634,10,0,6,0,4,6
65635,295,158,69,19,49,246
65636,70,36,17,0,17,53
65637,212,98,65,0,49,163
65638,379,104,179,7,89,290
65639,114,83,5,1,25,89
65640,200,51,22,95,32,168
65641,25,17,3,1,4,21
65642,47,9,23,4,11,36
65643,227,162,16,4,45,182
65644,11,8,3,0,0,11
65645,137,73,34,0,30,107
65646,213,86,37,41,49,164
65647,55,25,13,6,11,44
65648,109,57,32,1,19,90
65649,40,10,18,4,8,32
65650,54,26,17,0,11,43
65651,44,36,2,0,6,38
65652,139,74,29,1,35,104
65653,59,19,15,14,11,48
65654,78,36,5,16,21,57
65655,179,77,62,9,31,148
65656,32,21,9,0,2,30
65657,65,31,17,2,15,50
65658,119,48,46,0,25,94
65659,46,14,22,0,10,36
65660,125,58,39,4,24,101
65661,19,15,3,0,1,18
65662,33,15,9,0,9,24
65663,155,99,31,1,24,131
65664,15,1,14,0,0,15
65665,1,0,1,0,0,1
65666,35,12,10,5,8,27
65667,23,9,9,0,5,18
65668,30,15,9,4,2,28
65669,277,118,96,17,46,231
65670,113,46,41,5,21,92
65671,455,334,22,0,99,356
65672,59,6,42,0,11,48
65673,23,3,15,0,5,18
65674,46,18,20,0,8,38
65675,45,9,22,0,14,31
65676,141,101,15,2,23,118
65677,17,8,6,0,3,14
65678,45,9,22,0,14,31
65679,8,3,4,0,1,7
65680,43,14,21,1,7,36
65681,32,21,9,0,2,30
65682,129,26,68,1,34,95
65683,75,9,43,5,18,57
65684,115,44,39,6,26,89
65685,243,101,15,83,44,199
65686,3,2,0,0,1,2
65687,32,21,9,0,2,30
65688,13,2,5,0,6,7
65689,120,59,23,17,21,99
65690,626,350,157,22,97,529
65691,151,115,7,0,29,122
65692,94,60,12,2,20,74
65693,30,12,11,0,7,23
65694,40,4,25,1,10,30
65695,33,12,11,1,9,24
65696,125,96,3,0,26,99
65697,40,27,2,3,8,32
65698,11,8,1,0,2,9
65699,32,7,18,1,6,26
65700,434,199,142,8,85,349
65701,44,7,29,5,3,41
65702,84,31,35,1,17,67
65703,16,3,12,0,1,15
65704,24,14,2,3,5,19
65705,105,55,24,0,26,79
65706,103,29,56,0,18,85
65707,109,46,44,3,16,93
65708,36,23,10,0,3,33
65709,20,2,11,1,6,14
65710,63,37,13,2,11,52
65711,27,8,3,5,11,16
65712,25,15,6,0,4,21
65713,204,78,54,30,42,162
65714,129,47,28,23,31,98
65715,12,12,0,0,0,12
65716,52,17,22,4,9,43
65717,19,0,11,0,8,11
65718,0,0,0,0,0,0
65719,107,40,39,6,22,85
65720,64,23,32,1,8,56
65721,58,25,15,3,15,43
65722,30,10,14,1,5,25
65723,55,27,21,0,7,48
65724,122,58,37,3,24,98
65725,5,0,0,0,5,0
65726,18,1,14,0,3,15
65727,104,49,23,2,30,74
65728,71,40,17,1,13,58
65729,183,67,57,26,33,150
65730,35,19,9,1,6,29
65731,87,37,8,25,17,70
65732,6,0,6,0,0,6
65733,36,21,7,0,8,28
65734,84,18,41,9,16,68
65735,34,16,12,1,5,29
65736,63,30,16,5,12,51
65737,317,165,85,15,52,265
65738,46,13,25,0,8,38
65739,40,31,1,2,6,34
65740,69,46,6,0,17,52
65741,381,221,82,16,62,319
65742,71,53,6,0,12,59
65743,513,260,96,49,108,405
65744,67,47,8,0,12,55
65745,46,18,20,0,8,38
65746,243,101,15,83,44,199
65747,86,39,32,0,15,71
65748,141,58,53,3,27,114
65749,89,43,25,3,18,71
65750,155,51,46,32,26,129
65751,99,66,15,1,17,82
65752,29,12,11,0,6,23
65753,108,45,14,17,32,76
65754,39,28,5,2,4,35
65755,46,18,20,0,8,38
65756,38,21,6,2,9,29
65757,112,58,22,10,22,90
65758,67,34,15,2,16,51
65759,161,109,27,0,25,136
65760,15,0,11,0,4,11
65761,424,194,138,9,83,341
65762,103,63,10,8,22,81
65763,93,39,37,0,17,76
65764,45,15,24,0,6,39
65765,385,181,108,16,80,305
65766,83,25,22,19,17,66
65767,16,2,10,1,3,13
65768,48,24,17,0,7,41
65769,7,2,3,0,2,5
65770,193,105,57,0,31,162
65771,34,14,7,1,12,22
65772,80,47,18,2,13,67
65773,76,52,11,5,8,68
65774,9,0,7,0,2,7
65775,18,8,8,0,2,16
65776,84,39,27,2,16,68
65777,59,20,26,0,13,46
65778,58,18,33,1,6,52
65779,233,79,91,15,48,185
65780,14,1,10,0,3,11
65781,37,16,3,8,10,27
65782,25,9,13,0,3,22
65783,58,19,22,3,14,44
65784,30,5,19,0,6,24
65785,258,96,108,6,48,210
65786,18,7,1,4,6,12
65787,39,21,10,0,8,31
65788,264,63,136,7,58,206
65789,61,36,16,0,9,52
65790,21,10,6,0,5,16
65791,57,34,15,0,8,49
65792,8,1,3,0,4,4
65793,47,21,16,2,8,39
65794,46,18,20,0,8,38
65795,183,76,55,11,41,142
65796,64,42,5,0,17,47
65797,127,36,42,24,25,102
65798,32,21,6,0,5,27
65799,193,75,35,34,49,144
65800,31,15,8,4,4,27
65801,4,1,1,0,2,2
65802,11,8,2,0,1,10
65803,96,59,17,2,18,78
65804,72,40,19,0,13,59
65805,51,33,6,0,12,39
65806,32,21,9,0,2,30
65807,66,23,25,3,15,51
65808,10,0,9,0,1,9
65809,35,11,20,0,4,31
65810,63,42,13,0,8,55
65811,74,28,28,5,13,61
65812,86,43,28,0,15,71
65813,77,39,26,1,11,66
65814,62,46,4,3,9,53
65815,94,40,31,10,13,81
65816,77,32,29,1,15,62
65817,221,95,14,76,36,185
65818,562,402,43,1,116,446
65819,172,103,19,16,34,138
65820,97,61,11,2,23,74
65821,39,8,23,2,6,33
65822,16,10,5,0,1,15
65823,27,7,10,4,6,21
65824,103,32,50,1,20,83
65825,38,16,17,0,5,33
65826,2,1,1,0,0,2
65827,11,3,6,0,2,9
65828,156,55,39,30,32,124
65829,41,12,19,0,10,31
65830,80,26,42,0,12,68
65831,14,4,4,1,5,9
65832,8,2,6,0,0,8
65833,39,3,33,0,3,36
65834,40,7,15,8,10,30
65835,13,1,7,0,5,8
65836,41,9,23,3,6,35
65837,110,38,43,11,18,92
65838,32,21,9,0,2,30
65839,56,38,12,0,6,50
65840,33,22,3,0,8,25
65841,49,33,4,2,10,39
65842,60,20,24,4,12,48
65843,115,41,42,14,18,97
65844,109,40,26,20,23,86
65845,45,18,19,0,8,37
65846,47,9,24,4,10,37
65847,222,60,115,4,43,179
65848,38,25,5,1,7,31
65849,15,5,4,3,3,12
65850,70,29,22,0,19,51
65851,35,19,6,1,9,26
65852,23,7,10,1,5,18
65853,33,12,11,1,9,24
65854,148,51,38,29,30,118
65855,73,25,21,10,17,56
65856,15,6,3,2,4,11
65857,127,49,48,0,30,97
65858,315,193,54,0,68,247
65859,32,21,9,0,2,30
65860,410,133,162,25,90,320
65861,10,6,2,0,2,8
65862,109,32,56,0,21,88
65863,135,54,42,9,30,105
65864,65,41,14,1,9,56
65865,69,14,35,6,14,55
65866,143,61,32,17,33,110
65867,88,41,25,1,21,67
65868,528,290,114,13,111,417
65869,3,1,0,0,2,1
65870,13,7,3,2,1,12
65871,205,68,82,15,40,165
65872,93,62,8,10,13,80
65873,263,139,75,0,49,214
65874,44,36,2,0,6,38
65875,339,143,120,6,70,269
65876,79,37,5,16,21,58
65877,80,24,27,11,18,62
65878,80,30,35,1,14,66
65879,95,60,10,6,19,76
65880,146,64,53,1,28,118
65881,7,0,5,0,2,5
65882,100,71,19,1,9,91
65883,106,25,61,3,17,89
65884,70,40,19,2,9,61
65885,128,81,17,4,26,102
65886,41,24,5,7,5,36
65887,78,34,26,5,13,65
65888,156,71,51,6,28,128
65889,55,41,8,0,6,49
65890,166,133,5,3,25,141
65891,39,18,8,5,8,31
65892,502,269,84,45,104,398
65893,86,51,10,12,13,73
65894,37,12,17,1,7,30
65895,498,269,84,43,102,396
65896,62,19,28,2,13,49
65897,30,20,3,0,7,23
65898,79,60,5,4,10,69
65899,238,180,9,0,49,189
65900,46,26,6,2,12,34
65901,31,6,17,2,6,25
65902,89,25,21,19,24,65
65903,31,7,13,3,8,23
65904,88,57,10,6,15,73
65905,225,120,35,29,41,184
65906,115,53,24,15,23,92
65907,64,42,5,0,17,47
65908,34,10,10,6,8,26
65909,13,8,2,0,3,10
65910,267,140,91,0,36,231
65911,29,8,14,1,6,23
65912,55,6,35,1,13,42
65913,8,1,3,0,4,4
65914,43,8,24,3,8,35
65915,36,9,17,2,8,28
65916,62,18,28,3,13,49
65917,79,46,15,3,15,64
65918,45,21,14,0,10,35
65919,65,45,6,1,13,52
65920,73,37,18,1,17,56
65921,33,13,15,0,5,28
65922,32,16,8,0,8,24
65923,153,61,38,21,33,120
65924,147,60,45,9,33,114
65925,33,14,11,0,8,25
65926,16,9,3,0,4,12
65927,41,14,18,4,5,36
65928,123,48,36,10,29,94
65929,111,56,30,5,20,91
65930,73,64,2,0,7,66
65931,116,48,15,18,35,81
65932,85,39,29,4,13,72
65933,23,12,9,1,1,22
65934,59,33,17,0,9,50
65935,246,59,25,121,41,205
65936,82,37,24,3,18,64
65937,440,328,25,0,87,353
65938,29,10,15,0,4,25
65939,63,15,31,0,17,46
65940,346,261,19,2,64,282
65941,57,24,18,5,10,47
65942,179,128,13,1,37,142
65943,75,26,27,5,17,58
65944,123,47,33,14,29,94
65945,19,3,9,1,6,13
65946,24,10,8,2,4,20
65947,196,143,14,1,38,158
65948,95,57,18,5,15,80
65949,582,409,49,1,123,459
65950,73,22,36,2,13,60
65951,147,75,44,0,28,119
65952,76,24,21,12,19,57
65953,357,185,91,19,62,295
65954,41,17,8,6,10,31
65955,93,35,30,3,25,68
65956,42,10,11,9,12,30
65957,92,43,9,17,23,69
65958,13,4,5,0,4,9
65959,33,14,9,2,8,25
65960,45,13,25,0,7,38
65961,4,1,2,0,1,3
65962,156,55,39,30,32,124
65963,8,2,4,0,2,6
65964,540,287,98,47,108,432
65965,86,41,22,1,22,64
65966,28,13,9,2,4,24
65967,16,9,0,5,2,14
65968,41,8,26,4,3,38
65969,51,28,13,1,9,42
65970,127,58,26,17,26,101
65971,32,21,10,0,1,31
65972,50,11,31,0,8,42
65973,34,23,8,0,3,31
65974,67,17,25,10,15,52
65975,94,48,14,2,30,64
65976,124,98,6,0,20,104
65977,95,48,25,3,19,76
65978,79,37,24,0,18,61
65979,259,136,66,0,57,202
65980,83,21,38,3,21,62
65981,95,47,29,1,18,77
65982,131,84,3,11,33,98
65983,14,0,10,0,4,10
65984,80,28,29,2,21,59
65985,63,25,22,3,13,50
65986,52,33,9,0,10,42
65987,3,0,2,0,1,2
65988,47,8,33,0,6,41
65989,49,30,5,8,6,43
65990,3,0,3,0,0,3
65991,105,46,27,1,31,74
65992,81,36,16,13,16,65
65993,14,1,10,0,3,11
65994,4,0,2,2,0,4
65995,101,85,3,3,10,91
65996,48,24,7,8,9,39
65997,334,245,17,2,70,264
65998,43,10,23,0,10,33
65999,32,21,9,0,2,30
66000,141,103,6,3,29,112
66001,189,86,52,13,38,151
66002,53,9,32,0,12,41
66003,91,62,11,10,8,83
66004,22,5,13,0,4,18
66005,19,10,6,0,3,16
66006,175,84,26,25,40,135
66007,30,18,5,2,5,25
66008,35,16,10,0,9,26
66009,32,21,9,0,2,30
66010,32,21,9,0,2,30
66011,118,62,22,11,23,95
66012,6,0,5,0,1,5
66013,223,111,40,34,38,185
66014,7,6,1,0,0,7
66015,2,1,1,0,0,2
66016,21,6,7,0,8,13
66017,33,17,10,0,6,27
66018,155,74,49,1,31,124
66019,169,81,25,24,39,130
66020,75,23,24,8,20,55
66021,168,84,49,1,34,134
66022,21,15,3,0,3,18
66023,32,21,9,0,2,30
66024,206,90,44,24,48,158
66025,19,10,8,0,1,18
66026,138,48,59,4,27,111
66027,14,2,9,0,3,11
66028,41,8,25,0,8,33
66029,120,51,24,19,26,94
66030,41,13,16,3,9,32
66031,23,6,8,3,6,17
66032,82,37,15,13,17,65
66033,42,3,28,3,8,34
66034,18,5,10,0,3,15
66035,44,32,4,0,8,36
66036,42,11,27,0,4,38
66037,234,106,45,27,56,178
66038,8,0,6,0,2,6
66039,11,3,6,0,2,9
66040,88,47,12,2,27,61
66041,151,108,17,0,26,125
66042,84,59,5,0,20,64
66043,48,20,17,0,11,37
66044,100,41,22,18,19,81
66045,36,23,5,1,7,29
66046,41,26,6,0,9,32
66047,68,46,5,3,14,54
66048,56,7,32,6,11,45
66049,62,25,24,2,11,51
66050,32,16,8,4,4,28
66051,132,89,22,0,21,111
66052,71,19,26,13,13,58
66053,50,29,6,2,13,37
66054,469,229,124,20,96,373
66055,44,23,15,0,6,38
66056,237,144,9,31,53,184
66057,109,65,20,7,17,92
66058,18,2,10,0,6,12
66059,78,60,1,0,17,61
66060,40,6,5,20,9,31
66061,95,71,5,0,19,76
66062,16,9,2,2,3,13
66063,108,88,4,2,14,94
66064,42,14,17,3,8,34
66065,98,26,40,8,24,74
66066,20,1,14,0,5,15
66067,70,33,16,4,17,53
66068,27,1,18,0,8,19
66069,164,121,18,0,25,139
66070,60,18,31,0,11,49
66071,47,22,11,2,12,35
66072,53,30,13,2,8,45
66073,39,29,0,0,10,29
66074,31,15,13,0,3,28
66075,197,108,39,14,36,161
66076,15,2,10,1,2,13
66077,61,49,0,0,12,49
66078,2,2,0,0,0,2
66079,53,32,16,0,5,48
66080,44,21,14,3,6,38
66081,16,5,8,0,3,13
66082,38,20,9,1,8,30
66083,35,6,21,0,8,27
66084,78,19,36,3,20,58
66085,25,8,8,3,6,19
66086,77,52,15,1,9,68
66087,50,24,15,1,10,40
66088,42,7,25,0,10,32
66089,49,36,2,0,11,38
66090,73,40,5,12,16,57
66091,3,2,0,0,1,2
66092,157,93,36,1,27,130
66093,61,23,26,0,12,49
66094,272,62,144,7,59,213
66095,13,0,12,1,0,13
66096,61,28,23,1,9,52
66097,15,4,8,0,3,12
66098,70,34,12,5,19,51
66099,75,35,24,0,16,59
66100,416,193,126,12,85,331
66101,83,30,35,1,17,66
66102,144,46,73,2,23,121
66103,62,36,16,0,10,52
66104,125,76,26,0,23,102
66105,100,48,31,5,16,84
66106,18,6,4,3,5,13
66107,31,13,10,0,8,23
66108,132,51,27,26,28,104
66109,106,44,38,5,19,87
66110,58,21,26,0,11,47
66111,28,14,7,3,4,24
66112,54,32,7,0,15,39
66113,23,15,2,0,6,17
66114,132,47,51,13,21,111
66115,263,126,80,5,52,211
66116,158,113,20,0,25,133
66117,14,0,10,0,4,10
66118,35,5,14,10,6,29
66119,13,5,5,0,3,10
66120,56,0,40,0,16,40
66121,22,7,6,2,7,15
66122,85,36,35,0,14,71
66123,10,3,5,0,2,8
66124,190,61,61,24,44,146
66125,124,49,29,19,27,97
66126,105,52,25,7,21,84
66127,376,189,114,1,72,304
66128,60,42,5,1,12,48
66129,164,123,4,1,36,128
66130,47,16,23,0,8,39
66131,29,10,11,0,8,21
66132,37,2,27,0,8,29
66133,51,31,7,0,13,38
66134,3,3,0,0,0,3
66135,74,26,38,0,10,64
66136,130,42,50,14,24,106
66137,40,30,4,2,4,36
66138,89,30,43,2,14,75
66139,94,50,25,3,16,78
66140,75,43,16,1,15,60
66141,182,26,112,3,41,141
66142,112,34,36,14,28,84
66143,209,112,35,27,35,174
66144,68,35,15,5,13,55
66145,70,57,2,0,11,59
66146,139,75,34,0,30,109
66147,168,86,40,0,42,126
66148,141,85,30,0,26,115
66149,224,170,15,0,39,185
66150,66,35,15,0,16,50
66151,423,200,133,12,78,345
66152,615,364,137,15,99,516
66153,113,46,16,18,33,80
66154,46,25,13,2,6,40
66155,71,35,12,7,17,54
66156,93,64,8,0,21,72
66157,23,5,14,0,4,19
66158,72,39,17,0,16,56
66159,11,3,6,0,2,9
66160,187,13,140,0,34,153
66161,182,121,12,11,38,144
66162,69,41,3,13,12,57
66163,19,10,5,1,3,16
66164,21,8,9,0,4,17
66165,73,31,20,1,21,52
66166,63,29,22,3,9,54
66167,36,16,12,0,8,28
66168,165,116,13,0,36,129
66169,81,43,16,8,14,67
66170,82,40,27,4,11,71
66171,175,78,27,28,42,133
66172,102,38,38,5,21,81
66173,133,41,64,1,27,106
66174,30,9,16,0,5,25
66175,522,365,47,1,109,413
66176,65,42,7,4,12,53
66177,56,36,12,3,5,51
66178,77,14,40,7,16,61
66179,58,16,20,7,15,43
66180,33,26,3,1,3,30
66181,58,19,32,0,7,51
66182,82,37,30,1,14,68
66183,62,40,12,1,9,53
66184,276,90,128,15,43,233
66185,345,137,120,24,64,281
66186,44,25,14,0,5,39
66187,45,24,3,11,7,38
66188,4,2,0,0,2,2
66189,383,221,84,0,78,305
66190,64,33,8,8,15,49
66191,27,19,2,0,6,21
66192,119,34,37,23,25,94
66193,35,24,5,0,6,29
66194,90,25,54,0,11,79
66195,142,91,27,2,22,120
66196,211,98,62,13,38,173
66197,43,15,19,0,9,34
66198,64,34,3,17,10,54
66199,11,3,4,0,4,7
66200,8,2,4,0,2,6
66201,59,27,13,5,14,45
66202,16,6,5,0,5,11
66203,30,23,0,0,7,23
66204,48,0,44,0,4,44
66205,503,255,94,53,101,402
66206,14,6,5,0,3,11
66207,17,11,5,0,1,16
66208,32,21,9,0,2,30
66209,60,32,18,1,9,51
66210,65,17,29,3,16,49
66211,197,64,61,27,45,152
66212,33,12,3,15,3,30
66213,69,21,32,4,12,57
66214,0,0,0,0,0,0
66215,446,148,159,48,91,355
66216,81,21,34,0,26,55
66217,250,131,72,0,47,203
66218,55,15,22,10,8,47
66219,33,22,6,0,5,28
66220,31,9,13,0,9,22
66221,50,5,33,1,11,39
66222,62,33,15,0,14,48
66223,116,28,35,22,31,85
66224,111,44,39,6,22,89
66225,48,16,18,2,12,36
66226,111,63,15,10,23,88
66227,47,8,27,4,8,39
66228,122,59,32,0,31,91
66229,76,39,23,2,12,64
66230,54,16,26,0,12,42
66231,177,75,54,10,38,139
66232,113,49,39,4,21,92
66233,17,3,12,0,2,15
66234,197,110,28,23,36,161
66235,424,231,93,12,88,336
66236,13,7,4,0,2,11
66237,77,39,20,0,18,59
66238,52,34,5,6,7,45
66239,66,19,31,1,15,51
66240,142,82,22,2,36,106
66241,160,112,23,0,25,135
66242,65,7,49,1,8,57
66243,111,71,15,3,22,89
66244,103,39,24,20,20,83
66245,64,28,23,1,12,52
66246,98,39,22,18,19,79
66247,24,6,14,0,4,20
66248,30,19,9,0,2,28
66249,79,27,35,2,15,64
66250,74,45,11,3,15,59
66251,50,14,26,4,6,44
66252,167,74,56,7,30,137
66253,48,19,23,1,5,43
66254,57,2,35,15,5,52
66255,40,28,1,0,11,29
66256,12,4,3,0,5,7
66257,40,7,26,1,6,34
66258,61,24,23,4,10,51
66259,24,10,7,2,5,19
66260,95,43,27,1,24,71
66261,145,81,28,1,35,110
66262,49,3,38,0,8,41
66263,3,0,2,0,1,2
66264,53,18,18,7,10,43
66265,683,380,166,24,113,570
66266,56,42,2,0,12,44
66267,113,47,15,18,33,80
66268,18,15,1,0,2,16
66269,125,104,5,0,16,109
66270,32,15,13,0,4,28
66271,150,39,78,1,32,118
66272,220,150,30,0,40,180
66273,14,3,6,0,5,9
66274,19,12,1,0,6,13
66275,190,87,58,14,31,159
66276,49,26,6,8,9,40
66277,32,21,9,0,2,30
66278,141,60,42,14,25,116
66279,73,39,23,2,9,64
66280,68,17,29,12,10,58
66281,59,25,24,0,10,49
66282,222,126,43,14,39,183
66283,104,22,49,14,19,85
66284,29,5,6,10,8,21
66285,28,13,10,0,5,23
66286,46,18,20,0,8,38
66287,39,18,7,6,8,31
66288,40,15,10,9,6,34
66289,354,189,91,15,59,295
66290,31,15,7,0,9,22
66291,390,204,108,16,62,328
66292,55,30,12,2,11,44
66293,121,46,35,15,25,96
66294,6,0,5,0,1,5
66295,31,8,16,2,5,26
66296,49,28,7,6,8,41
66297,279,124,103,2,50,229
66298,13,3,7,0,3,10
66299,6,1,2,0,3,3
66300,80,41,20,2,17,63
66301,7,3,4,0,0,7
66302,185,124,12,11,38,147
66303,6,0,6,0,0,6
66304,130,59,33,9,29,101
66305,6,0,3,0,3,3
66306,206,93,58,13,42,164
66307,69,15,42,0,12,57
66308,67,14,40,0,13,54
66309,16,5,6,3,2,14
66310,1,1,0,0,0,1
66311,36,17,10,1,8,28
66312,32,21,9,0,2,30
66313,20,12,4,1,3,17
66314,24,9,12,1,2,22
66315,89,32,32,5,20,69
66316,18,5,9,0,4,14
66317,54,32,15,0,7,47
66318,178,98,38,10,32,146
66319,106,55,24,7,20,86
66320,60,30,7,10,13,47
66321,129,102,8,0,19,110
66322,42,23,10,0,9,33
66323,68,28,7,20,13,55
66324,121,34,64,0,23,98
66325,107,82,2,0,23,84
66326,5,1,2,1,1,4
66327,73,58,2,0,13,60
66328,24,16,3,0,5,19
66329,76,37,9,10,20,56
66330,163,110,27,0,26,137
66331,73,31,20,1,21,52
66332,48,24,16,0,8,40
66333,62,27,18,4,13,49
66334,284,111,101,21,51,233
66335,444,254,85,12,93,351
66336,80,39,24,0,17,63
66337,39,4,28,0,7,32
66338,59,35,13,1,10,49
66339,78,36,5,16,21,57
66340,21,5,10,0,6,15
66341,39,7,25,0,7,32
66342,420,134,174,18,94,326
66343,351,186,92,15,58,293
66344,197,107,33,21,36,161
66345,144,109,2,1,32,112
66346,12,0,6,4,2,10
66347,3,1,1,0,1,2
66348,67,15,40,0,12,55
66349,155,80,45,1,29,126
66350,29,6,16,2,5,24
66351,129,67,12,23,27,102
66352,46,18,20,0,8,38
66353,2,1,1,0,0,2
66354,8,1,6,0,1,7
66355,19,16,0,0,3,16
66356,153,48,79,4,22,131
66357,14,7,4,0,3,11
66358,72,55,2,0,15,57
66359,177,127,19,2,29,148
66360,18,9,6,2,1,17
66361,23,2,17,0,4,19
66362,284,105,120,15,44,240
66363,12,4,5,0,3,9
66364,30,3,21,0,6,24
66365,123,59,26,4,34,89
66366,68,40,15,0,13,55
66367,42,22,5,7,8,34
66368,83,38,24,3,18,65
66369,28,12,4,4,8,20
66370,167,74,55,7,31,136
66371,79,30,24,8,17,62
66372,107,48,36,5,18,89
66373,22,12,4,0,6,16
66374,123,96,5,0,22,101
66375,30,0,7,19,4,26
66376,33,12,14,0,7,26
66377,21,2,17,0,2,19
66378,100,62,27,0,11,89
66379,673,390,152,20,111,562
66380,46,15,22,4,5,41
66381,138,91,27,1,19,119
66382,130,67,13,23,27,103
66383,38,22,13,0,3,35
66384,57,26,17,5,9,48
66385,99,73,10,0,16,83
66386,33,25,4,0,4,29
66387,29,7,14,1,7,22
66388,23,15,6,0,2,21
66389,167,108,27,5,27,140
66390,166,107,11,11,37,129
66391,40,21,14,0,5,35
66392,96,68,11,3,14,82
66393,214,131,15,26,42,172
66394,75,20,26,13,16,59
66395,140,57,33,18,32,108
66396,75,36,10,3,26,49
66397,74,11,49,0,14,60
66398,333,251,19,1,62,271
66399,129,84,15,6,24,105
66400,215,78,89,5,43,172
66401,41,22,10,1,8,33
66402,11,4,5,0,2,9
66403,27,1,18,0,8,19
66404,355,162,119,6,68,287
66405,404,101,170,44,89,315
66406,71,54,5,4,8,63
66407,614,423,58,1,132,482
66408,4,2,1,0,1,3
66409,95,43,34,4,14,81
66410,46,18,20,0,8,38
66411,76,14,39,6,17,59
66412,14,10,2,0,2,12
66413,147,68,42,0,37,110
66414,65,34,16,4,11,54
66415,47,27,12,0,8,39
66416,24,5,14,0,5,19
66417,386,121,155,31,79,307
66418,36,17,10,1,8,28
66419,166,99,38,1,28,138
66420,32,21,9,0,2,30
66421,72,50,9,4,9,63
66422,130,65,17,18,30,100
66423,350,168,114,2,66,284
66424,287,161,35,33,58,229
66425,138,93,19,1,25,113
66426,63,8,42,0,13,50
66427,86,25,42,0,19,67
66428,194,76,35,34,49,145
66429,22,6,12,1,3,19
66430,38,17,12,0,9,29
66431,344,187,88,15,54,290
66432,173,88,42,0,43,130
66433,45,25,16,0,4,41
66434,36,1,28,1,6,30
66435,32,21,9,0,2,30
66436,52,36,3,1,12,40
66437,67,26,26,5,10,57
66438,66,34,14,2,16,50
66439,18,7,4,1,6,12
66440,164,103,4,19,38,126
66441,31,3,15,8,5,26
66442,53,24,14,1,14,39
66443,88,66,4,1,17,71
66444,404,229,93,0,82,322
66445,53,3,38,0,12,41
66446,20,9,10,0,1,19
66447,60,25,23,1,11,49
66448,60,22,26,0,12,48
66449,10,8,1,0,1,9
66450,90,32,36,4,18,72
66451,52,42,1,0,9,43
66452,63,33,7,8,15,48
66453,350,159,116,6,69,281
66454,13,7,4,0,2,11
66455,38,15,18,0,5,33
66456,92,54,16,1,21,71
66457,21,7,9,0,5,16
66458,64,30,24,1,9,55
66459,108,55,43,1,9,99
66460,46,22,11,4,9,37
66461,71,39,17,0,15,56
66462,100,58,7,11,24,76
66463,21,8,10,0,3,18
66464,626,376,123,18,109,517
66465,33,24,4,0,5,28
66466,39,17,12,2,8,31
66467,53,14,25,2,12,41
66468,594,360,106,8,120,474
66469,137,78,23,3,33,104
66470,121,49,29,14,29,92
66471,506,296,84,7,119,387
66472,76,28,26,7,15,61
66473,17,6,5,0,6,11
66474,154,121,6,0,27,127
66475,119,32,63,0,24,95
66476,21,6,9,0,6,15
66477,53,23,19,0,11,42
66478,127,75,22,3,27,100
66479,220,94,14,76,36,184
66480,20,11,4,1,4,16
66481,124,51,32,18,23,101
66482,57,28,13,6,10,47
66483,41,10,16,9,6,35
66484,32,21,9,0,2,30
66485,52,29,6,6,11,41
66486,54,26,16,1,11,43
66487,3,1,2,0,0,3
66488,106,58,10,16,22,84
66489,99,62,24,6,7,92
66490,45,1,35,0,9,36
66491,32,21,9,0,2,30
66492,131,43,36,29,23,108
66493,37,3,27,0,7,30
66494,79,46,17,0,16,63
66495,156,92,25,12,27,129
66496,34,4,20,0,10,24
66497,59,37,10,2,10,49
66498,10,3,4,0,3,7
66499,16,6,7,0,3,13
66500,46,29,9,0,8,38
66501,98,28,43,6,21,77
66502,255,124,72,0,59,196
66503,58,31,9,1,17,41
66504,14,0,12,0,2,12
66505,297,137,95,12,53,244
66506,62,26,26,0,10,52
66507,129,94,6,3,26,103
66508,192,103,58,0,31,161
66509,68,15,41,2,10,58
66510,135,53,33,21,28,107
66511,218,148,30,0,40,178
66512,201,95,71,1,34,167
66513,296,144,81,12,59,237
66514,104,48,27,12,17,87
66515,37,13,15,1,8,29
66516,47,15,22,0,10,37
66517,8,2,0,5,1,7
66518,73,48,15,1,9,64
66519,48,19,15,4,10,38
66520,33,6,20,0,7,26
66521,82,22,42,2,16,66
66522,49,36,2,0,11,38
66523,32,21,9,0,2,30
66524,163,124,2,1,36,127
66525,12,5,5,0,2,10
66526,24,8,9,0,7,17
66527,30,9,7,5,9,21
66528,30,21,3,1,5,25
66529,62,44,7,1,10,52
66530,32,1,27,0,4,28
66531,43,12,21,0,10,33
66532,30,5,22,2,1,29
66533,48,26,16,1,5,43
66534,9,5,1,0,3,6
66535,28,3,16,4,5,23
66536,55,31,10,4,10,45
66537,652,385,140,16,111,541
66538,41,4,29,0,8,33
66539,55,15,25,5,10,45
66540,193,61,22,77,33,160
66541,84,47,21,0,16,68
66542,160,24,98,10,28,132
66543,492,348,42,1,101,391
66544,69,44,13,0,12,57
66545,241,181,16,0,44,197
66546,20,6,0,8,6,14
66547,24,4,15,1,4,20
66548,50,27,14,0,9,41
66549,122,41,31,22,28,94
66550,63,42,13,0,8,55
66551,405,185,133,6,81,324
66552,79,27,21,9,22,57
66553,20,12,3,0,5,15
66554,66,43,14,2,7,59
66555,59,42,3,6,8,51
66556,50,20,14,4,12,38
66557,26,12,9,0,5,21
66558,14,3,4,4,3,11
66559,76,4,54,1,17,59
66560,11,5,5,0,1,10
66561,528,227,139,48,114,414
66562,27,19,5,0,3,24
66563,42,8,29,0,5,37
66564,166,126,7,0,33,133
66565,53,28,3,14,8,45
66566,47,32,9,0,6,41
66567,332,138,120,6,68,264
66568,568,404,44,1,119,449
66569,135,76,24,7,28,107
66570,32,21,9,0,2,30
66571,25,7,12,0,6,19
66572,85,36,22,12,15,70
66573,85,43,5,25,12,73
66574,150,12,89,21,28,122
66575,199,79,37,33,50,149
66576,54,24,20,1,9,45
66577,23,13,9,0,1,22
66578,32,21,9,0,2,30
66579,132,42,50,17,23,109
66580,599,411,56,1,131,468
66581,24,7,12,2,3,21
66582,38,19,9,1,9,29
66583,204,77,40,38,49,155
66584,216,128,39,3,46,170
66585,12,6,5,0,1,11
66586,42,11,27,0,4,38
66587,33,12,9,0,12,21
66588,90,36,20,11,23,67
66589,102,67,15,3,17,85
66590,32,21,9,0,2,30
66591,23,13,8,1,1,22
66592,355,244,40,1,70,285
66593,154,72,52,2,28,126
66594,13,4,7,1,1,12
66595,72,36,17,0,19,53
66596,58,22,11,17,8,50
66597,48,23,17,0,8,40
66598,85,43,23,1,18,67
66599,419,312,20,0,87,332
66600,126,74,13,20,19,107
66601,112,85,2,0,25,87
66602,105,48,41,2,14,91
66603,38,0,33,0,5,33
66604,14,3,7,1,3,11
66605,30,20,3,0,7,23
66606,53,28,6,4,15,38
66607,92,59,12,2,19,73
66608,59,18,26,2,13,46
66609,13,5,5,1,2,11
66610,194,110,26,23,35,159
66611,70,23,20,9,18,52
66612,160,91,35,4,30,130
66613,42,29,1,0,12,30
66614,93,38,25,12,18,75
66615,48,18,17,1,12,36
66616,36,21,8,0,7,29
66617,50,14,18,9,9,41
66618,80,30,34,0,16,64
66619,91,36,38,0,17,74
66620,482,226,156,11,89,393
66621,92,30,43,0,19,73
66622,84,24,42,2,16,68
66623,18,7,4,1,6,12
66624,162,118,9,5,30,132
66625,21,5,10,0,6,15
66626,69,24,35,1,9,60
66627,26,19,1,0,6,20
66628,78,45,20,0,13,65
66629,57,16,26,0,15,42
66630,36,7,19,4,6,30
66631,377,84,164,41,88,289
66632,176,47,18,83,28,148
66633,12,9,3,0,0,12
66634,18,13,2,0,3,15
66635,52,25,17,1,9,43
66636,144,49,67,0,28,116
66637,22,5,16,0,1,21
66638,32,22,5,1,4,28
66639,46,7,31,3,5,41
66640,58,27,23,2,6,52
66641,49,25,5,5,14,35
66642,21,11,4,0,6,15
66643,2,2,0,0,0,2
66644,19,14,3,0,2,17
66645,43,11,22,0,10,33
66646,17,13,2,0,2,15
66647,80,17,42,1,20,60
66648,67,11,20,28,8,59
66649,14,2,8,0,4,10
66650,42,31,2,0,9,33
66651,122,59,28,14,21,101
66652,62,41,7,2,12,50
66653,25,8,12,0,5,20
66654,32,21,9,0,2,30
66655,191,74,34,34,49,142
66656,52,22,19,0,11,41
66657,2,2,0,0,0,2
66658,35,28,2,0,5,30
66659,75,9,43,5,18,57
66660,35,17,10,0,8,27
66661,34,25,2,0,7,27
66662,24,14,4,0,6,18
66663,348,199,67,13,69,279
66664,205,112,61,0,32,173
66665,234,59,33,103,39,195
66666,18,11,4,1,2,16
66667,69,17,35,0,17,52
66668,6,1,4,0,1,5
66669,216,100,63,13,40,176
66670,107,40,30,14,23,84
66671,43,16,14,3,10,33
66672,20,6,0,8,6,14
66673,23,9,12,0,2,21
66674,46,18,20,0,8,38
66675,342,142,124,6,70,272
66676,99,45,41,2,11,88
66677,146,71,28,21,26,120
66678,75,39,20,4,12,63
66679,34,15,13,0,6,28
66680,26,10,13,0,3,23
66681,35,20,4,1,10,25
66682,50,34,1,4,11,39
66683,15,5,5,0,5,10
66684,36,21,8,0,7,29
66685,94,54,17,0,23,71
66686,22,10,6,3,3,19
66687,127,65,12,23,27,100
66688,155,122,5,0,28,127
66689,175,89,33,21,32,143
66690,25,3,18,1,3,22
66691,21,13,1,0,7,14
66692,91,55,12,1,23,68
66693,30,5,17,1,7,23
66694,351,101,134,32,84,267
66695,196,19,140,2,35,161
66696,95,44,16,18,17,78
66697,19,3,14,0,2,17
66698,83,22,24,17,20,63
66699,12,7,3,0,2,10
66700,27,9,11,0,7,20
66701,25,7,8,0,10,15
66702,14,9,0,2,3,11
66703,20,5,8,2,5,15
66704,46,29,5,7,5,41
66705,27,20,4,1,2,25
66706,84,40,33,2,9,75
66707,67,5,46,4,12,55
66708,220,91,40,38,51,169
66709,17,1,11,0,5,12
66710,200,85,51,23,41,159
66711,46,25,10,1,10,36
66712,49,28,14,0,7,42
66713,207,138,29,4,36,171
66714,53,37,6,1,9,44
66715,39,7,12,10,10,29
66716,39,8,14,6,11,28
66717,73,46,12,1,14,59
66718,2,0,0,0,2,0
66719,12,4,5,0,3,9
66720,383,202,90,17,74,309
66721,27,17,7,0,3,24
66722,71,35,18,0,18,53
66723,88,36,25,12,15,73
66724,19,8,6,0,5,14
66725,55,27,11,0,17,38
66726,65,33,18,0,14,51
66727,88,37,21,17,13,75
66728,47,29,9,0,9,38
66729,7,5,0,1,1,6
66730,133,45,49,8,31,102
66731,45,21,14,0,10,35
66732,49,14,21,7,7,42
66733,50,9,30,2,9,41
66734,84,12,51,5,16,68
66735,282,70,159,1,52,230
66736,31,6,15,1,9,22
66737,1,1,0,0,0,1
66738,45,23,15,0,7,38
66739,33,12,11,1,9,24
66740,79,32,11,12,24,55
66741,230,50,127,7,46,184
66742,62,23,21,1,17,45
66743,53,33,5,0,15,38
66744,19,2,13,0,4,15
66745,238,64,123,1,50,188
66746,349,150,126,6,67,282
66747,162,73,52,6,31,131
66748,26,11,8,2,5,21
66749,9,1,7,0,1,8
66750,201,147,15,1,38,163
66751,13,7,5,0,1,12
66752,35,17,11,0,7,28
66753,36,8,19,1,8,28
66754,139,58,46,8,27,112
66755,88,26,39,5,18,70
66756,45,16,18,0,11,34
66757,59,24,8,12,15,44
66758,39,15,11,3,10,29
66759,115,25,39,29,22,93
66760,225,75,85,15,50,175
66761,17,7,6,0,4,13
66762,120,94,6,0,20,100
66763,64,37,7,8,12,52
66764,70,26,22,8,14,56
66765,30,8,11,2,9,21
66766,37,19,11,1,6,31
66767,84,34,23,10,17,67
66768,21,6,13,0,2,19
66769,132,44,49,6,33,99
66770,76,31,8,17,20,56
66771,677,377,165,24,111,566
66772,46,18,20,0,8,38
66773,60,39,6,2,13,47
66774,186,49,107,4,26,160
66775,42,25,8,0,9,33
66776,63,42,4,0,17,46
66777,140,57,42,18,23,117
66778,74,8,43,5,18,56
66779,42,28,6,0,8,34
66780,74,46,15,0,13,61
66781,124,55,19,18,32,92
66782,97,65,15,2,15,82
66783,44,12,12,10,10,34
66784,0,0,0,0,0,0
66785,153,64,35,20,34,119
66786,49,31,7,0,11,38
66787,217,147,30,0,40,177
66788,47,21,17,0,9,38
66789,71,31,22,0,18,53
66790,56,37,13,0,6,50
66791,6,0,5,0,1,5
66792,205,54,38,78,35,170
66793,147,37,76,1,33,114
66794,58,27,22,0,9,49
66795,418,235,84,14,85,333
66796,130,45,51,8,26,104
66797,193,89,48,19,37,156
66798,93,25,41,8,19,74
66799,34,18,7,3,6,28
66800,152,119,13,1,19,133
66801,45,23,15,3,4,41
66802,143,25,61,26,31,112
66803,55,13,38,0,4,51
66804,16,4,11,0,1,15
66805,34,15,12,0,7,27
66806,24,5,12,1,6,18
66807,62,37,15,0,10,52
66808,21,12,3,0,6,15
66809,95,30,42,1,22,73
66810,19,4,14,0,1,18
66811,83,31,30,8,14,69
66812,62,19,33,1,9,53
66813,376,218,80,0,78,298
66814,54,11,22,8,13,41
66815,466,198,117,46,105,361
66816,47,15,19,6,7,40
66817,23,16,4,0,3,20
66818,69,43,12,2,12,57
66819,162,116,11,2,33,129
66820,33,12,14,1,6,27
66821,511,286,80,41,104,407
66822,26,14,8,0,4,22
66823,84,36,34,1,13,71
66824,150,24,98,1,27,123
66825,260,183,12,4,61,199
66826,97,61,17,0,19,78
66827,42,12,23,0,7,35
66828,77,33,17,9,18,59
66829,431,101,184,45,101,330
66830,36,9,17,2,8,28
66831,91,19,32,22,18,73
66832,182,111,6,22,43,139
66833,119,59,22,16,22,97
66834,42,26,4,1,11,31
66835,20,9,7,0,4,16
66836,509,249,103,56,101,408
66837,66,23,32,1,10,56
66838,115,76,15,1,23,92
66839,41,11,26,0,4,37
66840,136,53,30,24,29,107
66841,56,22,22,4,8,48
66842,65,35,13,1,16,49
66843,13,2,4,5,2,11
66844,150,70,46,5,29,121
66845,115,74,21,2,18,97
66846,138,34,66,4,34,104
66847,83,53,16,0,14,69
66848,13,4,7,0,2,11
66849,37,16,14,0,7,30
66850,55,28,17,5,5,50
66851,150,63,33,19,35,115
66852,13,0,10,0,3,10
66853,2,0,2,0,0,2
66854,82,56,7,1,18,64
66855,120,51,43,3,23,97
66856,46,18,20,0,8,38
66857,90,47,12,2,29,61
66858,78,37,5,15,21,57
66859,218,51,122,5,40,178
66860,168,109,27,0,32,136
66861,8,4,1,0,3,5
66862,88,47,12,2,27,61
66863,44,8,22,0,14,30
66864,361,255,38,1,67,294
66865,20,16,0,0,4,16
66866,40,6,5,20,9,31
66867,50,30,13,0,7,43
66868,59,29,19,1,10,49
66869,341,160,84,27,70,271
66870,347,189,89,15,54,293
66871,45,9,23,5,8,37
66872,351,151,127,6,67,284
66873,149,64,53,7,25,124
66874,467,248,77,41,101,366
66875,229,57,70,51,51,178
66876,125,85,14,2,24,101
66877,18,2,12,1,3,15
66878,126,2,106,0,18,108
66879,12,2,3,2,5,7
66880,49,10,29,1,9,40
66881,41,12,20,0,9,32
66882,8,0,6,0,2,6
66883,26,5,17,0,4,22
66884,57,12,31,0,14,43
66885,38,16,18,0,4,34
66886,42,9,21,4,8,34
66887,91,22,52,0,17,74
66888,175,86,51,4,34,141
66889,31,6,18,0,7,24
66890,16,4,8,0,4,12
66891,76,42,15,0,19,57
66892,18,5,7,1,5,13
66893,17,7,6,0,4,13
66894,186,131,7,6,42,144
66895,31,4,25,0,2,29
66896,276,18,204,2,52,224
66897,321,80,157,6,78,243
66898,142,106,5,4,27,115
66899,194,30,88,31,45,149
66900,156,80,45,1,30,126
66901,98,60,16,1,21,77
66902,146,58,31,26,31,115
66903,40,11,9,15,5,35
66904,263,127,77,0,59,204
66905,137,94,11,5,27,110
66906,45,5,32,0,8,37
66907,17,11,2,0,4,13
66908,9,6,1,0,2,7
66909,111,50,33,0,28,83
66910,146,59,45,9,33,113
66911,150,24,98,1,27,123
66912,32,13,14,2,3,29
66913,444,214,123,13,94,350
66914,54,20,21,2,11,43
66915,79,50,12,0,17,62
66916,40,9,24,0,7,33
66917,39,21,9,1,8,31
66918,98,42,39,0,17,81
66919,127,59,40,4,24,103
66920,54,30,14,3,7,47
66921,96,41,34,1,20,76
66922,49,24,17,0,8,41
66923,147,110,6,0,31,116
66924,9,2,4,0,3,6
66925,49,25,3,14,7,42
66926,16,10,4,0,2,14
66927,27,2,11,8,6,21
66928,109,33,55,1,20,89
66929,91,26,38,10,17,74
66930,39,21,9,1,8,31
66931,31,3,21,0,7,24
66932,30,23,0,0,7,23
66933,78,13,42,7,16,62
66934,62,25,21,2,14,48
66935,141,75,39,2,25,116
66936,199,51,22,93,33,166
66937,142,75,32,7,28,114
66938,32,21,9,0,2,30
66939,6,1,2,0,3,3
66940,73,5,53,1,14,59
66941,62,22,19,6,15,47
66942,11,3,6,1,1,10
66943,88,42,14,14,18,70
66944,27,9,14,0,4,23
66945,271,17,202,0,52,219
66946,2,0,0,2,0,2
66947,290,129,99,4,58,232
66948,7,0,3,0,4,3
66949,68,26,5,23,14,54
66950,59,25,15,1,18,41
66951,278,210,15,0,53,225
66952,40,12,17,2,9,31
66953,6,4,1,0,1,5
66954,45,14,21,0,10,35
66955,69,35,22,0,12,57
66956,69,32,21,5,11,58
66957,15,2,5,0,8,7
66958,62,39,5,2,16,46
66959,68,43,13,1,11,57
66960,600,415,55,1,129,471
66961,362,167,106,11,78,284
66962,99,30,31,15,23,76
66963,12,6,4,1,1,11
66964,42,22,11,4,5,37
66965,86,32,36,4,14,72
66966,34,20,8,0,6,28
66967,94,41,22,8,23,71
66968,112,75,22,0,15,97
66969,69,26,30,1,12,57
66970,65,18,27,0,20,45
66971,44,27,10,3,4,40
66972,463,327,42,1,93,370
66973,52,25,19,2,6,46
66974,5,1,4,0,0,5
66975,21,5,10,0,6,15
66976,102,57,21,0,24,78
66977,48,35,3,3,7,41
66978,82,47,19,1,15,67
66979,526,286,117,14,109,417
66980,46,24,16,1,5,41
66981,46,18,20,0,8,38
66982,78,38,27,0,13,65
66983,51,33,8,0,10,41
66984,15,5,6,0,4,11
66985,80,52,17,0,11,69
66986,50,25,10,7,8,42
66987,57,41,3,0,13,44
66988,70,24,30,6,10,60
66989,348,151,124,6,67,281
66990,40,22,13,0,5,35
66991,18,2,13,0,3,15
66992,34,21,6,0,7,27
66993,70,16,38,1,15,55
66994,60,35,14,0,11,49
66995,14,10,0,0,4,10
66996,32,21,9,0,2,30
66997,20,11,5,1,3,17
66998,53,44,0,0,9,44
66999,15,3,10,0,2,13
67000,138,70,16,23,29,109
67001,37,7,24,1,5,32
67002,66,33,13,0,20,46
67003,31,12,12,1,6,25
67004,291,155,67,15,54,237
67005,498,206,133,52,107,391
67006,134,36,67,1,30,104
67007,151,61,32,28,30,121
67008,56,32,14,2,8,48
67009,10,2,5,0,3,7
67010,70,39,14,0,17,53
67011,11,8,1,0,2,9
67012,21,10,7,0,4,17
67013,101,49,36,1,15,86
67014,59,37,10,0,12,47
67015,39,24,8,0,7,32
67016,22,2,15,2,3,19
67017,115,43,29,21,22,93
67018,71,36,25,0,10,61
67019,44,9,28,1,6,38
67020,36,23,9,1,3,33
67021,152,62,36,22,32,120
67022,19,1,12,1,5,14
67023,50,33,8,0,9,41
67024,13,7,4,0,2,11
67025,147,69,49,5,24,123
67026,108,71,13,3,21,87
67027,28,8,10,3,7,21
67028,22,4,10,1,7,15
67029,63,34,9,6,14,49
67030,34,13,15,0,6,28
67031,87,36,18,8,25,62
67032,46,18,20,0,8,38
67033,58,33,16,0,9,49
67034,455,219,94,44,98,357
67035,6,0,6,0,0,6
67036,31,20,3,0,8,23
67037,27,0,20,0,7,20
67038,114,35,56,0,23,91
67039,36,6,20,0,10,26
67040,69,37,14,0,18,51
67041,15,9,5,0,1,14
67042,157,68,53,0,36,121
67043,50,18,21,0,11,39
67044,67,16,37,0,14,53
67045,115,65,20,5,25,90
67046,25,12,7,0,6,19
67047,20,3,0,10,7,13
67048,25,10,6,1,8,17
67049,201,89,55,20,37,164
67050,84,35,10,22,17,67
67051,34,16,7,1,10,24
67052,112,33,39,15,25,87
67053,27,8,14,0,5,22
67054,36,15,20,0,1,35
67055,10,7,2,0,1,9
67056,85,57,8,3,17,68
67057,138,58,50,3,27,111
67058,24,9,12,1,2,22
67059,16,0,11,2,3,13
67060,348,191,88,15,54,294
67061,32,21,9,0,2,30
67062,68,45,12,0,11,57
67063,93,70,4,1,18,75
67064,22,18,0,0,4,18
67065,109,20,55,15,19,90
67066,33,25,5,0,3,30
67067,94,60,23,0,11,83
67068,8,3,3,0,2,6
67069,48,26,9,3,10,38
67070,137,102,5,2,28,109
67071,138,64,46,5,23,115
67072,67,12,43,0,12,55
67073,31,10,14,4,3,28
67074,92,53,13,3,23,69
67075,14,3,7,0,4,10
67076,82,28,39,3,12,70
67077,94,72,4,1,17,77
67078,108,53,38,1,16,92
67079,52,15,24,1,12,40
67080,31,16,7,4,4,27
67081,213,88,14,75,36,177
67082,30,13,11,3,3,27
67083,39,26,9,0,4,35
67084,32,21,9,0,2,30
67085,188,74,44,30,40,148
67086,73,64,2,0,7,66
67087,58,16,30,0,12,46
67088,15,3,6,0,6,9
67089,12,4,3,0,5,7
67090,63,32,14,3,14,49
67091,5,4,1,0,0,5
67092,6,0,4,0,2,4
67093,337,198,67,0,72,265
67094,7,0,5,0,2,5
67095,216,80,62,30,44,172
67096,131,91,22,0,18,113
67097,371,100,145,47,79,292
67098,32,21,9,0,2,30
67099,32,21,9,0,2,30
67100,50,11,28,0,11,39
67101,3,2,0,0,1,2
67102,74,27,35,6,6,68
67103,87,41,27,3,16,71
67104,62,19,33,1,9,53
67105,37,5,20,5,7,30
67106,80,30,33,7,10,70
67107,46,15,20,4,7,39
67108,56,3,41,1,11,45
67109,95,25,42,5,23,72
67110,25,9,9,0,7,18
67111,55,13,38,0,4,51
67112,52,32,11,0,9,43
67113,1,1,0,0,0,1
67114,55,25,13,6,11,44
67115,6,4,1,0,1,5
67116,157,9,91,27,30,127
67117,37,18,13,1,5,32
67118,59,35,7,3,14,45
67119,155,91,21,11,32,123
67120,25,9,9,2,5,20
67121,688,400,143,21,124,564
67122,37,22,6,2,7,30
67123,43,18,10,9,6,37
67124,32,21,9,0,2,30
67125,32,21,9,0,2,30
67126,375,285,20,0,70,305
67127,401,295,21,0,85,316
67128,73,22,37,0,14,59
67129,45,6,27,0,12,33
67130,44,36,2,0,6,38
67131,32,12,14,0,6,26
67132,108,37,42,11,18,90
67133,44,16,12,5,11,33
67134,242,155,33,4,50,192
67135,32,21,9,0,2,30
67136,52,23,12,5,12,40
67137,59,33,3,12,11,48
67138,160,79,25,26,30,130
67139,193,80,44,23,46,147
67140,137,46,46,16,29,108
67141,55,9,29,4,13,42
67142,68,35,11,7,15,53
67143,107,49,30,2,26,81
67144,2,1,0,0,1,1
67145,62,38,14,1,9,53
67146,111,63,22,7,19,92
67147,163,77,47,7,32,131
67148,50,14,24,2,10,40
67149,107,44,14,17,32,75
67150,95,51,28,0,16,79
67151,79,40,20,0,19,60
67152,479,246,87,45,101,378
67153,35,8,23,0,4,31
67154,88,18,40,12,18,70
67155,43,14,21,2,6,37
67156,72,35,15,4,18,54
67157,32,21,9,0,2,30
67158,50,35,7,1,7,43
67159,44,38,1,0,5,39
67160,11,1,5,0,5,6
67161,44,24,9,2,9,35
67162,455,236,116,12,91,364
67163,220,150,30,0,40,180
67164,8,5,1,0,2,6
67165,125,68,10,24,23,102
67166,14,10,3,0,1,13
67167,46,18,20,0,8,38
67168,29,9,13,2,5,24
67169,36,19,10,0,7,29
67170,16,7,3,1,5,11
67171,55,27,21,0,7,48
67172,13,3,9,0,1,12
67173,13,1,11,0,1,12
67174,197,77,36,34,50,147
67175,166,84,48,3,31,135
67176,15,6,4,3,2,13
67177,36,3,28,1,4,32
67178,9,0,5,2,2,7
67179,36,25,6,1,4,32
67180,49,24,12,2,11,38
67181,61,22,32,0,7,54
67182,74,34,21,3,16,58
67183,156,101,3,17,35,121
67184,62,20,17,9,16,46
67185,32,21,9,0,2,30
67186,29,1,24,0,4,25
67187,27,8,10,1,8,19
67188,137,12,92,9,24,113
67189,23,4,17,0,2,21
67190,168,44,92,2,30,138
67191,40,8,18,0,14,26
67192,110,54,38,1,17,93
67193,198,89,52,20,37,161
67194,26,20,0,0,6,20
67195,71,37,14,6,14,57
67196,95,19,31,25,20,75
67197,446,144,185,17,100,346
67198,171,114,27,1,29,142
67199,12,2,6,0,4,8
67200,23,12,2,3,6,17
67201,90,48,18,3,21,69
67202,69,25,24,8,12,57
67203,72,39,15,2,16,56
67204,35,27,4,0,4,31
67205,30,0,26,0,4,26
67206,39,16,11,3,9,30
67207,94,55,22,0,17,77
67208,68,28,24,0,16,52
67209,170,118,15,0,37,133
67210,14,4,6,0,4,10
67211,171,82,54,3,32,139
67212,29,13,10,0,6,23
67213,41,15,14,5,7,34
67214,143,35,76,1,31,112
67215,10,1,4,0,5,5
67216,32,21,9,0,2,30
67217,105,48,30,1,26,79
67218,64,2,37,19,6,58
67219,281,210,15,0,56,225
67220,72,42,19,0,11,61
67221,235,95,14,83,43,192
67222,54,38,3,1,12,42
67223,199,76,76,6,41,158
67224,59,41,9,0,9,50
67225,148,61,58,7,22,126
67226,199,101,50,0,48,151
67227,97,74,4,2,17,80
67228,73,51,9,1,12,61
67229,380,218,85,0,77,303
67230,298,74,125,27,72,226
67231,84,55,12,0,17,67
67232,139,81,13,19,26,113
67233,15,3,10,1,1,14
67234,492,251,92,52,97,395
67235,62,26,8,13,15,47
67236,129,28,50,21,30,99
67237,83,52,13,0,18,65
67238,9,5,4,0,0,9
67239,119,44,34,17,24,95
67240,99,29,49,4,17,82
67241,62,22,19,5,16,46
67242,100,53,35,0,12,88
67243,49,31,5,0,13,36
67244,90,60,6,5,19,71
67245,42,19,16,0,7,35
67246,403,112,156,47,88,315
67247,24,4,7,4,9,15
67248,233,79,92,14,48,185
67249,27,5,15,4,3,24
67250,61,28,8,12,13,48
67251,32,21,9,0,2,30
67252,359,182,102,1,74,285
67253,56,29,13,5,9,47
67254,32,3,22,2,5,27
67255,28,3,20,0,5,23
67256,39,12,20,1,6,33
67257,115,51,35,2,27,88
67258,161,35,56,37,33,128
67259,39,26,6,0,7,32
67260,185,100,25,24,36,149
67261,12,10,1,0,1,11
67262,75,47,17,0,11,64
67263,78,15,43,0,20,58
67264,18,11,4,1,2,16
67265,221,151,30,0,40,181
67266,442,153,150,47,92,350
67267,76,31,23,9,13,63
67268,67,13,32,10,12,55
67269,80,37,26,2,15,65
67270,91,20,41,13,17,74
67271,5,0,0,0,5,0
67272,66,26,4,24,12,54
67273,4,2,1,0,1,3
67274,61,19,26,4,12,49
67275,18,8,7,0,3,15
67276,16,9,5,0,2,14
67277,46,18,20,0,8,38
67278,44,3,33,1,7,37
67279,168,75,54,7,32,136
67280,135,52,37,14,32,103
67281,69,31,25,0,13,56
67282,55,15,30,2,8,47
67283,42,34,3,1,4,38
67284,131,67,27,12,25,106
67285,45,27,8,0,10,35
67286,79,29,24,7,19,60
67287,12,9,1,0,2,10
67288,33,14,13,0,6,27
67289,322,188,58,12,64,258
67290,544,263,122,42,117,427
67291,66,26,22,8,10,56
67292,588,411,50,1,126,462
67293,32,11,16,0,5,27
67294,142,79,26,7,30,112
67295,87,59,8,0,20,67
67296,12,5,3,1,3,9
67297,163,77,47,7,32,131
67298,23,9,6,2,6,17
67299,495,253,90,51,101,394
67300,14,2,11,0,1,13
67301,69,14,34,7,14,55
67302,4,1,2,0,1,3
67303,43,21,12,2,8,35
67304,10,6,1,0,3,7
67305,3,2,0,0,1,2
67306,29,8,15,0,6,23
67307,41,8,13,9,11,30
67308,105,65,25,7,8,97
67309,49,0,38,0,11,38
67310,138,41,67,1,29,109
67311,41,10,21,2,8,33
67312,59,37,7,1,14,45
67313,10,0,10,0,0,10
67314,9,5,2,0,2,7
67315,21,10,6,2,3,18
67316,35,17,12,2,4,31
67317,62,16,30,2,14,48
67318,135,105,8,0,22,113
67319,69,11,44,0,14,55
67320,498,261,91,45,101,397
67321,39,17,12,0,10,29
67322,18,7,4,1,6,12
67323,14,4,2,6,2,12
67324,42,18,13,2,9,33
67325,32,21,9,0,2,30
67326,201,81,64,20,36,165
67327,287,214,12,2,59,228
67328,238,73,113,2,50,188
67329,16,4,9,0,3,13
67330,442,330,20,0,92,350
67331,512,260,96,52,104,408
67332,16,11,3,0,2,14
67333,237,179,17,2,39,198
67334,117,62,22,11,22,95
67335,118,58,27,14,19,99
67336,22,14,2,0,6,16
67337,5,1,3,0,1,4
67338,45,24,11,3,7,38
67339,53,25,18,1,9,44
67340,57,24,15,3,15,42
67341,437,202,150,9,76,361
67342,32,17,3,5,7,25
67343,18,13,1,4,0,18
67344,52,5,9,25,13,39
67345,29,23,2,0,4,25
67346,499,352,38,1,108,391
67347,113,48,29,13,23,90
67348,14,10,0,0,4,10
67349,64,15,23,3,23,41
67350,96,47,29,2,18,78
67351,48,25,4,3,16,32
67352,32,21,9,0,2,30
67353,15,5,8,0,2,13
67354,16,3,10,0,3,13
67355,21,7,9,0,5,16
67356,45,7,16,10,12,33
67357,62,37,11,2,12,50
67358,6,1,2,0,3,3
67359,10,2,7,0,1,9
67360,175,77,50,10,38,137
67361,90,45,17,7,21,69
67362,31,14,9,0,8,23
67363,29,10,16,0,3,26
67364,114,49,43,1,21,93
67365,82,35,32,0,15,67
67366,34,2,25,0,7,27
67367,46,0,38,0,8,38
67368,313,163,83,15,52,261
67369,120,46,35,14,25,95
67370,141,81,22,2,36,105
67371,63,23,14,17,9,54
67372,88,47,11,2,28,60
67373,192,86,62,13,31,161
67374,43,33,1,0,9,34
67375,54,24,13,1,16,38
67376,87,38,31,0,18,69
67377,73,30,25,3,15,58
67378,8,1,6,0,1,7
67379,3,1,0,0,2,1
67380,90,44,14,9,23,67
67381,222,91,41,38,52,170
67382,18,9,5,1,3,15
67383,52,32,10,4,6,46
67384,79,54,11,0,14,65
67385,79,40,18,2,19,60
67386,18,15,1,0,2,16
67387,39,12,18,3,6,33
67388,31,16,7,0,8,23
67389,68,27,27,4,10,58
67390,189,89,47,16,37,152
67391,33,12,11,1,9,24
67392,49,27,15,0,7,42
67393,7,5,0,0,2,5
67394,100,27,48,8,17,83
67395,33,3,23,2,5,28
67396,14,2,10,0,2,12
67397,105,36,26,25,18,87
67398,226,76,86,15,49,177
67399,80,35,24,0,21,59
67400,132,45,52,8,27,105
67401,9,3,3,0,3,6
67402,127,75,22,3,27,100
67403,71,20,22,16,13,58
67404,126,75,21,3,27,99
67405,6,1,5,0,0,6
67406,32,21,9,0,2,30
67407,103,68,1,13,21,82
67408,24,12,7,0,5,19
67409,111,45,9,38,19,92
67410,347,167,121,3,56,291
67411,46,18,20,0,8,38
67412,151,80,46,5,20,131
67413,172,84,54,0,34,138
67414,34,11,13,5,5,29
67415,31,11,16,0,4,27
67416,62,38,13,0,11,51
67417,63,38,17,3,5,58
67418,78,38,25,4,11,67
67419,10,2,6,0,2,8
67420,141,42,55,17,27,114
67421,338,99,159,6,74,264
67422,171,114,27,1,29,142
67423,672,392,144,18,118,554
67424,64,34,4,11,15,49
67425,48,20,17,3,8,40
67426,37,23,6,1,7,30
67427,77,32,27,2,16,61
67428,64,28,15,4,17,47
67429,60,29,15,0,16,44
67430,22,9,7,2,4,18
67431,33,15,10,0,8,25
67432,39,27,1,0,11,28
67433,32,21,9,0,2,30
67434,12,0,11,0,1,11
67435,42,7,28,0,7,35
67436,15,2,11,0,2,13
67437,40,21,11,1,7,33
67438,510,216,129,50,115,395
67439,180,128,7,4,41,139
67440,97,40,28,10,19,78
67441,26,11,8,2,5,21
67442,134,66,37,5,26,108
67443,136,47,22,28,39,97
67444,492,356,33,1,102,390
67445,10,0,7,0,3,7
67446,137,92,13,4,28,109
67447,101,52,27,2,20,81
67448,29,12,8,0,9,20
67449,74,37,20,0,17,57
67450,55,11,32,0,12,43
67451,156,56,51,24,25,131
67452,71,19,41,0,11,60
67453,50,19,18,1,12,38
67454,461,137,188,36,100,361
67455,14,3,9,0,2,12
67456,33,22,8,0,3,30
67457,57,19,32,0,6,51
67458,16,4,9,0,3,13
67459,21,6,11,0,4,17
67460,83,40,23,3,17,66
67461,108,56,32,0,20,88
67462,85,27,23,15,20,65
67463,47,14,25,1,7,40
67464,44,32,4,0,8,36
67465,179,102,33,0,44,135
67466,8,4,4,0,0,8
67467,168,31,105,1,31,137
67468,26,4,20,0,2,24
67469,27,11,10,1,5,22
67470,38,14,16,0,8,30
67471,82,22,41,3,16,66
67472,480,231,96,49,104,376
67473,62,17,21,6,18,44
67474,64,19,25,0,20,44
67475,66,50,12,0,4,62
67476,100,36,40,10,14,86
67477,58,3,40,4,11,47
67478,53,21,19,1,12,41
67479,88,61,6,0,21,67
67480,123,46,34,14,29,94
67481,101,25,50,2,24,77
67482,43,8,20,4,11,32
67483,662,389,142,17,114,548
67484,322,133,130,5,54,268
67485,62,41,8,0,13,49
67486,32,21,9,0,2,30
67487,46,29,6,0,11,35
67488,30,16,6,1,7,23
67489,16,8,6,0,2,14
67490,120,44,31,17,28,92
67491,138,87,26,3,22,116
67492,126,47,26,22,31,95
67493,126,75,21,3,27,99
67494,138,83,23,2,30,108
67495,150,52,39,32,27,123
67496,7,4,1,2,0,7
67497,309,189,53,0,67,242
67498,2,0,2,0,0,2
67499,143,70,18,23,32,111
67500,33,17,12,0,4,29
67501,2,0,1,0,1,1
67502,233,156,32,0,45,188
67503,121,52,38,3,28,93
67504,69,40,13,1,15,54
67505,80,28,23,10,19,61
67506,127,75,22,3,27,100
67507,108,30,58,0,20,88
67508,29,10,11,0,8,21
67509,131,69,14,22,26,105
67510,40,7,22,3,8,32
67511,593,400,65,3,125,468
67512,47,18,20,0,9,38
67513,32,7,14,3,8,24
67514,42,18,10,6,8,34
67515,70,36,13,6,15,55
67516,18,7,4,1,6,12
67517,59,37,13,0,9,50
67518,59,1,50,0,8,51
67519,58,12,37,1,8,50
67520,30,16,8,2,4,26
67521,17,10,2,1,4,13
67522,13,4,6,0,3,10
67523,93,39,38,2,14,79
67524,52,22,13,1,16,36
67525,26,2,5,8,11,15
67526,91,30,19,23,19,72
67527,17,8,2,2,5,12
67528,29,15,7,0,7,22
67529,66,25,27,4,10,56
67530,17,12,3,0,2,15
67531,46,18,20,0,8,38
67532,139,64,48,3,24,115
67533,26,9,12,1,4,22
67534,41,13,14,6,8,33
67535,63,31,17,2,13,50
67536,560,313,116,13,118,442
67537,11,0,10,0,1,10
67538,19,9,5,0,5,14
67539,144,29,58,21,36,108
67540,145,91,29,0,25,120
67541,415,220,104,20,71,344
67542,123,54,21,22,26,97
67543,441,148,154,48,91,350
67544,13,12,1,0,0,13
67545,36,23,5,1,7,29
67546,13,0,12,0,1,12
67547,127,77,19,2,29,98
67548,168,77,54,4,33,135
67549,29,15,8,4,2,27
67550,104,21,61,1,21,83
67551,32,21,9,0,2,30
67552,495,235,125,31,104,391
67553,30,16,3,4,7,23
67554,42,24,7,1,10,32
67555,496,249,94,52,101,395
67556,2,0,1,0,1,1
67557,75,5,54,1,15,60
67558,567,397,47,1,122,445
67559,79,26,28,14,11,68
67560,31,17,3,4,7,24
67561,51,10,28,4,9,42
67562,24,9,13,1,1,23
67563,100,33,34,13,20,80
67564,33,11,11,5,6,27
67565,99,71,5,1,22,77
67566,294,152,98,0,44,250
67567,12,7,2,1,2,10
67568,487,250,88,46,103,384
67569,12,5,6,0,1,11
67570,48,16,20,4,8,40
67571,169,47,54,34,34,135
67572,284,179,43,0,62,222
67573,65,31,22,0,12,53
67574,40,32,1,0,7,33
67575,107,22,68,0,17,90
67576,142,67,54,5,16,126
67577,107,85,3,0,19,88
67578,11,7,3,0,1,10
67579,47,34,2,0,11,36
67580,200,132,54,1,13,187
67581,591,340,122,19,110,481
67582,512,282,114,17,99,413
67583,67,35,17,2,13,54
67584,31,16,6,0,9,22
67585,47,11,23,0,13,34
67586,30,22,4,0,4,26
67587,23,6,12,1,4,19
67588,60,32,20,0,8,52
67589,449,161,148,46,94,355
67590,43,21,11,1,10,33
67591,100,43,19,14,24,76
67592,82,43,22,3,14,68
67593,54,12,6,25,11,43
67594,165,123,4,1,37,128
67595,24,14,2,0,8,16
67596,25,4,13,1,7,18
67597,37,15,4,10,8,29
67598,36,17,8,5,6,30
67599,457,189,119,49,100,357
67600,35,14,10,0,11,24
67601,152,119,5,6,22,130
67602,19,9,5,0,5,14
67603,261,57,68,83,53,208
67604,265,183,18,4,60,205
67605,66,26,16,10,14,52
67606,11,4,5,0,2,9
67607,22,7,11,0,4,18
67608,244,102,15,83,44,200
67609,62,30,17,0,15,47
67610,19,10,8,0,1,18
67611,519,281,115,13,110,409
67612,4,1,1,0,2,2
67613,231,100,14,78,39,192
67614,24,3,18,0,3,21
67615,131,28,46,30,27,104
67616,142,98,17,2,25,117
67617,57,12,31,0,14,43
67618,49,25,3,14,7,42
67619,350,150,124,6,70,280
67620,637,353,157,24,103,534
67621,69,18,28,11,12,57
67622,76,21,35,8,12,64
67623,13,3,8,0,2,11
67624,638,379,133,18,108,530
67625,50,36,2,0,12,38
67626,196,45,100,2,49,147
67627,18,4,10,1,3,15
67628,21,6,7,1,7,14
67629,23,17,2,0,4,19
67630,9,7,0,0,2,7
67631,67,13,40,2,12,55
67632,5,1,4,0,0,5
67633,154,72,52,2,28,126
67634,131,50,48,8,25,106
67635,39,25,3,0,11,28
67636,76,21,33,0,22,54
67637,69,13,44,0,12,57
67638,473,230,95,49,99,374
67639,20,9,7,2,2,18
67640,9,2,3,0,4,5
67641,39,17,8,3,11,28
67642,52,30,15,0,7,45
67643,39,19,13,0,7,32
67644,517,305,90,8,114,403
67645,61,32,7,5,17,44
67646,91,30,20,23,18,73
67647,100,31,50,0,19,81
67648,83,63,3,0,17,66
67649,23,9,9,0,5,18
67650,79,27,37,3,12,67
67651,75,26,29,6,14,61
67652,29,11,13,0,5,24
67653,35,12,16,2,5,30
67654,28,12,7,0,9,19
67655,22,1,13,1,7,15
67656,87,44,26,2,15,72
67657,69,37,23,1,8,61
67658,63,34,14,0,15,48
67659,71,41,3,14,13,58
67660,104,71,6,0,27,77
67661,19,8,9,1,1,18
67662,44,24,2,11,7,37
67663,601,349,125,17,110,491
67664,96,71,6,0,19,77
67665,60,41,2,2,15,45
67666,46,18,20,0,8,38
67667,351,189,92,15,55,296
67668,51,17,20,2,12,39
67669,117,92,4,0,21,96
67670,35,7,11,9,8,27
67671,41,17,16,1,7,34
67672,52,11,22,8,11,41
67673,52,42,1,0,9,43
67674,54,14,27,0,13,41
67675,14,4,8,0,2,12
67676,58,6,37,1,14,44
67677,193,89,47,20,37,156
67678,34,9,14,2,9,25
67679,121,55,28,14,24,97
67680,80,17,44,0,19,61
67681,104,58,25,3,18,86
67682,61,8,40,3,10,51
67683,188,75,61,20,32,156
67684,48,16,10,7,15,33
67685,46,24,15,0,7,39
67686,2,1,1,0,0,2
67687,92,38,34,1,19,73
67688,49,23,15,3,8,41
67689,56,38,12,0,6,50
67690,68,15,36,7,10,58
67691,100,36,40,11,13,87
67692,128,28,45,30,25,103
67693,46,35,0,0,11,35
67694,23,8,9,2,4,19
67695,58,15,23,7,13,45
67696,280,160,29,33,58,222
67697,62,21,22,5,14,48
67698,39,27,1,1,10,29
67699,165,71,52,10,32,133
67700,8,2,2,4,0,8
67701,5,1,4,0,0,5
67702,35,22,4,4,5,30
67703,22,15,2,0,5,17
67704,220,123,55,0,42,178
67705,86,56,16,0,14,72
67706,68,38,14,2,14,54
67707,175,57,55,26,37,138
67708,51,17,24,4,6,45
67709,44,15,18,0,11,33
67710,417,120,185,16,96,321
67711,82,35,31,1,15,67
67712,75,23,38,0,14,61
67713,82,35,8,25,14,68
67714,213,92,63,20,38,175
67715,257,68,127,4,58,199
67716,14,0,13,0,1,13
67717,127,64,40,0,23,104
67718,42,17,17,0,8,34
67719,37,12,14,0,11,26
67720,11,5,3,1,2,9
67721,67,34,15,0,18,49
67722,645,382,136,18,109,536
67723,74,40,15,2,17,57
67724,51,16,24,2,9,42
67725,28,16,8,0,4,24
67726,77,17,43,1,16,61
67727,105,53,19,2,31,74
67728,78,45,15,4,14,64
67729,174,72,38,20,44,130
67730,20,9,6,1,4,16
67731,90,55,20,4,11,79
67732,61,35,18,2,6,55
67733,142,56,30,25,31,111
67734,186,75,44,22,45,141
67735,75,39,26,0,10,65
67736,11,5,4,0,2,9
67737,38,23,9,0,6,32
67738,31,15,10,1,5,26
67739,45,7,27,4,7,38
67740,15,5,5,0,5,10
67741,35,3,24,0,8,27
67742,183,82,63,2,36,147
67743,76,40,13,9,14,62
67744,38,3,29,2,4,34
67745,8,6,1,0,1,7
67746,69,19,28,2,20,49
67747,55,34,10,0,11,44
67748,135,55,40,15,25,110
67749,14,0,10,0,4,10
67750,112,48,14,17,33,79
67751,89,33,36,1,19,70
67752,53,28,6,5,14,39
67753,193,89,47,20,37,156
67754,291,83,136,6,66,225
67755,54,29,6,5,14,40
67756,33,9,12,9,3,30
67757,107,33,55,0,19,88
67758,2,0,2,0,0,2
67759,57,11,8,27,11,46
67760,32,21,9,0,2,30
67761,140,44,52,12,32,108
67762,74,56,8,0,10,64
67763,50,27,13,2,8,42
67764,91,23,51,2,15,76
67765,6,4,0,0,2,4
67766,44,9,24,0,11,33
67767,9,6,2,1,0,9
67768,18,6,4,3,5,13
67769,149,63,32,21,33,116
67770,62,41,12,1,8,54
67771,177,101,32,0,44,133
67772,44,25,8,2,9,35
67773,610,374,108,8,120,490
67774,244,169,27,6,42,202
67775,25,5,1,16,3,22
67776,205,87,43,27,48,157
67777,380,224,79,17,60,320
67778,66,26,19,6,15,51
67779,19,1,13,3,2,17
67780,11,8,0,0,3,8
67781,351,159,87,36,69,282
67782,140,85,29,0,26,114
67783,38,9,20,0,9,29
67784,57,30,18,0,9,48
67785,342,147,120,6,69,273
67786,57,34,2,3,18,39
67787,22,5,11,0,6,16
67788,63,20,12,22,9,54
67789,99,46,36,4,13,86
67790,5,3,0,0,2,3
67791,78,40,16,5,17,61
67792,35,28,0,0,7,28
67793,71,39,10,10,12,59
67794,423,313,20,0,90,333
67795,40,4,25,1,10,30
67796,94,37,24,15,18,76
67797,37,5,20,5,7,30
67798,33,9,17,0,7,26
67799,19,10,6,1,2,17
67800,8,4,2,2,0,8
67801,72,51,5,5,11,61
67802,29,6,14,3,6,23
67803,18,6,1,7,4,14
67804,2,0,2,0,0,2
67805,468,216,156,12,84,384
67806,63,37,20,0,6,57
67807,266,185,18,4,59,207
67808,105,83,8,0,14,91
67809,156,76,49,1,30,126
67810,30,2,22,1,5,25
67811,212,157,14,0,41,171
67812,24,18,2,0,4,20
67813,39,19,13,2,5,34
67814,204,85,34,38,47,157
67815,388,204,98,8,78,310
67816,88,68,1,0,19,69
67817,32,9,19,0,4,28
67818,20,16,0,0,4,16
67819,145,14,99,2,30,115
67820,21,7,6,2,6,15
67821,70,29,21,3,17,53
67822,24,5,14,0,5,19
67823,70,33,27,0,10,60
67824,58,16,33,1,8,50
67825,109,59,25,4,21,88
67826,17,1,14,0,2,15
67827,76,26,22,12,16,60
67828,361,158,125,11,67,294
67829,79,51,16,0,12,67
67830,15,7,5,0,3,12
67831,43,4,31,2,6,37
67832,55,24,19,2,10,45
67833,174,123,14,2,35,139
67834,32,15,11,2,4,28
67835,215,101,83,5,26,189
67836,58,27,19,0,12,46
67837,97,25,57,2,13,84
67838,110,66,28,8,8,102
67839,628,395,92,8,133,495
67840,61,40,8,0,13,48
67841,130,36,64,3,27,103
67842,43,4,29,2,8,35
67843,67,13,38,1,15,52
67844,222,75,83,15,49,173
67845,34,16,5,3,10,24
67846,206,19,148,2,37,169
67847,110,65,19,7,19,91
67848,210,61,98,6,45,165
67849,168,69,62,7,30,138
67850,42,6,30,0,6,36
67851,86,56,12,10,8,78
67852,327,90,156,6,75,252
67853,52,21,14,3,14,38
67854,25,17,3,1,4,21
67855,15,13,1,0,1,14
67856,22,3,14,2,3,19
67857,23,10,2,5,6,17
67858,112,33,58,0,21,91
67859,16,5,3,4,4,12
67860,172,70,51,7,44,128
67861,173,84,54,3,32,141
67862,16,6,1,3,6,10
67863,22,7,8,2,5,17
67864,5,3,0,0,2,3
67865,114,68,17,3,26,88
67866,68,44,11,5,8,60
67867,48,11,30,0,7,41
67868,1,1,0,0,0,1
67869,51,36,6,1,8,43
67870,17,2,5,2,8,9
67871,496,260,89,50,97,399
67872,33,14,14,2,3,30
67873,41,30,0,0,11,30
67874,591,341,122,18,110,481
67875,161,72,52,6,31,130
67876,26,8,5,5,8,18
67877,126,72,21,6,27,99
67878,106,80,7,0,19,87
67879,48,13,23,0,12,36
67880,399,232,88,0,79,320
67881,25,9,12,0,4,21
67882,54,13,28,0,13,41
67883,39,2,19,13,5,34
67884,19,5,8,0,6,13
67885,43,35,1,0,7,36
67886,273,83,132,14,44,229
67887,25,15,7,0,3,22
67888,69,40,13,2,14,55
67889,46,18,20,0,8,38
67890,4,2,1,0,1,3
67891,50,35,6,1,8,42
67892,55,40,2,1,12,43
67893,58,28,15,0,15,43
67894,76,39,17,2,18,58
67895,149,112,9,0,28,121
67896,33,0,28,0,5,28
67897,342,147,120,6,69,273
67898,545,282,108,44,111,434
67899,10,0,8,1,1,9
67900,32,16,12,0,4,28
67901,42,23,10,3,6,36
67902,213,88,43,28,54,159
67903,49,10,29,1,9,40
67904,85,35,9,22,19,66
67905,32,5,17,0,10,22
67906,346,168,99,14,65,281
67907,18,5,12,0,1,17
67908,545,343,88,5,109,436
67909,15,1,13,0,1,14
67910,32,21,9,0,2,30
67911,15,1,9,0,5,10
67912,14,9,3,0,2,12
67913,201,22,141,2,36,165
67914,40,9,5,19,7,33
67915,292,37,200,2,53,239
67916,17,6,8,0,3,14
67917,62,29,24,0,9,53
67918,19,4,11,0,4,15
67919,35,18,16,0,1,34
67920,64,41,13,1,9,55
67921,8,1,6,0,1,7
67922,48,26,18,0,4,44
67923,395,227,88,0,80,315
67924,443,255,84,12,92,351
67925,45,19,9,6,11,34
67926,1266,508,171,336,251,1015
67927,270,17,202,2,49,221
67928,29,14,12,0,3,26
67929,119,90,8,0,21,98
67930,51,32,6,0,13,38
67931,67,39,3,13,12,55
67932,19,6,12,0,1,18
67933,89,43,30,1,15,74
67934,27,12,14,0,1,26
67935,43,17,22,1,3,40
67936,65,46,4,1,14,51
67937,435,321,20,0,94,341
67938,45,12,21,0,12,33
67939,17,11,3,0,3,14
67940,78,45,18,2,13,65
67941,25,9,11,0,5,20
67942,94,53,26,0,15,79
67943,75,45,9,8,13,62
67944,515,291,77,46,101,414
67945,660,380,154,20,106,554
67946,21,8,9,0,4,17
67947,174,53,88,0,33,141
67948,32,12,6,7,7,25
67949,25,13,6,0,6,19
67950,79,58,4,2,15,64
67951,104,19,64,1,20,84
67952,296,155,97,0,44,252
67953,39,14,21,1,3,36
67954,13,7,2,2,2,11
67955,199,134,13,13,39,160
67956,128,33,48,16,31,97
67957,36,17,10,0,9,27
67958,52,1,39,2,10,42
67959,77,24,37,0,16,61
67960,245,188,13,0,44,201
67961,97,46,15,12,24,73
67962,77,46,17,2,12,65
67963,32,21,9,0,2,30
67964,49,33,6,2,8,41
67965,44,34,2,0,8,36
67966,33,20,8,1,4,29
67967,53,30,17,0,6,47
67968,102,46,29,1,26,76
67969,31,9,9,10,3,28
67970,30,8,15,0,7,23
67971,62,19,35,1,7,55
67972,22,4,16,0,2,20
67973,126,75,21,3,27,99
67974,38,22,7,0,9,29
67975,95,27,39,3,26,69
67976,22,9,3,3,7,15
67977,115,87,4,2,22,93
67978,314,152,105,2,55,259
67979,12,7,3,0,2,10
67980,32,16,3,6,7,25
67981,106,38,40,6,22,84
67982,4,2,2,0,0,4
67983,54,25,20,2,7,47
67984,72,31,17,6,18,54
67985,340,142,126,6,66,274
67986,60,24,23,0,13,47
67987,40,22,12,1,5,35
67988,88,19,44,5,20,68
67989,424,118,195,10,101,323
67990,32,21,9,0,2,30
67991,378,195,100,19,64,314
67992,45,11,17,6,11,34
67993,24,3,20,0,1,23
67994,9,6,3,0,0,9
67995,54,0,35,3,16,38
67996,254,49,156,2,47,207
67997,85,40,26,0,19,66
67998,94,29,49,0,16,78
67999,76,43,19,0,14,62
68000,16,4,8,1,3,13
68001,35,17,9,2,7,28
68002,29,2,20,2,5,24
68003,39,4,24,0,11,28
68004,81,46,11,6,18,63
68005,7,4,2,0,1,6
68006,36,13,17,0,6,30
68007,157,76,25,26,30,127
68008,54,17,17,10,10,44
68009,49,24,11,5,9,40
68010,200,54,51,57,38,162
68011,111,37,39,10,25,86
68012,5,1,3,0,1,4
68013,29,2,22,1,4,25
68014,212,114,48,0,50,162
68015,37,7,25,1,4,33
68016,40,12,12,7,9,31
68017,113,38,28,21,26,87
68018,38,22,3,0,13,25
68019,100,41,42,1,16,84
68020,595,342,124,17,112,483
68021,165,63,57,21,24,141
68022,90,29,34,11,16,74
68023,127,75,22,3,27,100
68024,17,7,7,0,3,14
68025,171,87,41,0,43,128
68026,80,54,11,1,14,66
68027,427,124,162,47,94,333
68028,109,46,43,4,16,93
68029,147,37,76,1,33,114
68030,92,27,37,8,20,72
68031,20,0,14,0,6,14
68032,272,119,86,20,47,225
68033,83,27,32,6,18,65
68034,70,36,19,4,11,59
68035,468,290,67,7,104,364
68036,146,59,45,9,33,113
68037,34,6,21,0,7,27
68038,639,374,139,15,111,528
68039,236,96,14,83,43,193
68040,35,25,5,0,5,30
68041,690,398,158,23,111,579
68042,24,10,7,3,4,20
68043,272,107,110,7,48,224
68044,147,53,43,22,29,118
68045,96,51,31,2,12,84
68046,124,41,33,28,22,102
68047,204,136,22,0,46,158
68048,47,23,13,4,7,40
68049,30,11,5,8,6,24
68050,95,26,50,0,19,76
68051,125,28,59,16,22,103
68052,180,123,19,0,38,142
68053,112,96,2,0,14,98
68054,49,14,16,12,7,42
68055,157,66,32,24,35,122
68056,262,156,46,8,52,210
68057,16,4,10,0,2,14
68058,77,13,49,0,15,62
68059,23,15,2,0,6,17
68060,102,56,28,0,18,84
68061,75,30,23,8,14,61
68062,46,18,20,0,8,38
68063,113,42,26,25,20,93
68064,18,9,4,1,4,14
68065,134,47,65,0,22,112
68066,45,24,12,1,8,37
68067,467,344,26,1,96,371
68068,97,56,14,2,25,72
68069,43,28,8,1,6,37
68070,63,20,23,0,20,43
68071,40,32,2,1,5,35
68072,232,141,40,6,45,187
68073,33,10,7,10,6,27
68074,81,33,24,9,15,66
68075,54,35,10,0,9,45
68076,40,10,20,0,10,30
68077,32,19,6,0,7,25
68078,53,0,34,3,16,37
68079,171,114,27,1,29,142
68080,60,25,24,1,10,50
68081,134,101,6,0,27,107
68082,402,228,92,0,82,320
68083,6,4,1,0,1,5
68084,142,86,30,0,26,116
68085,36,15,9,4,8,28
68086,51,26,13,1,11,40
68087,7,1,3,0,3,4
68088,68,35,24,2,7,61
68089,61,34,13,0,14,47
68090,81,20,36,9,16,65
68091,27,14,8,1,4,23
68092,152,76,27,16,33,119
68093,36,18,16,1,1,35
68094,561,329,123,15,94,467
68095,31,13,10,0,8,23
68096,69,11,44,0,14,55
68097,6,2,3,0,1,5
68098,33,9,17,0,7,26
68099,19,7,8,0,4,15
68100,66,21,18,14,13,53
68101,73,44,14,2,13,60
68102,72,18,40,2,12,60
68103,32,21,9,0,2,30
68104,60,36,13,0,11,49
68105,108,54,31,2,21,87
68106,114,47,25,21,21,93
68107,32,2,25,0,5,27
68108,166,64,47,26,29,137
68109,508,286,75,44,103,405
68110,198,101,35,24,38,160
68111,94,35,27,4,28,66
68112,7,5,1,0,1,6
68113,117,54,24,15,24,93
68114,58,37,11,0,10,48
68115,35,16,6,7,6,29
68116,204,89,58,20,37,167
68117,56,36,8,2,10,46
68118,19,0,11,0,8,11
68119,42,36,2,0,4,38
68120,46,18,20,0,8,38
68121,14,4,8,0,2,12
68122,76,28,24,5,19,57
68123,35,12,12,1,10,25
68124,161,49,87,4,21,140
68125,6,0,4,0,2,4
68126,30,13,9,0,8,22
68127,454,245,114,21,74,380
68128,150,22,100,1,27,123
68129,145,14,99,2,30,115
68130,37,12,16,1,8,29
68131,32,21,9,0,2,30
68132,133,6,70,28,29,104
68133,21,14,3,0,4,17
68134,6,0,3,1,2,4
68135,72,39,15,2,16,56
68136,26,6,16,0,4,22
68137,37,7,22,2,6,31
68138,21,6,9,0,6,15
68139,176,76,32,21,47,129
68140,46,18,20,0,8,38
68141,52,24,11,7,10,42
68142,55,34,10,0,11,44
68143,130,56,41,0,33,97
68144,319,137,85,35,62,257
68145,87,36,35,2,14,73
68146,223,150,33,0,40,183
68147,22,4,5,6,7,15
68148,46,18,20,0,8,38
68149,162,69,57,16,20,142
68150,146,83,27,1,35,111
68151,95,59,21,2,13,82
68152,129,40,49,20,20,109
68153,51,3,39,0,9,42
68154,197,113,43,7,34,163
68155,69,20,34,1,14,55
68156,33,25,5,0,3,30
68157,137,49,34,20,34,103
68158,615,352,145,17,101,514
68159,51,16,25,3,7,44
68160,84,47,3,17,17,67
68161,38,5,26,0,7,31
68162,2,0,1,0,1,1
68163,7,1,3,0,3,4
68164,51,6,32,0,13,38
68165,141,57,44,9,31,110
68166,6,2,2,0,2,4
68167,180,123,18,0,39,141
68168,38,28,2,0,8,30
68169,152,77,38,0,37,115
68170,491,269,78,41,103,388
68171,117,24,62,0,31,86
68172,80,56,6,0,18,62
68173,106,67,29,0,10,96
68174,28,12,7,3,6,22
68175,34,19,9,0,6,28
68176,30,1,25,0,4,26
68177,6,1,5,0,0,6
68178,92,29,33,12,18,74
68179,80,21,38,8,13,67
68180,32,23,4,0,5,27
68181,82,20,33,13,16,66
68182,138,68,38,5,27,111
68183,9,4,4,0,1,8
68184,51,16,7,20,8,43
68185,42,9,22,5,6,36
68186,65,34,4,13,14,51
68187,180,72,56,7,45,135
68188,97,43,24,5,25,72
68189,94,50,13,17,14,80
68190,33,26,2,0,5,28
68191,17,4,7,2,4,13
68192,183,102,34,1,46,137
68193,578,413,45,1,119,459
68194,138,51,30,23,34,104
68195,240,73,115,2,50,190
68196,78,40,16,5,17,61
68197,44,31,4,1,8,36
68198,27,16,5,4,2,25
68199,409,136,167,19,87,322
68200,55,13,17,14,11,44
68201,44,11,23,1,9,35
68202,193,124,33,1,35,158
68203,140,25,60,24,31,109
68204,81,38,12,10,21,60
68205,9,6,0,1,2,7
68206,145,89,30,0,26,119
68207,74,28,30,2,14,60
68208,35,6,21,0,8,27
68209,40,31,1,2,6,34
68210,342,145,121,6,70,272
68211,32,21,9,0,2,30
68212,101,68,1,12,20,81
68213,68,39,9,7,13,55
68214,97,37,20,12,28,69
68215,14,7,4,0,3,11
68216,49,33,6,2,8,41
68217,27,7,12,0,8,19
68218,225,75,85,15,50,175
68219,107,54,27,4,22,85
68220,3,0,2,0,1,2
68221,11,5,5,0,1,10
68222,465,218,144,12,91,374
68223,299,156,85,0,58,241
68224,68,31,20,2,15,53
68225,18,6,7,1,4,14
68226,204,105,34,31,34,170
68227,32,21,9,0,2,30
68228,122,48,39,15,20,102
68229,91,21,45,3,22,69
68230,51,36,6,2,7,44
68231,26,14,8,0,4,22
68232,78,28,34,0,16,62
68233,166,12,94,28,32,134
68234,39,7,21,3,8,31
68235,93,19,32,24,18,75
68236,86,55,17,0,14,72
68237,62,27,16,3,16,46
68238,11,4,3,0,4,7
68239,197,105,50,8,34,163
68240,21,6,10,0,5,16
68241,63,11,38,0,14,49
68242,86,41,22,1,22,64
68243,54,12,16,15,11,43
68244,193,141,14,1,37,156
68245,7,5,1,0,1,6
68246,21,9,6,0,6,15
68247,46,18,13,6,9,37
68248,31,9,18,0,4,27
68249,76,5,55,1,15,61
68250,149,58,40,16,35,114
68251,5,4,0,1,0,5
68252,45,18,20,0,7,38
68253,72,40,11,4,17,55
68254,46,18,20,0,8,38
68255,556,397,44,1,114,442
68256,74,57,6,1,10,64
68257,78,36,15,10,17,61
68258,44,31,3,3,7,37
68259,32,21,9,0,2,30
68260,234,101,77,16,40,194
68261,139,84,30,0,25,114
68262,7,1,4,1,1,6
68263,44,23,11,0,10,34
68264,12,5,3,1,3,9
68265,17,5,7,0,5,12
68266,66,30,20,2,14,52
68267,30,11,12,3,4,26
68268,91,27,25,21,18,73
68269,179,103,32,0,44,135
68270,177,31,76,27,43,134
68271,84,26,40,4,14,70
68272,180,91,48,6,35,145
68273,38,21,12,0,5,33
68274,31,7,13,3,8,23
68275,54,35,5,0,14,40
68276,114,54,26,2,32,82
68277,197,132,21,0,44,153
68278,212,116,65,0,31,181
68279,5,4,0,1,0,5
68280,83,32,12,13,26,57
68281,57,22,18,5,12,45
68282,139,52,50,14,23,116
68283,55,46,0,0,9,46
68284,224,123,50,0,51,173
68285,53,43,0,0,10,43
68286,475,218,158,13,86,389
68287,39,31,0,0,8,31
68288,88,45,25,2,16,72
68289,11,7,0,0,4,7
68290,61,11,35,1,14,47
68291,19,0,11,0,8,11
68292,9,6,2,0,1,8
68293,233,156,32,0,45,188
68294,21,7,9,0,5,16
68295,46,18,20,0,8,38
68296,44,8,25,3,8,36
68297,57,23,25,0,9,48
68298,78,38,19,5,16,62
68299,130,38,67,0,25,105
68300,78,12,51,0,15,63
68301,251,186,13,1,51,200
68302,86,66,1,0,19,67
68303,46,18,20,0,8,38
68304,54,26,3,12,13,41
68305,252,183,13,3,53,199
68306,147,63,32,18,34,113
68307,66,36,14,0,16,50
68308,64,47,1,0,16,48
68309,52,26,16,1,9,43
68310,35,17,10,3,5,30
68311,10,7,1,0,2,8
68312,76,26,31,10,9,67
68313,37,15,15,0,7,30
68314,152,54,38,30,30,122
68315,24,4,13,2,5,19
68316,72,36,26,0,10,62
68317,20,7,8,3,2,18
68318,30,6,15,2,7,23
68319,114,57,31,5,21,93
68320,155,80,45,1,29,126
68321,465,232,115,20,98,367
68322,65,37,14,4,10,55
68323,602,415,57,1,129,473
68324,66,36,22,0,8,58
68325,173,84,24,25,40,133
68326,18,14,0,0,4,14
68327,90,33,5,40,12,78
68328,4,3,1,0,0,4
68329,42,10,11,9,12,30
68330,83,43,20,1,19,64
68331,111,86,5,0,20,91
68332,32,15,7,1,9,23
68333,192,129,21,0,42,150
68334,438,203,150,9,76,362
68335,16,9,4,0,3,13
68336,645,380,140,15,110,535
68337,23,15,3,3,2,21
68338,33,17,9,1,6,27
68339,13,3,7,0,3,10
68340,3,1,1,1,0,3
68341,22,7,10,1,4,18
68342,14,4,8,0,2,12
68343,35,22,4,4,5,30
68344,44,33,3,0,8,36
68345,32,21,9,0,2,30
68346,133,36,49,16,32,101
68347,142,112,6,0,24,118
68348,46,18,20,0,8,38
68349,21,13,5,0,3,18
68350,32,21,9,0,2,30
68351,83,40,25,2,16,67
68352,52,13,17,11,11,41
68353,271,153,53,16,49,222
68354,47,40,3,0,4,43
68355,64,19,26,6,13,51
68356,22,11,9,1,1,21
68357,390,111,182,7,90,300
68358,85,25,23,20,17,68
68359,80,47,17,2,14,66
68360,44,24,11,0,9,35
68361,37,17,14,0,6,31
68362,58,27,19,0,12,46
68363,42,24,7,4,7,35
68364,98,32,39,11,16,82
68365,226,77,85,15,49,177
68366,76,53,10,0,13,63
68367,36,23,8,3,2,34
68368,246,182,12,1,51,195
68369,67,46,7,0,14,53
68370,112,24,50,14,24,88
68371,64,27,22,4,11,53
68372,34,17,10,1,6,28
68373,248,77,120,12,39,209
68374,37,23,6,1,7,30
68375,22,8,8,2,4,18
68376,17,1,11,0,5,12
68377,125,28,57,18,22,103
68378,38,10,18,2,8,30
68379,121,46,35,15,25,96
68380,227,52,32,105,38,189
68381,80,30,20,11,19,61
68382,476,129,202,39,106,370
68383,67,23,27,2,15,52
68384,23,6,9,0,8,15
68385,47,22,14,2,9,38
68386,61,22,23,6,10,51
68387,70,40,13,2,15,55
68388,38,15,17,1,5,33
68389,36,14,11,3,8,28
68390,86,32,27,10,17,69
68391,44,6,30,0,8,36
68392,84,64,1,0,19,65
68393,48,22,16,3,7,41
68394,55,28,10,8,9,46
68395,58,14,34,1,9,49
68396,82,33,32,0,17,65
68397,105,54,13,12,26,79
68398,94,51,20,3,20,74
68399,21,12,9,0,0,21
68400,46,18,20,0,8,38
68401,47,3,9,28,7,40
68402,62,41,6,0,15,47
68403,326,139,130,5,52,274
68404,162,100,26,4,32,130
68405,17,8,6,0,3,14
68406,4,2,2,0,0,4
68407,55,30,13,0,12,43
68408,280,175,43,0,62,218
68409,339,164,112,1,62,277
68410,61,15,31,1,14,47
68411,23,10,10,1,2,21
68412,67,46,7,0,14,53
68413,8,2,5,0,1,7
68414,37,14,11,0,12,25
68415,47,25,11,2,9,38
68416,39,11,24,0,4,35
68417,59,37,14,0,8,51
68418,21,7,6,2,6,15
68419,150,40,72,4,34,116
68420,169,83,55,5,26,143
68421,34,15,11,0,8,26
68422,124,67,23,4,30,94
68423,49,28,12,0,9,40
68424,12,6,4,1,1,11
68425,234,165,52,3,14,220
68426,136,72,41,0,23,113
68427,90,68,16,2,4,86
68428,17,9,7,1,0,17
68429,162,111,26,0,25,137
68430,63,42,11,0,10,53
68431,50,31,9,2,8,42
68432,177,51,46,45,35,142
68433,48,18,17,1,12,36
68434,109,43,34,13,19,90
68435,246,103,15,82,46,200
68436,23,3,11,4,5,18
68437,24,9,6,1,8,16
68438,50,5,34,0,11,39
68439,26,1,21,1,3,23
68440,64,42,5,0,17,47
68441,10,1,6,0,3,7
68442,30,14,13,0,3,27
68443,182,102,33,1,46,136
68444,417,159,138,29,91,326
68445,41,24,8,2,7,34
68446,20,0,15,0,5,15
68447,307,83,145,6,73,234
68448,13,8,2,0,3,10
68449,369,210,82,0,77,292
68450,56,25,12,6,13,43
68451,23,14,2,2,5,18
68452,210,53,87,16,54,156
68453,43,19,13,2,9,34
68454,94,59,12,2,21,73
68455,197,55,53,50,39,158
68456,587,430,39,1,117,470
68457,35,17,10,1,7,28
68458,12,4,6,0,2,10
68459,91,57,19,4,11,80
68460,39,26,5,0,8,31
68461,74,46,17,0,11,63
68462,53,32,10,2,9,44
68463,39,11,24,0,4,35
68464,52,19,24,0,9,43
68465,88,31,23,11,23,65
68466,20,3,13,0,4,16
68467,52,29,7,4,12,40
68468,180,119,15,11,35,145
68469,122,55,18,18,31,91
68470,19,8,4,0,7,12
68471,99,86,3,0,10,89
68472,151,23,69,23,36,115
68473,93,51,19,6,17,76
68474,68,40,14,3,11,57
68475,55,15,21,10,9,46
68476,11,1,5,0,5,6
68477,64,25,24,4,11,53
68478,184,121,28,5,30,154
68479,52,9,24,6,13,39
68480,39,10,17,0,12,27
68481,52,2,32,13,5,47
68482,148,109,5,1,33,115
68483,58,29,18,0,11,47
68484,29,2,22,1,4,25
68485,22,4,14,0,4,18
68486,16,9,4,0,3,13
68487,40,30,1,0,9,31
68488,11,3,4,0,4,7
68489,398,134,158,16,90,308
68490,149,63,28,29,29,120
68491,429,199,145,9,76,353
68492,49,26,6,8,9,40
68493,267,48,164,4,51,216
68494,50,11,31,0,8,42
68495,42,31,8,0,3,39
68496,54,33,14,0,7,47
68497,35,0,30,0,5,30
68498,299,186,48,0,65,234
68499,47,22,12,0,13,34
68500,78,44,3,17,14,64
68501,494,262,114,14,104,390
68502,35,8,19,0,8,27
68503,88,67,5,4,12,76
68504,21,10,6,2,3,18
68505,51,11,32,0,8,43
68506,13,2,8,0,3,10
68507,71,21,33,2,15,56
68508,32,21,9,0,2,30
68509,11,1,7,0,3,8
68510,154,59,39,22,34,120
68511,31,15,7,0,9,22
68512,24,13,6,0,5,19
68513,22,3,0,11,8,14
68514,78,16,39,10,13,65
68515,11,6,0,2,3,8
68516,57,17,25,4,11,46
68517,200,110,40,14,36,164
68518,80,37,23,3,17,63
68519,15,0,12,0,3,12
68520,450,221,90,43,96,354
68521,618,401,80,5,132,486
68522,49,16,26,0,7,42
68523,17,6,10,0,1,16
68524,136,109,4,1,22,114
68525,28,5,6,10,7,21
68526,123,63,14,20,26,97
68527,50,23,21,0,6,44
68528,196,101,36,26,33,163
68529,54,27,3,15,9,45
68530,19,9,9,0,1,18
68531,7,1,3,0,3,4
68532,101,32,58,0,11,90
68533,128,46,46,8,28,100
68534,71,32,17,8,14,57
68535,127,88,12,2,25,102
68536,51,20,5,17,9,42
68537,57,13,28,2,14,43
68538,35,2,26,0,7,28
68539,43,12,22,0,9,34
68540,32,26,1,0,5,27
68541,91,49,25,0,17,74
68542,73,36,21,0,16,57
68543,48,17,10,5,16,32
68544,12,0,10,0,2,10
68545,18,8,8,0,2,16
68546,65,43,7,1,14,51
68547,60,32,9,0,19,41
68548,52,19,16,3,14,38
68549,1,1,0,0,0,1
68550,123,43,46,8,26,97
68551,32,21,9,0,2,30
68552,22,5,10,0,7,15
68553,107,32,54,1,20,87
68554,55,21,16,5,13,42
68555,150,53,36,30,31,119
68556,48,22,10,7,9,39
68557,43,19,9,6,9,34
68558,62,23,21,1,17,45
68559,463,138,190,37,98,365
68560,161,95,37,1,28,133
68561,23,12,2,3,6,17
68562,39,15,17,1,6,33
68563,48,26,14,2,6,42
68564,66,33,19,0,14,52
68565,232,127,52,15,38,194
68566,32,13,15,0,4,28
68567,8,3,1,3,1,7
68568,470,326,43,1,100,370
68569,195,79,51,24,41,154
68570,48,30,8,0,10,38
68571,41,8,26,0,7,34
68572,22,3,14,0,5,17
68573,40,18,13,1,8,32
68574,82,56,7,1,18,64
68575,33,23,3,3,4,29
68576,14,0,10,0,4,10
68577,286,138,73,19,56,230
68578,164,55,74,0,35,129
68579,89,46,25,0,18,71
68580,354,194,89,15,56,298
68581,36,16,11,0,9,27
68582,51,21,5,18,7,44
68583,467,213,160,10,84,383
68584,193,89,47,20,37,156
68585,26,8,13,0,5,21
68586,95,60,19,2,14,81
68587,25,6,15,0,4,21
68588,55,0,36,3,16,39
68589,246,49,153,1,43,203
68590,248,115,74,17,42,206
68591,54,36,11,0,7,47
68592,55,23,14,3,15,40
68593,32,17,6,1,8,24
68594,45,20,15,0,10,35
68595,5,0,2,1,2,3
68596,341,200,69,0,72,269
68597,49,14,25,0,10,39
68598,46,18,20,0,8,38
68599,28,6,17,0,5,23
68600,24,10,5,1,8,16
68601,9,4,4,1,0,9
68602,70,45,9,0,16,54
68603,44,14,18,0,12,32
68604,155,44,85,4,22,133
68605,5,0,4,1,0,5
68606,55,36,7,0,12,43
68607,51,26,6,5,14,37
68608,64,17,26,0,21,43
68609,95,49,32,2,12,83
68610,60,39,6,0,15,45
68611,40,23,7,4,6,34
68612,13,7,2,2,2,11
68613,103,68,1,13,21,82
68614,135,103,4,2,26,109
68615,114,44,34,18,18,96
68616,143,58,36,19,30,113
68617,59,38,8,0,13,46
68618,106,44,13,29,20,86
68619,16,3,6,1,6,10
68620,53,12,12,21,8,45
68621,94,52,30,7,5,89
68622,134,92,18,1,23,111
68623,19,6,5,2,6,13
68624,46,28,9,4,5,41
68625,33,18,7,1,7,26
68626,60,18,25,7,10,50
68627,251,31,169,2,49,202
68628,46,9,17,11,9,37
68629,114,28,34,22,30,84
68630,134,40,37,23,34,100
68631,60,31,6,5,18,42
68632,168,120,34,2,12,156
68633,32,21,9,0,2,30
68634,126,100,3,0,23,103
68635,62,18,33,3,8,54
68636,57,6,36,1,14,43
68637,203,96,70,1,36,167
68638,42,23,15,0,4,38
68639,9,4,5,0,0,9
68640,100,31,42,6,21,79
68641,108,40,30,14,24,84
68642,61,42,2,2,15,46
68643,182,120,12,11,39,143
68644,30,8,11,0,11,19
68645,65,30,16,5,14,51
68646,23,4,10,4,5,18
68647,36,25,5,1,5,31
68648,38,8,22,1,7,31
68649,287,160,80,0,47,240
68650,156,73,44,0,39,117
68651,68,45,12,0,11,57
68652,93,32,26,9,26,67
68653,80,34,21,12,13,67
68654,15,2,8,0,5,10
68655,56,13,29,1,13,43
68656,109,63,19,2,25,84
68657,5,1,1,1,2,3
68658,97,25,57,2,13,84
68659,110,48,31,8,23,87
68660,356,163,119,6,68,288
68661,110,48,22,15,25,85
68662,80,37,24,3,16,64
68663,109,31,61,0,17,92
68664,84,37,25,0,22,62
68665,98,74,4,2,18,80
68666,60,21,27,3,9,51
68667,97,45,30,3,19,78
68668,288,153,71,17,47,241
68669,117,78,24,3,12,105
68670,48,28,11,0,9,39
68671,44,1,39,0,4,40
68672,127,47,46,8,26,101
68673,12,6,3,0,3,9
68674,62,42,7,0,13,49
68675,74,30,24,7,13,61
68676,119,24,64,1,30,89
68677,276,174,42,0,60,216
68678,12,5,5,1,1,11
68679,76,25,31,8,12,64
68680,196,112,21,27,36,160
68681,448,115,189,46,98,350
68682,25,7,9,3,6,19
68683,24,14,2,1,7,17
68684,5,0,4,0,1,4
68685,30,12,13,0,5,25
68686,22,11,3,0,8,14
68687,50,10,28,1,11,39
68688,45,36,1,0,8,37
68689,84,37,25,0,22,62
68690,64,34,16,1,13,51
68691,66,38,15,0,13,53
68692,31,22,2,0,7,24
68693,136,73,33,0,30,106
68694,76,5,24,37,10,66
68695,73,47,11,2,13,60
68696,212,68,85,10,49,163
68697,31,6,14,5,6,25
68698,25,16,4,1,4,21
68699,105,50,16,13,26,79
68700,46,18,20,0,8,38
68701,198,129,50,4,15,183
68702,51,23,14,4,10,41
68703,8,1,6,0,1,7
68704,58,37,9,1,11,47
68705,35,19,7,3,6,29
68706,29,10,11,2,6,23
68707,32,21,9,0,2,30
68708,31,18,4,0,9,22
68709,446,223,115,14,94,352
68710,123,43,31,21,28,95
68711,194,108,28,20,38,156
68712,180,138,16,1,25,155
68713,21,9,9,0,3,18
68714,358,164,120,6,68,290
68715,178,128,21,1,28,150
68716,93,66,7,0,20,73
68717,70,46,8,2,14,56
68718,443,141,187,15,100,343
68719,58,33,11,0,14,44
68720,109,38,42,11,18,91
68721,56,24,20,0,12,44
68722,5,3,0,0,2,3
68723,144,73,37,0,34,110
68724,32,21,9,0,2,30
68725,139,52,40,19,28,111
68726,81,25,37,8,11,70
68727,57,15,29,2,11,46
68728,8,2,0,5,1,7
68729,12,7,2,0,3,9
68730,220,150,30,0,40,180
68731,36,11,18,0,7,29
68732,135,62,38,0,35,100
68733,28,19,4,0,5,23
68734,55,39,6,1,9,46
68735,17,8,6,1,2,15
68736,87,52,18,0,17,70
68737,10,5,3,1,1,9
68738,46,20,10,8,8,38
68739,74,29,30,1,14,60
68740,11,2,5,1,3,8
68741,148,20,75,25,28,120
68742,46,18,20,0,8,38
68743,52,20,19,0,13,39
68744,63,42,4,0,17,46
68745,63,32,16,5,10,53
68746,116,48,16,18,34,82
68747,20,7,9,1,3,17
68748,34,17,7,3,7,27
68749,71,35,25,1,10,61
68750,49,13,20,5,11,38
68751,42,13,13,8,8,34
68752,31,10,14,4,3,28
68753,51,27,8,0,16,35
68754,27,15,2,4,6,21
68755,440,143,178,20,99,341
68756,82,32,35,5,10,72
68757,126,53,40,0,33,93
68758,47,21,11,3,12,35
68759,8,1,5,0,2,6
68760,121,59,28,14,20,101
68761,93,20,52,2,19,74
68762,21,9,9,2,1,20
68763,26,15,3,1,7,19
68764,4,1,3,0,0,4
68765,136,55,54,7,20,116
68766,574,422,39,1,112,462
68767,462,219,144,13,86,376
68768,55,20,20,1,14,41
68769,73,35,28,1,9,64
68770,118,77,25,0,16,102
68771,20,11,5,1,3,17
68772,15,5,7,0,3,12
68773,46,18,20,0,8,38
68774,11,8,2,1,0,11
68775,50,23,16,3,8,42
68776,73,25,25,2,21,52
68777,55,39,6,1,9,46
68778,81,38,5,16,22,59
68779,151,24,99,1,27,124
68780,32,21,9,0,2,30
68781,20,8,9,0,3,17
68782,3,1,2,0,0,3
68783,31,11,10,0,10,21
68784,63,19,33,1,10,53
68785,25,10,6,1,8,17
68786,104,44,34,7,19,85
68787,44,26,8,0,10,34
68788,96,23,42,8,23,73
68789,33,25,0,0,8,25
68790,17,8,2,3,4,13
68791,96,21,45,13,17,79
68792,115,52,37,4,22,93
68793,70,30,18,9,13,57
68794,25,6,10,3,6,19
68795,175,121,15,0,39,136
68796,78,56,4,0,18,60
68797,24,10,3,8,3,21
68798,111,49,34,2,26,85
68799,34,14,10,3,7,27
68800,267,104,103,16,44,223
68801,38,18,12,1,7,31
68802,22,7,10,2,3,19
68803,228,109,85,0,34,194
68804,12,1,10,0,1,11
68805,94,52,16,0,26,68
68806,427,242,83,16,86,341
68807,50,16,24,4,6,44
68808,43,4,31,1,7,36
68809,5,0,4,0,1,4
68810,21,12,4,0,5,16
68811,602,358,126,16,102,500
68812,83,36,24,3,20,63
68813,71,20,29,0,22,49
68814,33,12,5,6,10,23
68815,231,79,89,15,48,183
68816,82,37,30,0,15,67
68817,151,24,99,1,27,124
68818,55,37,12,0,6,49
68819,128,34,43,26,25,103
68820,150,80,20,20,30,120
68821,38,25,5,2,6,32
68822,44,31,2,0,11,33
68823,200,98,60,7,35,165
68824,387,147,114,40,86,301
68825,56,3,41,1,11,45
68826,75,28,24,8,15,60
68827,133,46,51,8,28,105
68828,79,69,1,0,9,70
68829,17,6,4,1,6,11
68830,51,29,13,2,7,44
68831,46,19,11,6,10,36
68832,62,33,16,3,10,52
68833,46,18,20,0,8,38
68834,14,5,6,2,1,13
68835,361,171,100,18,72,289
68836,171,114,27,1,29,142
68837,70,35,15,4,16,54
68838,25,7,13,0,5,20
68839,107,83,8,0,16,91
68840,66,18,33,1,14,52
68841,442,216,85,50,91,351
68842,141,66,38,0,37,104
68843,68,37,14,0,17,51
68844,45,0,34,0,11,34
68845,70,40,14,1,15,55
68846,21,6,10,2,3,18
68847,13,7,3,1,2,11
68848,15,7,5,1,2,13
68849,58,2,48,1,7,51
68850,119,71,9,11,28,91
68851,9,2,4,0,3,6
68852,9,3,3,0,3,6
68853,3,0,3,0,0,3
68854,27,7,15,3,2,25
68855,25,10,13,0,2,23
68856,120,59,24,16,21,99
68857,32,21,9,0,2,30
68858,6,1,3,0,2,4
68859,53,25,23,0,5,48
68860,166,104,4,19,39,127
68861,83,15,40,9,19,64
68862,223,150,33,0,40,183
68863,149,87,27,1,34,115
68864,461,140,184,36,101,360
68865,100,47,15,24,14,86
68866,43,9,19,8,7,36
68867,139,55,44,9,31,108
68868,8,0,8,0,0,8
68869,185,120,49,2,14,171
68870,58,33,11,0,14,44
68871,280,97,126,15,42,238
68872,54,9,26,5,14,40
68873,178,87,47,14,30,148
68874,170,124,21,0,25,145
68875,110,45,9,37,19,91
68876,25,10,10,2,3,22
68877,46,18,20,0,8,38
68878,197,98,50,0,49,148
68879,33,7,21,1,4,29
68880,87,53,11,2,21,66
68881,169,70,50,6,43,126
68882,133,42,36,31,24,109
68883,281,176,43,0,62,219
68884,36,16,11,0,9,27
68885,198,110,28,23,37,161
68886,91,54,15,1,21,70
68887,199,146,15,1,37,162
68888,78,45,18,2,13,65
68889,183,103,33,1,46,137
68890,30,6,14,2,8,22
68891,94,38,33,5,18,76
68892,43,28,4,1,10,33
68893,420,119,163,47,91,329
68894,26,9,10,3,4,22
68895,197,77,37,33,50,147
68896,74,23,21,11,19,55
68897,226,76,85,15,50,176
68898,16,5,8,1,2,14
68899,32,21,9,0,2,30
68900,119,45,31,15,28,91
68901,111,46,15,17,33,78
68902,53,17,21,2,13,40
68903,41,19,11,3,8,33
68904,1,0,0,1,0,1
68905,22,4,12,0,6,16
68906,359,199,89,15,56,303
68907,10,4,4,0,2,8
68908,32,21,9,0,2,30
68909,28,21,4,0,3,25
68910,54,16,19,3,16,38
68911,122,57,35,0,30,92
68912,63,16,25,13,9,54
68913,178,87,47,14,30,148
68914,25,5,5,11,4,21
68915,44,36,2,0,6,38
68916,15,7,7,0,1,14
68917,44,24,10,4,6,38
68918,58,25,26,0,7,51
68919,26,2,19,1,4,22
68920,31,20,3,0,8,23
68921,132,69,42,0,21,111
68922,126,43,45,7,31,95
68923,38,6,4,20,8,30
68924,229,54,119,3,53,176
68925,35,11,14,5,5,30
68926,24,5,14,0,5,19
68927,133,47,29,27,30,103
68928,76,5,55,1,15,61
68929,61,28,18,1,14,47
68930,16,6,5,1,4,12
68931,126,58,32,10,26,100
68932,17,7,7,1,2,15
68933,44,16,18,3,7,37
68934,11,8,0,0,3,8
68935,51,4,39,0,8,43
68936,43,5,30,0,8,35
68937,19,4,10,0,5,14
68938,21,8,6,0,7,14
68939,39,22,7,0,10,29
68940,133,75,29,6,23,110
68941,192,153,13,1,25,167
68942,6,3,1,0,2,4
68943,82,29,28,4,21,61
68944,49,41,0,0,8,41
68945,293,34,199,4,56,237
68946,35,2,26,0,7,28
68947,17,7,7,1,2,15
68948,46,18,20,0,8,38
68949,276,142,80,9,45,231
68950,23,10,8,1,4,19
68951,60,34,17,0,9,51
68952,7,2,4,0,1,6
68953,62,15,32,7,8,54
68954,139,56,55,5,23,116
68955,46,18,20,0,8,38
68956,20,9,5,0,6,14
68957,70,23,29,6,12,58
68958,100,68,1,12,19,81
68959,57,3,39,4,11,46
68960,32,8,18,1,5,27
68961,7,2,3,2,0,7
68962,24,7,14,0,3,21
68963,48,11,21,5,11,37
68964,10,3,4,0,3,7
68965,21,7,10,0,4,17
68966,47,3,9,28,7,40
68967,211,116,48,0,47,164
68968,126,53,26,21,26,100
68969,336,179,86,18,53,283
68970,107,83,3,0,21,86
68971,137,54,44,9,30,107
68972,12,5,2,0,5,7
68973,110,55,30,6,19,91
68974,127,65,12,23,27,100
68975,62,13,32,1,16,46
68976,139,28,48,24,39,100
68977,190,89,47,17,37,153
68978,67,5,45,1,16,51
68979,53,16,28,1,8,45
68980,34,16,12,1,5,29
68981,32,5,22,0,5,27
68982,662,385,151,16,110,552
68983,333,141,124,10,58,275
68984,32,21,9,0,2,30
68985,114,46,34,8,26,88
68986,84,27,26,9,22,62
68987,16,12,3,0,1,15
68988,129,54,25,23,27,102
68989,157,64,32,30,31,126
68990,65,21,27,4,13,52
68991,55,30,13,1,11,44
68992,15,8,2,0,5,10
68993,122,67,36,1,18,104
68994,634,363,137,18,116,518
68995,29,13,10,1,5,24
68996,99,81,3,0,15,84
68997,53,26,3,15,9,44
68998,259,19,191,2,47,212
68999,146,40,10,70,26,120
69000,16,3,12,0,1,15
69001,267,144,65,0,58,209
69002,57,25,14,3,15,42
69003,27,11,13,0,3,24
69004,453,333,20,0,100,353
69005,4,3,1,0,0,4
69006,1,1,0,0,0,1
69007,66,32,14,3,17,49
69008,116,28,34,22,32,84
69009,198,110,28,23,37,161
69010,33,10,19,0,4,29
69011,188,108,23,23,34,154
69012,95,34,40,10,11,84
69013,46,18,20,0,8,38
69014,27,15,2,4,6,21
69015,137,58,26,24,29,108
69016,102,46,17,18,21,81
69017,186,49,19,88,30,156
69018,12,7,2,0,3,9
69019,92,37,23,14,18,74
69020,127,75,22,3,27,100
69021,23,9,7,1,6,17
69022,312,163,84,15,50,262
69023,33,5,23,0,5,28
69024,61,15,30,2,14,47
69025,138,50,34,20,34,104
69026,27,5,15,1,6,21
69027,46,18,20,0,8,38
69028,102,38,35,6,23,79
69029,67,26,25,3,13,54
69030,20,9,3,3,5,15
69031,17,7,5,1,4,13
69032,32,21,9,0,2,30
69033,20,5,6,6,3,17
69034,15,1,12,0,2,13
69035,21,11,4,0,6,15
69036,54,35,6,2,11,43
69037,183,147,9,0,27,156
69038,46,23,10,2,11,35
69039,64,20,24,0,20,44
69040,3,1,1,0,1,2
69041,35,12,10,5,8,27
69042,77,26,35,3,13,64
69043,49,41,2,0,6,43
69044,25,11,8,1,5,20
69045,456,158,157,46,95,361
69046,45,13,25,0,7,38
69047,533,299,116,17,101,432
69048,404,192,99,32,81,323
69049,50,6,37,0,7,43
69050,95,27,54,2,12,83
69051,76,32,20,1,23,53
69052,15,9,2,0,4,11
69053,115,93,6,0,16,99
69054,20,8,7,2,3,17
69055,72,7,50,5,10,62
69056,59,38,12,0,9,50
69057,64,23,14,10,17,47
69058,49,20,15,8,6,43
69059,52,17,17,7,11,41
69060,63,48,5,4,6,57
69061,21,5,9,0,7,14
69062,48,14,24,0,10,38
69063,29,22,4,1,2,27
69064,159,109,26,0,24,135
69065,37,18,14,0,5,32
69066,12,2,5,1,4,8
69067,469,217,147,14,91,378
69068,210,9,164,0,37,173
69069,127,44,48,8,27,100
69070,104,65,21,0,18,86
69071,153,66,42,20,25,128
69072,221,173,11,1,36,185
69073,56,16,28,2,10,46
69074,7,3,3,0,1,6
69075,253,20,185,2,46,207
69076,60,27,14,2,17,43
69077,24,11,11,2,0,24
69078,51,14,28,1,8,43
69079,23,14,4,0,5,18
69080,35,12,14,0,9,26
69081,64,44,2,2,16,48
69082,48,1,38,0,9,39
69083,42,6,21,11,4,38
69084,416,231,88,12,85,331
69085,334,197,66,0,71,263
69086,4,2,1,0,1,3
69087,40,18,15,1,6,34
69088,39,34,0,0,5,34
69089,15,2,10,1,2,13
69090,296,142,93,12,49,247
69091,605,341,148,20,96,509
69092,458,137,190,34,97,361
69093,31,17,8,0,6,25
69094,26,20,3,1,2,24
69095,20,6,12,0,2,18
69096,126,62,29,14,21,105
69097,25,9,13,0,3,22
69098,172,72,30,28,42,130
69099,97,25,54,0,18,79
69100,224,75,85,15,49,175
69101,9,5,2,0,2,7
69102,27,11,7,0,9,18
69103,127,70,31,0,26,101
69104,82,32,31,6,13,69
69105,425,133,171,25,96,329
69106,31,4,17,0,10,21
69107,330,184,51,29,66,264
69108,133,73,24,4,32,101
69109,15,7,1,3,4,11
69110,13,8,2,1,2,11
69111,212,40,122,1,49,163
69112,329,140,115,6,68,261
69113,35,3,24,0,8,27
69114,98,55,18,0,25,73
69115,49,28,13,0,8,41
69116,109,27,30,30,22,87
69117,64,39,16,0,9,55
69118,48,26,15,0,7,41
69119,75,31,32,3,9,66
69120,11,3,4,0,4,7
69121,3,1,1,0,1,2
69122,22,10,5,2,5,17
69123,56,30,16,1,9,47
69124,92,67,7,0,18,74
69125,29,20,6,1,2,27
69126,75,38,22,0,15,60
69127,28,10,12,0,6,22
69128,12,3,5,0,4,8
69129,291,192,34,8,57,234
69130,32,22,4,0,6,26
69131,278,70,42,121,45,233
69132,418,101,174,48,95,323
69133,113,34,42,10,27,86
69134,399,105,161,46,87,312
69135,2,0,1,0,1,1
69136,49,26,16,0,7,42
69137,23,2,17,0,4,19
69138,27,10,12,0,5,22
69139,32,21,9,0,2,30
69140,63,47,12,0,4,59
69141,20,8,9,0,3,17
69142,42,18,13,0,11,31
69143,32,21,9,0,2,30
69144,45,10,25,0,10,35
69145,141,54,54,13,20,121
69146,28,9,12,0,7,21
69147,39,2,19,13,5,34
69148,64,32,12,0,20,44
69149,154,88,31,0,35,119
69150,25,3,18,1,3,22
69151,383,184,106,14,79,304
69152,63,27,14,9,13,50
69153,311,176,77,0,58,253
69154,40,24,10,2,4,36
69155,2,0,2,0,0,2
69156,46,14,25,0,7,39
69157,59,9,35,0,15,44
69158,612,389,88,6,129,483
69159,71,40,6,7,18,53
69160,86,18,43,9,16,70
69161,25,13,6,1,5,20
69162,4,1,0,3,0,4
69163,51,25,16,0,10,41
69164,60,4,43,4,9,51
69165,73,28,30,1,14,59
69166,99,32,40,10,17,82
69167,56,32,16,2,6,50
69168,386,221,90,0,75,311
69169,57,22,22,2,11,46
69170,51,14,20,7,10,41
69171,7,3,1,0,3,4
69172,24,14,6,0,4,20
69173,19,2,11,0,6,13
69174,159,86,22,21,30,129
69175,512,352,49,1,110,402
69176,153,115,5,2,31,122
69177,54,30,9,4,11,43
69178,258,190,16,0,52,206
69179,43,5,30,0,8,35
69180,362,89,175,8,90,272
69181,34,5,24,0,5,29
69182,133,47,29,27,30,103
69183,34,3,20,0,11,23
69184,45,31,1,0,13,32
69185,342,147,120,6,69,273
69186,21,2,15,0,4,17
69187,492,253,87,47,105,387
69188,55,34,8,3,10,45
69189,658,385,141,17,115,543
69190,10,1,6,0,3,7
69191,77,40,24,2,11,66
69192,35,21,7,0,7,28
69193,9,0,4,0,5,4
69194,61,35,18,0,8,53
69195,44,15,15,3,11,33
69196,63,42,6,0,15,48
69197,2,0,0,0,2,0
69198,107,46,31,8,22,85
69199,257,123,78,5,51,206
69200,233,156,32,0,45,188
69201,41,18,11,0,12,29
69202,67,30,18,5,14,53
69203,13,7,4,1,1,12
69204,25,9,10,1,5,20
69205,83,22,45,2,14,69
69206,85,41,22,1,21,64
69207,59,7,37,1,14,45
69208,56,38,5,0,13,43
69209,600,342,141,17,100,500
69210,16,12,3,0,1,15
69211,631,352,156,23,100,531
69212,25,9,13,0,3,22
69213,161,116,11,0,34,127
69214,139,41,66,1,31,108
69215,11,5,4,0,2,9
69216,55,33,15,2,5,50
69217,45,7,30,3,5,40
69218,31,19,4,2,6,25
69219,84,59,5,0,20,64
69220,43,28,7,1,7,36
69221,70,47,10,0,13,57
69222,83,40,26,0,17,66
69223,33,2,24,0,7,26
69224,19,0,11,0,8,11
69225,109,27,30,30,22,87
69226,24,16,3,0,5,19
69227,30,16,7,4,3,27
69228,103,46,13,25,19,84
69229,42,26,4,0,12,30
69230,181,92,56,0,33,148
69231,207,54,39,79,35,172
69232,56,12,13,22,9,47
69233,56,7,33,4,12,44
69234,366,162,129,6,69,297
69235,156,55,40,30,31,125
69236,95,54,17,0,24,71
69237,75,47,15,0,13,62
69238,41,8,20,5,8,33
69239,70,25,6,26,13,57
69240,200,81,13,68,38,162
69241,81,46,16,2,17,64
69242,101,67,17,0,17,84
69243,170,103,11,23,33,137
69244,144,69,28,24,23,121
69245,90,66,6,0,18,72
69246,32,2,23,0,7,25
69247,273,62,144,7,60,213
69248,152,65,56,1,30,122
69249,388,291,20,0,77,311
69250,119,52,41,1,25,94
69251,1,0,1,0,0,1
69252,13,2,8,0,3,10
69253,12,0,11,0,1,11
69254,172,49,53,36,34,138
69255,8,3,3,0,2,6
69256,27,10,11,1,5,22
69257,103,60,8,11,24,79
69258,18,9,8,0,1,17
69259,8,2,3,0,3,5
69260,116,68,19,3,26,90
69261,33,13,16,1,3,30
69262,52,32,11,1,8,44
69263,16,5,7,0,4,12
69264,194,5,158,0,31,163
69265,120,87,7,0,26,94
69266,190,73,63,7,47,143
69267,31,4,17,0,10,21
69268,47,29,6,1,11,36
69269,90,57,17,2,14,76
69270,586,342,120,18,106,480
69271,94,56,22,1,15,79
69272,32,21,9,0,2,30
69273,48,25,4,3,16,32
69274,512,245,105,58,104,408
69275,50,30,12,0,8,42
69276,70,59,2,0,9,61
69277,463,259,96,12,96,367
69278,118,42,41,7,28,90
69279,45,35,4,0,6,39
69280,83,26,37,5,15,68
69281,533,272,113,39,109,424
69282,103,45,22,14,22,81
69283,23,7,13,0,3,20
69284,40,21,11,1,7,33
69285,8,6,1,0,1,7
69286,129,37,58,7,27,102
69287,76,11,34,16,15,61
69288,97,60,18,12,7,90
69289,42,23,10,0,9,33
69290,46,18,20,0,8,38
69291,7,0,6,0,1,6
69292,154,70,50,5,29,125
69293,54,37,5,2,10,44
69294,49,23,19,0,7,42
69295,68,46,8,2,12,56
69296,46,27,7,0,12,34
69297,46,18,20,0,8,38
69298,445,140,182,29,94,351
69299,32,12,14,0,6,26
69300,58,33,16,0,9,49
69301,166,56,70,9,31,135
69302,43,21,11,4,7,36
69303,121,84,8,5,24,97
69304,49,33,6,2,8,41
69305,29,11,13,1,4,25
69306,81,37,23,3,18,63
69307,356,203,80,7,66,290
69308,111,44,39,7,21,90
69309,363,165,124,6,68,295
69310,32,21,9,0,2,30
69311,444,215,119,20,90,354
69312,13,3,7,0,3,10
69313,45,25,7,3,10,35
69314,137,94,19,1,23,114
69315,109,71,2,13,23,86
69316,11,6,2,0,3,8
69317,8,6,1,1,0,8
69318,27,20,2,0,5,22
69319,44,17,4,16,7,37
69320,28,15,6,1,6,22
69321,71,23,19,10,19,52
69322,12,6,6,0,0,12
69323,85,54,16,0,15,70
69324,59,26,21,0,12,47
69325,22,12,6,0,4,18
69326,70,53,6,1,10,60
69327,142,87,29,0,26,116
69328,215,136,63,4,12,203
69329,100,48,31,5,16,84
69330,12,6,4,0,2,10
69331,157,120,11,1,25,132
69332,22,0,20,1,1,21
69333,109,54,38,1,16,93
69334,53,13,28,4,8,45
69335,156,77,48,1,30,126
69336,102,26,57,3,16,86
69337,16,8,6,0,2,14
69338,98,36,28,11,23,75
69339,74,25,24,14,11,63
69340,64,42,11,2,9,55
69341,8,0,4,0,4,4
69342,276,94,126,14,42,234
69343,22,16,2,0,4,18
69344,309,168,72,0,69,240
69345,35,7,22,1,5,30
69346,36,17,8,5,6,30
69347,41,6,6,20,9,32
69348,15,9,1,5,0,15
69349,264,196,15,0,53,211
69350,202,79,12,74,37,165
69351,562,398,44,1,119,443
69352,53,10,31,2,10,43
69353,100,47,15,24,14,86
69354,91,42,14,17,18,73
69355,31,12,6,7,6,25
69356,332,159,112,1,60,272
69357,219,149,30,0,40,179
69358,90,65,15,1,9,81
69359,217,141,63,1,12,205
69360,55,29,6,4,16,39
69361,4,1,2,0,1,3
69362,73,31,20,1,21,52
69363,32,21,9,0,2,30
69364,135,89,23,1,22,113
69365,85,43,28,0,14,71
69366,31,0,11,16,4,27
69367,56,3,41,1,11,45
69368,78,32,31,4,11,67
69369,45,6,16,11,12,33
69370,38,18,9,3,8,30
69371,19,2,13,0,4,15
69372,164,51,89,4,20,144
69373,44,21,6,7,10,34
69374,28,22,5,0,1,27
69375,60,17,28,1,14,46
69376,236,156,35,0,45,191
69377,35,13,19,0,3,32
69378,99,43,35,1,20,79
69379,63,12,41,0,10,53
69380,4,3,1,0,0,4
69381,1,0,0,1,0,1
69382,118,53,22,17,26,92
69383,154,55,33,34,32,122
69384,109,47,22,21,19,90
69385,65,39,3,3,20,45
69386,165,61,51,24,29,136
69387,36,12,19,1,4,32
69388,40,9,22,3,6,34
69389,140,56,47,14,23,117
69390,122,84,11,2,25,97
69391,89,23,43,2,21,68
69392,53,27,13,3,10,43
69393,26,8,15,0,3,23
69394,8,5,0,1,2,6
69395,32,21,9,0,2,30
69396,31,9,14,1,7,24
69397,281,28,198,2,53,228
69398,165,104,4,19,38,127
69399,70,20,33,1,16,54
69400,32,21,9,0,2,30
69401,17,7,8,0,2,15
69402,108,35,44,11,18,90
69403,55,25,4,17,9,46
69404,17,10,2,1,4,13
69405,63,18,36,1,8,55
69406,77,44,7,6,20,57
69407,73,51,7,3,12,61
69408,8,2,3,0,3,5
69409,126,36,62,4,24,102
69410,13,3,8,0,2,11
69411,46,6,26,3,11,35
69412,139,105,5,2,27,112
69413,79,59,7,1,12,67
69414,21,5,12,1,3,18
69415,81,36,27,2,16,65
69416,45,16,11,5,13,32
69417,34,12,13,0,9,25
69418,23,10,1,5,7,16
69419,334,200,58,12,64,270
69420,67,12,35,6,14,53
69421,46,15,20,4,7,39
69422,93,30,25,21,17,76
69423,19,1,16,0,2,17
69424,76,32,20,1,23,53
69425,33,16,4,5,8,25
69426,61,29,14,4,14,47
69427,16,5,6,0,5,11
69428,101,34,36,14,17,84
69429,134,28,49,30,27,107
69430,76,31,8,17,20,56
69431,32,18,5,0,9,23
69432,213,48,110,4,51,162
69433,40,26,8,1,5,35
69434,286,81,144,4,57,229
69435,69,25,24,5,15,54
69436,22,12,5,0,5,17
69437,48,18,20,3,7,41
69438,72,44,15,0,13,59
69439,52,35,7,0,10,42
69440,16,3,6,0,7,9
69441,55,25,13,6,11,44
69442,55,34,10,0,11,44
69443,31,15,9,2,5,26
69444,23,11,10,0,2,21
69445,31,16,8,1,6,25
69446,58,38,10,0,10,48
69447,46,16,15,2,13,33
69448,165,110,25,1,29,136
69449,337,139,124,6,68,269
69450,343,144,127,6,66,277
69451,80,38,27,0,15,65
69452,41,1,32,0,8,33
69453,142,10,84,18,30,112
69454,166,123,8,6,29,137
69455,14,6,3,3,2,12
69456,224,97,14,76,37,187
69457,363,95,180,5,83,280
69458,46,22,13,1,10,36
69459,76,32,8,17,19,57
69460,113,59,22,10,22,91
69461,167,86,40,0,41,126
69462,72,40,10,10,12,60
69463,32,21,9,0,2,30
69464,70,38,18,0,14,56
69465,339,143,120,6,70,269
69466,55,24,6,12,13,42
69467,51,11,25,1,14,37
69468,49,18,16,1,14,35
69469,34,7,23,0,4,30
69470,32,21,9,0,2,30
69471,9,0,4,0,5,4
69472,40,13,21,0,6,34
69473,66,15,35,7,9,57
69474,32,16,4,5,7,25
69475,51,11,32,0,8,43
69476,160,98,36,1,25,135
69477,52,32,7,3,10,42
69478,75,42,19,0,14,61
69479,29,22,2,0,5,24
69480,74,47,18,0,9,65
69481,34,16,7,1,10,24
69482,98,27,35,16,20,78
69483,58,39,5,0,14,44
69484,104,60,18,2,24,80
69485,21,4,14,1,2,19
69486,40,21,12,1,6,34
69487,12,4,5,0,3,9
69488,150,64,36,23,27,123
69489,20,11,6,0,3,17
69490,63,37,16,0,10,53
69491,47,22,21,0,4,43
69492,170,82,25,23,40,130
69493,98,51,13,17,17,81
69494,67,54,0,0,13,54
69495,64,18,23,6,17,47
69496,34,3,5,20,6,28
69497,55,30,17,0,8,47
69498,220,150,30,0,40,180
69499,107,25,49,16,17,90
69500,32,21,9,0,2,30
69501,3,0,1,0,2,1
69502,22,5,8,4,5,17
69503,83,50,18,0,15,68
69504,33,14,8,2,9,24
69505,172,81,33,27,31,141
69506,101,39,29,13,20,81
69507,57,14,17,18,8,49
69508,41,20,10,3,8,33
69509,7,2,4,0,1,6
69510,415,237,95,0,83,332
69511,70,36,15,3,16,54
69512,2,0,2,0,0,2
69513,24,7,8,0,9,15
69514,1,0,1,0,0,1
69515,57,29,11,3,14,43
69516,67,38,13,1,15,52
69517,171,51,57,26,37,134
69518,60,20,26,1,13,47
69519,7,5,2,0,0,7
69520,372,259,36,1,76,296
69521,598,349,131,15,103,495
69522,14,11,2,0,1,13
69523,89,20,54,0,15,74
69524,73,29,7,22,15,58
69525,157,68,31,22,36,121
69526,129,71,23,4,31,98
69527,35,14,8,7,6,29
69528,549,312,119,17,101,448
69529,23,10,9,0,4,19
69530,94,38,28,10,18,76
69531,52,31,7,0,14,38
69532,364,266,19,2,77,287
69533,471,253,100,24,94,377
69534,53,33,5,0,15,38
69535,46,18,20,0,8,38
69536,102,19,50,15,18,84
69537,105,58,21,7,19,86
69538,86,37,28,3,18,68
69539,65,19,21,9,16,49
69540,15,12,0,1,2,13
69541,94,29,49,0,16,78
69542,34,8,16,1,9,25
69543,78,21,42,2,13,65
69544,72,48,7,0,17,55
69545,241,74,116,12,39,202
69546,40,17,16,1,6,34
69547,242,107,89,3,43,199
69548,101,43,41,1,16,85
69549,51,39,2,0,10,41
69550,189,104,55,0,30,159
69551,170,113,27,1,29,141
69552,76,22,26,14,14,62
69553,72,31,28,3,10,62
69554,31,4,22,0,5,26
69555,102,42,35,9,16,86
69556,394,192,115,14,73,321
69557,58,17,18,7,16,42
69558,52,21,18,0,13,39
69559,16,7,7,0,2,14
69560,48,8,28,3,9,39
69561,137,85,14,10,28,109
69562,34,16,10,3,5,29
69563,78,19,18,31,10,68
69564,99,29,53,0,17,82
69565,134,49,5,59,21,113
69566,85,22,34,10,19,66
69567,47,20,7,12,8,39
69568,109,47,44,2,16,93
69569,42,6,26,0,10,32
69570,77,39,25,0,13,64
69571,60,42,5,1,12,48
69572,8,0,7,0,1,7
69573,53,37,2,0,14,39
69574,67,29,16,6,16,51
69575,105,37,46,4,18,87
69576,279,101,122,14,42,237
69577,63,43,5,0,15,48
69578,314,154,83,13,64,250
69579,46,18,20,0,8,38
69580,84,33,26,9,16,68
69581,34,9,16,1,8,26
69582,19,2,11,0,6,13
69583,54,21,6,14,13,41
69584,34,10,11,6,7,27
69585,102,53,24,0,25,77
69586,14,5,3,2,4,10
69587,86,47,20,0,19,67
69588,106,48,16,16,26,80
69589,135,57,30,23,25,110
69590,193,55,33,73,32,161
69591,270,61,142,7,60,210
69592,3,2,0,0,1,2
69593,149,78,20,21,30,119
69594,66,28,22,2,14,52
69595,8,4,2,0,2,6
69596,58,12,31,0,15,43
69597,428,129,162,47,90,338
69598,82,45,22,1,14,68
69599,34,10,11,6,7,27
69600,17,10,3,0,4,13
69601,36,15,16,0,5,31
69602,31,20,5,1,5,26
69603,90,53,20,0,17,73
69604,32,21,9,0,2,30
69605,477,332,42,1,102,375
69606,3,1,1,0,1,2
69607,556,406,38,1,111,445
69608,33,19,8,0,6,27
69609,579,392,63,4,120,459
69610,128,53,33,19,23,105
69611,15,3,5,4,3,12
69612,124,38,53,7,26,98
69613,50,25,10,7,8,42
69614,48,30,9,0,9,39
69615,75,53,7,0,15,60
69616,16,0,14,2,0,16
69617,57,24,13,9,11,46
69618,203,85,51,24,43,160
69619,55,19,21,0,15,40
69620,13,3,6,1,3,10
69621,27,8,15,0,4,23
69622,31,15,12,0,4,27
69623,6,1,2,0,3,3
69624,14,9,3,0,2,12
69625,26,18,2,0,6,20
69626,123,40,33,28,22,101
69627,75,19,42,1,13,62
69628,135,73,30,5,27,108
69629,6,1,3,0,2,4
69630,220,150,30,0,40,180
69631,52,30,8,4,10,42
69632,143,73,36,0,34,109
69633,35,6,7,11,11,24
69634,18,10,8,0,0,18
69635,281,25,202,2,52,229
69636,343,96,162,6,79,264
69637,261,75,126,9,51,210
69638,64,11,43,1,9,55
69639,42,13,19,0,10,32
69640,64,53,0,1,10,54
69641,69,26,33,1,9,60
69642,14,7,4,0,3,11
69643,61,15,28,5,13,48
69644,409,233,92,0,84,325
69645,39,27,6,0,6,33
69646,29,13,12,0,4,25
69647,68,47,7,0,14,54
69648,5,0,5,0,0,5
69649,36,5,24,0,7,29
69650,46,18,20,0,8,38
69651,51,0,32,3,16,35
69652,16,8,1,1,6,10
69653,52,9,35,0,8,44
69654,36,19,9,0,8,28
69655,99,43,27,6,23,76
69656,21,5,10,0,6,15
69657,140,66,42,11,21,119
69658,45,10,23,0,12,33
69659,59,24,26,0,9,50
69660,187,75,45,22,45,142
69661,36,15,11,2,8,28
69662,6,3,2,0,1,5
69663,83,48,17,1,17,66
69664,405,117,187,10,91,314
69665,24,17,2,0,5,19
69666,91,56,17,0,18,73
69667,210,125,15,25,45,165
69668,154,71,31,17,35,119
69669,171,70,50,7,44,127
69670,22,6,7,5,4,18
69671,29,7,12,3,7,22
69672,56,30,9,6,11,45
69673,17,10,4,0,3,14
69674,113,36,56,5,16,97
69675,76,47,10,5,14,62
69676,0,0,0,0,0,0
69677,17,8,5,0,4,13
69678,312,199,46,12,55,257
69679,60,39,6,0,15,45
69680,46,18,20,0,8,38
69681,49,26,18,0,5,44
69682,43,29,8,0,6,37
69683,32,21,9,0,2,30
69684,90,57,19,0,14,76
69685,56,34,13,0,9,47
69686,5,3,1,0,1,4
69687,167,86,32,23,26,141
69688,182,98,24,25,35,147
69689,103,19,51,15,18,85
69690,129,61,43,4,21,108
69691,46,18,20,0,8,38
69692,44,24,10,1,9,35
69693,689,410,140,20,119,570
69694,407,112,193,8,94,313
69695,32,21,9,0,2,30
69696,50,19,20,1,10,40
69697,37,2,29,0,6,31
69698,50,14,27,0,9,41
69699,53,2,43,0,8,45
69700,14,6,4,0,4,10
69701,36,10,12,9,5,31
69702,27,15,7,0,5,22
69703,34,21,6,2,5,29
69704,32,21,9,0,2,30
69705,88,23,49,3,13,75
69706,3,0,1,0,2,1
69707,3,2,1,0,0,3
69708,411,237,87,17,70,341
69709,5,2,2,0,1,4
69710,142,47,56,8,31,111
69711,2,1,0,0,1,1
69712,267,137,80,0,50,217
69713,68,34,17,2,15,53
69714,43,21,13,3,6,37
69715,19,10,4,1,4,15
69716,59,20,18,9,12,47
69717,303,119,107,24,53,250
69718,47,37,1,0,9,38
69719,91,40,29,2,20,71
69720,71,18,27,13,13,58
69721,54,26,13,10,5,49
69722,366,180,117,1,68,298
69723,37,24,6,0,7,30
69724,43,18,16,2,7,36
69725,74,46,19,0,9,65
69726,17,7,9,0,1,16
69727,81,41,16,8,16,65
69728,58,14,23,2,19,39
69729,137,100,6,3,28,109
69730,69,28,9,10,22,47
69731,28,19,4,0,5,23
69732,50,34,6,1,9,41
69733,57,23,4,21,9,48
69734,158,100,33,1,24,134
69735,51,17,24,0,10,41
69736,6,1,4,0,1,5
69737,147,80,14,25,28,119
69738,15,5,5,0,5,10
69739,33,6,22,1,4,29
69740,169,89,44,0,36,133
69741,40,16,4,11,9,31
69742,53,9,35,2,7,46
69743,394,287,24,0,83,311
69744,109,48,30,12,19,90
69745,43,18,10,9,6,37
69746,11,3,4,0,4,7
69747,419,208,107,24,80,339
69748,159,29,64,24,42,117
69749,574,407,46,1,120,454
69750,264,198,15,0,51,213
69751,64,5,45,0,14,50
69752,24,11,8,0,5,19
69753,39,5,29,0,5,34
69754,71,22,32,2,15,56
69755,23,3,15,2,3,20
69756,9,8,0,0,1,8
69757,146,82,28,1,35,111
69758,8,0,5,1,2,6
69759,576,322,119,13,122,454
69760,76,12,54,2,8,68
69761,68,44,14,0,10,58
69762,11,0,9,0,2,9
69763,57,22,21,1,13,44
69764,3,1,1,0,1,2
69765,16,4,7,0,5,11
69766,115,48,43,2,22,93
69767,46,13,11,13,9,37
69768,27,12,2,6,7,20
69769,9,2,5,0,2,7
69770,33,10,18,2,3,30
69771,127,65,12,23,27,100
69772,17,2,10,0,5,12
69773,25,9,12,0,4,21
69774,11,1,8,0,2,9
69775,14,9,2,0,3,11
69776,34,19,13,0,2,32
69777,45,21,9,5,10,35
69778,74,56,6,0,12,62
69779,668,400,129,23,116,552
69780,75,25,25,14,11,64
69781,17,10,2,1,4,13
69782,36,6,25,0,5,31
69783,92,44,26,5,17,75
69784,4,3,0,0,1,3
69785,13,8,2,0,3,10
69786,81,41,23,0,17,64
69787,12,2,6,0,4,8
69788,58,30,18,1,9,49
69789,26,9,11,0,6,20
69790,486,344,42,1,99,387
69791,50,30,13,0,7,43
69792,44,14,16,5,9,35
69793,77,50,18,0,9,68
69794,68,45,12,0,11,57
69795,5,1,3,0,1,4
69796,113,92,3,3,15,98
69797,135,55,40,15,25,110
69798,69,34,20,1,14,55
69799,64,19,33,1,11,53
69800,24,9,12,1,2,22
69801,80,22,37,8,13,67
69802,60,40,5,2,13,47
69803,29,11,13,0,5,24
69804,114,44,43,3,24,90
69805,46,3,30,4,9,37
69806,241,175,22,6,38,203
69807,80,60,4,1,15,65
69808,17,1,11,1,4,13
69809,196,106,58,0,32,164
69810,117,48,15,18,36,81
69811,92,48,13,2,29,63
69812,54,25,16,5,8,46
69813,30,24,4,0,2,28
69814,226,98,15,76,37,189
69815,47,19,17,0,11,36
69816,9,5,2,0,2,7
69817,69,38,19,0,12,57
69818,15,2,5,0,8,7
69819,146,81,28,1,36,110
69820,168,70,49,6,43,125
69821,286,140,70,18,58,228
69822,31,6,15,2,8,23
69823,232,79,89,15,49,183
69824,188,108,25,21,34,154
69825,36,2,30,0,4,32
69826,201,87,42,25,47,154
69827,12,2,8,0,2,10
69828,88,30,43,2,13,75
69829,29,14,6,3,6,23
69830,28,15,8,0,5,23
69831,83,42,4,25,12,71
69832,146,60,57,8,21,125
69833,343,177,88,19,59,284
69834,68,49,4,0,15,53
69835,79,26,37,3,13,66
69836,101,38,31,8,24,77
69837,33,8,18,4,3,30
69838,342,193,84,0,65,277
69839,100,65,23,0,12,88
69840,193,101,35,21,36,157
69841,46,9,15,12,10,36
69842,91,48,12,2,29,62
69843,41,11,26,0,4,37
69844,69,34,14,0,21,48
69845,32,16,7,1,8,24
69846,324,196,58,0,70,254
69847,29,7,14,1,7,22
69848,76,15,33,10,18,58
69849,45,4,30,0,11,34
69850,43,11,24,3,5,38
69851,42,26,12,0,4,38
69852,72,19,39,1,13,59
69853,100,42,20,11,27,73
69854,102,31,20,23,28,74
69855,111,46,41,2,22,89
69856,46,18,20,0,8,38
69857,35,9,15,4,7,28
69858,6,0,5,0,1,5
69859,14,4,6,0,4,10
69860,128,62,46,2,18,110
69861,86,21,41,3,21,65
69862,464,164,158,45,97,367
69863,238,92,54,37,55,183
69864,46,18,20,0,8,38
69865,13,6,4,0,3,10
69866,32,21,9,0,2,30
69867,19,0,11,0,8,11
69868,165,99,37,1,28,137
69869,84,10,52,5,17,67
69870,72,36,12,7,17,55
69871,84,12,56,0,16,68
69872,22,18,0,0,4,18
69873,123,60,32,0,31,92
69874,45,11,21,1,12,33
69875,32,21,9,0,2,30
69876,20,2,11,1,6,14
69877,79,26,23,13,17,62
69878,38,27,5,0,6,32
69879,76,19,40,2,15,61
69880,243,101,15,83,44,199
69881,415,194,126,12,83,332
69882,146,88,25,6,27,119
69883,33,12,11,1,9,24
69884,8,1,5,0,2,6
69885,253,116,85,10,42,211
69886,33,5,21,1,6,27
69887,46,18,20,0,8,38
69888,211,114,48,0,49,162
69889,29,14,6,2,7,22
69890,84,43,21,1,19,65
69891,52,16,23,3,10,42
69892,76,10,43,5,18,58
69893,10,5,5,0,0,10
69894,401,192,106,18,85,316
69895,43,9,28,0,6,37
69896,2,1,1,0,0,2
69897,157,76,48,1,32,125
69898,210,131,66,1,12,198
69899,313,91,148,6,68,245
69900,458,229,121,14,94,364
69901,16,2,10,1,3,13
69902,53,22,14,6,11,42
69903,265,124,77,12,52,213
69904,359,273,20,0,66,293
69905,544,308,111,12,113,431
69906,25,7,9,2,7,18
69907,73,44,18,0,11,62
69908,3,0,2,0,1,2
69909,4,0,2,0,2,2
69910,160,72,53,7,28,132
69911,32,21,9,0,2,30
69912,86,59,9,3,15,71
69913,27,18,7,0,2,25
69914,30,9,7,5,9,21
69915,22,11,6,0,5,17
69916,40,28,1,1,10,30
69917,14,6,3,3,2,12
69918,42,10,11,9,12,30
69919,46,18,20,0,8,38
69920,56,17,25,0,14,42
69921,80,38,5,16,21,59
69922,12,4,6,0,2,10
69923,24,9,4,2,9,15
69924,75,43,10,10,12,63
69925,88,45,25,0,18,70
69926,76,39,26,0,11,65
69927,64,34,14,0,16,48
69928,38,16,14,0,8,30
69929,38,18,16,0,4,34
69930,10,4,4,1,1,9
69931,237,167,28,3,39,198
69932,17,7,7,0,3,14
69933,31,2,22,0,7,24
69934,50,3,11,28,8,42
69935,156,57,48,17,34,122
69936,49,33,10,0,6,43
69937,54,19,16,8,11,43
69938,91,52,17,1,21,70
69939,348,191,88,15,54,294
69940,24,7,7,3,7,17
69941,113,25,42,21,25,88
69942,113,24,56,0,33,80
69943,13,6,5,0,2,11
69944,63,23,29,2,9,54
69945,168,82,51,3,32,136
69946,52,14,22,5,11,41
69947,38,25,4,0,9,29
69948,92,28,25,21,18,74
69949,37,26,3,0,8,29
69950,5,1,3,0,1,4
69951,95,49,11,12,23,72
69952,71,15,42,0,14,57
69953,429,129,161,47,92,337
69954,41,31,3,3,4,37
69955,73,35,18,12,8,65
69956,211,93,52,23,43,168
69957,37,8,22,0,7,30
69958,76,33,17,9,17,59
69959,59,21,23,3,12,47
69960,14,4,8,0,2,12
69961,108,39,41,11,17,91
69962,134,31,50,24,29,105
69963,17,16,0,0,1,16
69964,21,2,11,1,7,14
69965,91,10,53,6,22,69
69966,16,9,5,0,2,14
69967,203,124,12,24,43,160
69968,39,10,26,0,3,36
69969,128,44,47,7,30,98
69970,79,43,20,6,10,69
69971,81,61,7,1,12,69
69972,27,4,15,2,6,21
69973,27,11,12,0,4,23
69974,38,10,16,6,6,32
69975,129,67,12,23,27,102
69976,102,75,7,0,20,82
69977,542,382,47,1,112,430
69978,37,16,14,0,7,30
69979,78,20,32,1,25,53
69980,60,37,10,0,13,47
69981,13,6,5,0,2,11
69982,13,4,3,1,5,8
69983,73,23,36,4,10,63
69984,60,30,23,0,7,53
69985,58,20,24,1,13,45
69986,28,2,12,8,6,22
69987,53,17,18,3,15,38
69988,55,16,34,0,5,50
69989,33,13,15,0,5,28
69990,50,31,13,0,6,44
69991,16,2,8,0,6,10
69992,14,0,10,0,4,10
69993,67,33,21,1,12,55
69994,59,17,19,9,14,45
69995,66,31,22,0,13,53
69996,345,179,87,19,60,285
69997,49,21,18,0,10,39
69998,41,21,5,7,8,33
69999,75,19,42,1,13,62
70000,30,9,7,5,9,21
70001,24,15,3,0,6,18
70002,79,23,36,5,15,64
70003,49,12,27,1,9,40
70004,44,14,22,0,8,36
70005,130,40,50,20,20,110
70006,24,3,0,13,8,16
70007,28,7,16,2,3,25
70008,47,35,4,3,5,42
70009,26,17,8,0,1,25
70010,115,25,57,0,33,82
70011,54,20,15,4,15,39
70012,9,4,5,0,0,9
70013,69,39,13,2,15,54
70014,140,79,30,0,31,109
70015,33,14,6,5,8,25
70016,42,16,15,3,8,34
70017,12,2,8,0,2,10
70018,47,25,3,12,7,40
70019,58,34,13,1,10,48
70020,117,49,34,14,20,97
70021,142,52,32,23,35,107
70022,65,7,38,8,12,53
70023,2,0,2,0,0,2
70024,32,21,9,0,2,30
70025,50,25,17,0,8,42
70026,275,100,115,15,45,230
70027,231,133,46,13,39,192
70028,32,21,9,0,2,30
70029,45,11,21,0,13,32
70030,54,18,13,17,6,48
70031,56,30,10,4,12,44
70032,139,63,27,20,29,110
70033,38,26,5,3,4,34
70034,79,40,28,0,11,68
70035,131,97,6,0,28,103
70036,365,176,98,12,79,286
70037,127,69,23,4,31,96
70038,23,6,12,1,4,19
70039,94,42,27,1,24,70
70040,271,141,95,0,35,236
70041,86,51,22,2,11,75
70042,37,12,17,1,7,30
70043,61,44,3,0,14,47
70044,72,42,16,1,13,59
70045,76,40,13,9,14,62
70046,136,53,32,16,35,101
70047,78,45,18,2,13,65
70048,529,222,140,51,116,413
70049,170,113,27,1,29,141
70050,24,18,1,0,5,19
70051,146,90,30,0,26,120
70052,406,300,20,2,84,322
70053,54,33,11,0,10,44
70054,189,5,155,0,29,160
70055,36,9,20,0,7,29
70056,108,35,33,15,25,83
70057,34,21,7,0,6,28
70058,180,105,19,23,33,147
70059,137,20,71,17,29,108
70060,57,41,3,0,13,44
70061,54,17,19,7,11,43
70062,153,64,45,5,39,114
70063,47,12,24,0,11,36
70064,72,19,41,0,12,60
70065,140,61,30,23,26,114
70066,627,416,71,4,136,491
70067,53,26,16,0,11,42
70068,74,61,3,0,10,64
70069,147,65,46,10,26,121
70070,56,41,8,1,6,50
70071,134,76,22,3,33,101
70072,122,65,19,16,22,100
70073,76,35,5,15,21,55
70074,77,13,42,6,16,61
70075,135,75,22,7,31,104
70076,16,2,11,1,2,14
70077,0,0,0,0,0,0
70078,10,5,1,2,2,8
70079,34,20,8,2,4,30
70080,73,36,18,8,11,62
70081,24,8,11,0,5,19
70082,29,24,1,0,4,25
70083,511,237,131,36,107,404
70084,56,3,41,1,11,45
70085,76,45,14,1,16,60
70086,469,221,144,12,92,377
70087,310,159,83,15,53,257
70088,12,4,3,0,5,7
70089,133,31,73,1,28,105
70090,63,29,7,13,14,49
70091,47,0,29,3,15,32
70092,45,11,27,1,6,39
70093,205,103,33,33,36,169
70094,67,14,37,1,15,52
70095,106,38,39,3,26,80
70096,32,15,9,0,8,24
70097,27,15,2,4,6,21
70098,62,44,9,0,9,53
70099,172,86,25,30,31,141
70100,667,392,142,17,116,551
70101,1028,387,404,46,191,837
70102,9,7,0,0,2,7
70103,93,28,50,1,14,79
70104,18,8,6,0,4,14
70105,32,16,2,5,9,23
70106,62,31,16,0,15,47
70107,13,7,0,3,3,10
70108,129,94,10,0,25,104
70109,346,187,90,15,54,292
70110,63,37,16,0,10,53
70111,4,3,0,0,1,3
70112,49,12,27,1,9,40
70113,66,47,8,0,11,55
70114,68,26,28,1,13,55
70115,69,32,24,2,11,58
70116,15,2,8,0,5,10
70117,44,29,7,3,5,39
70118,75,39,16,2,18,57
70119,102,48,16,23,15,87
70120,31,22,2,0,7,24
70121,120,44,41,12,23,97
70122,91,27,25,21,18,73
70123,501,251,97,53,100,401
70124,27,1,18,0,8,19
70125,161,107,24,1,29,132
70126,39,20,10,0,9,30
70127,21,8,8,2,3,18
70128,140,107,4,3,26,114
70129,679,392,145,21,121,558
70130,153,115,8,4,26,127
70131,146,43,46,22,35,111
70132,31,4,17,0,10,21
70133,54,35,9,0,10,44
70134,64,30,21,1,12,52
70135,53,33,5,0,15,38
70136,98,21,62,0,15,83
70137,15,2,6,1,6,9
70138,109,62,14,10,23,86
70139,28,16,5,0,7,21
70140,23,9,2,7,5,18
70141,115,47,30,17,21,94
70142,132,57,24,23,28,104
70143,83,36,24,0,23,60
70144,142,56,47,9,30,112
70145,130,93,10,0,27,103
70146,94,30,22,24,18,76
70147,97,8,65,5,19,78
70148,15,9,1,1,4,11
70149,147,105,3,2,37,110
70150,19,9,4,1,5,14
70151,100,65,9,5,21,79
70152,75,43,10,10,12,63
70153,50,35,9,1,5,45
70154,7,4,1,0,2,5
70155,37,16,14,0,7,30
70156,36,23,5,1,7,29
70157,24,12,9,1,2,22
70158,69,43,14,1,11,58
70159,81,39,15,7,20,61
70160,19,15,2,0,2,17
70161,42,15,22,0,5,37
70162,53,37,3,1,12,41
70163,47,15,20,0,12,35
70164,65,43,7,1,14,51
70165,64,26,28,0,10,54
70166,204,114,60,0,30,174
70167,18,11,6,0,1,17
70168,201,109,31,23,38,163
70169,77,45,18,0,14,63
70170,162,68,64,4,26,136
70171,8,1,4,0,3,5
70172,440,253,82,12,93,347
70173,38,1,29,1,7,31
70174,140,85,28,0,27,113
70175,86,41,22,1,22,64
70176,75,36,20,0,19,56
70177,23,12,4,1,6,17
70178,8,5,1,1,1,7
70179,366,91,178,7,90,276
70180,53,33,12,1,7,46
70181,357,173,116,1,67,290
70182,386,178,128,6,74,312
70183,101,37,38,5,21,80
70184,16,9,5,0,2,14
70185,5,4,0,1,0,5
70186,20,0,15,0,5,15
70187,19,7,8,0,4,15
70188,66,27,27,1,11,55
70189,35,21,9,0,5,30
70190,46,13,22,0,11,35
70191,40,8,18,0,14,26
70192,15,13,0,0,2,13
70193,127,54,40,0,33,94
70194,37,23,6,1,7,30
70195,35,2,25,0,8,27
70196,96,38,37,6,15,81
70197,47,17,13,3,14,33
70198,25,7,13,0,5,20
70199,33,26,1,0,6,27
70200,3,0,2,0,1,2
70201,101,79,3,0,19,82
70202,44,31,1,2,10,34
70203,7,2,4,0,1,6
70204,23,10,8,0,5,18
70205,60,39,8,0,13,47
70206,25,14,9,0,2,23
70207,17,11,3,1,2,15
70208,41,22,16,0,3,38
70209,235,154,26,3,52,183
70210,70,39,19,0,12,58
70211,108,76,17,0,15,93
70212,84,49,16,0,19,65
70213,57,20,26,0,11,46
70214,149,59,48,9,33,116
70215,284,93,136,5,50,234
70216,70,15,29,9,17,53
70217,21,10,7,3,1,20
70218,22,5,10,2,5,17
70219,153,100,3,17,33,120
70220,20,11,3,0,6,14
70221,12,4,4,0,4,8
70222,156,119,7,0,30,126
70223,144,17,98,1,28,116
70224,93,30,36,5,22,71
70225,55,29,18,0,8,47
70226,47,17,16,1,13,34
70227,109,38,27,25,19,90
70228,78,18,41,3,16,62
70229,126,48,45,8,25,101
70230,8,0,4,0,4,4
70231,539,391,31,1,116,423
70232,57,9,34,4,10,47
70233,97,66,8,4,19,78
70234,32,21,9,0,2,30
70235,51,35,9,0,7,44
70236,112,43,45,0,24,88
70237,46,26,9,2,9,37
70238,50,31,11,1,7,43
70239,151,53,35,31,32,119
70240,62,23,21,1,17,45
70241,140,47,45,22,26,114
70242,44,14,17,7,6,38
70243,24,10,4,0,10,14
70244,5,5,0,0,0,5
70245,8,4,3,0,1,7
70246,114,60,22,10,22,92
70247,6,3,1,0,2,4
70248,55,26,22,0,7,48
70249,54,25,19,1,9,45
70250,54,14,19,9,12,42
70251,5,4,1,0,0,5
70252,56,0,38,3,15,41
70253,93,25,45,2,21,72
70254,33,13,12,2,6,27
70255,220,150,30,0,40,180
70256,261,72,138,2,49,212
70257,42,11,21,1,9,33
70258,536,269,102,56,109,427
70259,83,24,45,2,12,71
70260,24,13,8,2,1,23
70261,44,24,5,7,8,36
70262,81,25,42,2,12,69
70263,32,21,9,0,2,30
70264,328,169,95,1,63,265
70265,77,5,55,1,16,61
70266,83,33,34,1,15,68
70267,53,33,11,3,6,47
70268,38,10,24,2,2,36
70269,47,16,20,1,10,37
70270,75,46,15,0,14,61
70271,77,43,15,0,19,58
70272,10,2,7,0,1,9
70273,179,90,50,0,39,140
70274,56,13,30,0,13,43
70275,21,4,10,0,7,14
70276,81,62,1,0,18,63
70277,82,46,21,4,11,71
70278,46,18,20,0,8,38
70279,140,107,4,2,27,113
70280,41,8,27,0,6,35
70281,56,8,35,4,9,47
70282,68,18,33,4,13,55
70283,11,0,7,0,4,7
70284,36,21,8,0,7,29
70285,266,60,143,3,60,206
70286,462,219,144,13,86,376
70287,71,26,29,0,16,55
70288,41,22,10,1,8,33
70289,75,58,6,1,10,65
70290,117,37,35,14,31,86
70291,82,31,31,4,16,66
70292,93,74,3,0,16,77
70293,194,77,35,33,49,145
70294,452,221,117,17,97,355
70295,120,50,30,18,22,98
70296,78,45,18,2,13,65
70297,18,7,9,0,2,16
70298,108,43,33,9,23,85
70299,19,6,11,0,2,17
70300,197,110,22,24,41,156
70301,89,29,19,22,19,70
70302,31,12,13,0,6,25
70303,85,19,45,3,18,67
70304,110,71,20,2,17,93
70305,31,17,4,3,7,24
70306,28,12,9,2,5,23
70307,75,47,15,0,13,62
70308,119,57,38,4,20,99
70309,33,8,19,0,6,27
70310,76,49,8,0,19,57
70311,51,15,23,0,13,38
70312,30,17,9,0,4,26
70313,29,12,8,2,7,22
70314,95,65,15,0,15,80
70315,32,21,9,0,2,30
70316,35,8,18,0,9,26
70317,508,276,84,43,105,403
70318,46,18,20,0,8,38
70319,97,31,47,7,12,85
70320,76,31,29,1,15,61
70321,78,32,22,2,22,56
70322,45,7,27,4,7,38
70323,554,307,114,13,120,434
70324,102,68,12,1,21,81
70325,15,3,11,0,1,14
70326,44,19,9,8,8,36
70327,55,33,7,0,15,40
70328,25,9,11,0,5,20
70329,26,11,8,4,3,23
70330,147,69,49,5,24,123
70331,56,12,13,24,7,49
70332,93,54,20,0,19,74
70333,80,38,24,0,18,62
70334,428,206,104,30,88,340
70335,61,23,16,8,14,47
70336,8,0,7,0,1,7
70337,73,28,23,13,9,64
70338,64,34,10,6,14,50
70339,8,1,4,0,3,5
70340,155,42,85,2,26,129
70341,71,26,29,0,16,55
70342,55,27,13,2,13,42
70343,424,195,123,25,81,343
70344,424,114,171,45,94,330
70345,33,12,12,0,9,24
70346,55,40,5,1,9,46
70347,46,18,20,0,8,38
70348,57,23,24,1,9,48
70349,71,31,21,0,19,52
70350,90,33,29,9,19,71
70351,11,3,2,3,3,8
70352,26,14,4,0,8,18
70353,193,54,50,52,37,156
70354,377,197,106,17,57,320
70355,29,17,4,7,1,28
70356,565,411,41,1,112,453
70357,68,14,41,2,11,57
70358,15,0,12,0,3,12
70359,56,26,17,0,13,43
70360,68,29,26,0,13,55
70361,274,108,105,15,46,228
70362,18,15,2,0,1,17
70363,22,10,6,0,6,16
70364,36,15,15,0,6,30
70365,86,25,34,15,12,74
70366,42,24,10,0,8,34
70367,45,12,20,2,11,34
70368,13,1,10,0,2,11
70369,171,114,27,1,29,142
70370,43,30,1,2,10,33
70371,120,39,40,11,30,90
70372,91,19,40,12,20,71
70373,46,18,20,0,8,38
70374,34,23,5,2,4,30
70375,12,7,2,1,2,10
70376,21,16,2,1,2,19
70377,102,55,29,1,17,85
70378,57,23,24,1,9,48
70379,36,16,9,3,8,28
70380,79,39,21,0,19,60
70381,165,55,55,25,30,135
70382,63,40,8,3,12,51
70383,163,105,11,11,36,127
70384,49,33,6,2,8,41
70385,157,48,81,0,28,129
70386,76,10,43,5,18,58
70387,172,121,14,2,35,137
70388,137,73,34,0,30,107
70389,70,26,23,2,19,51
70390,15,4,8,0,3,12
70391,31,4,22,0,5,26
70392,134,39,66,1,28,106
70393,28,9,10,4,5,23
70394,105,82,7,0,16,89
70395,578,365,93,5,115,463
70396,66,33,15,7,11,55
70397,33,13,12,2,6,27
70398,502,213,146,38,105,397
70399,32,21,9,0,2,30
70400,168,70,34,24,40,128
70401,224,91,42,38,53,171
70402,21,5,14,0,2,19
70403,30,4,15,5,6,24
70404,69,34,6,13,16,53
70405,88,41,22,3,22,66
70406,47,22,12,0,13,34
70407,17,11,2,0,4,13
70408,79,50,17,0,12,67
70409,135,56,52,2,25,110
70410,50,12,16,11,11,39
70411,58,31,11,4,12,46
70412,89,53,23,1,12,77
70413,144,62,27,19,36,108
70414,270,153,30,33,54,216
70415,36,9,16,3,8,28
70416,15,0,12,0,3,12
70417,33,17,8,0,8,25
70418,390,223,87,0,80,310
70419,13,10,2,0,1,12
70420,89,63,5,8,13,76
70421,62,7,43,1,11,51
70422,36,16,9,3,8,28
70423,13,10,1,0,2,11
70424,104,64,29,0,11,93
70425,121,54,23,17,27,94
70426,147,59,31,28,29,118
70427,28,14,8,0,6,22
70428,151,76,50,0,25,126
70429,54,40,2,0,12,42
70430,45,24,12,0,9,36
70431,18,4,9,0,5,13
70432,52,37,3,1,11,41
70433,55,33,11,0,11,44
70434,51,32,1,6,12,39
70435,51,7,38,0,6,45
70436,66,32,12,8,14,52
70437,33,15,10,0,8,25
70438,32,16,6,3,7,25
70439,298,60,181,1,56,242
70440,9,6,0,2,1,8
70441,8,2,4,0,2,6
70442,136,108,1,2,25,111
70443,20,0,19,0,1,19
70444,62,23,21,1,17,45
70445,235,117,72,0,46,189
70446,55,14,30,0,11,44
70447,30,2,24,1,3,27
70448,36,8,15,0,13,23
70449,71,51,4,0,16,55
70450,23,3,12,0,8,15
70451,58,39,11,0,8,50
70452,15,4,9,1,1,14
70453,35,24,5,4,2,33
70454,57,24,15,4,14,43
70455,183,50,58,36,39,144
70456,159,117,13,1,28,131
70457,131,42,47,19,23,108
70458,16,2,13,0,1,15
70459,9,6,2,0,1,8
70460,35,14,11,2,8,27
70461,150,113,10,2,25,125
70462,32,7,20,1,4,28
70463,20,10,5,0,5,15
70464,9,0,5,2,2,7
70465,84,51,18,4,11,73
70466,218,164,13,3,38,180
70467,67,17,34,4,12,55
70468,34,10,15,0,9,25
70469,40,18,16,0,6,34
70470,309,76,151,6,76,233
70471,130,29,50,21,30,100
70472,189,53,103,2,31,158
70473,25,13,6,0,6,19
70474,12,4,4,0,4,8
70475,20,0,15,0,5,15
70476,75,14,45,5,11,64
70477,32,21,9,0,2,30
70478,343,148,120,6,69,274
70479,4,1,1,1,1,3
70480,76,30,34,3,9,67
70481,68,23,28,3,14,54
70482,22,8,6,3,5,17
70483,17,3,12,0,2,15
70484,244,62,50,83,49,195
70485,53,17,24,3,9,44
70486,399,183,116,11,89,310
70487,146,58,31,23,34,112
70488,71,35,12,7,17,54
70489,39,0,26,0,13,26
70490,199,100,50,0,49,150
70491,76,48,15,0,13,63
70492,137,78,23,3,33,104
70493,132,80,9,17,26,106
70494,94,26,36,13,19,75
70495,8,3,4,1,0,8
70496,114,47,16,18,33,81
70497,195,54,36,69,36,159
70498,38,19,9,1,9,29
70499,48,35,2,3,8,40
70500,37,27,0,1,9,28
70501,29,10,11,0,8,21
70502,34,13,13,0,8,26
70503,168,75,54,7,32,136
70504,36,19,12,0,5,31
70505,27,3,16,0,8,19
70506,264,81,125,17,41,223
70507,133,74,22,4,33,100
70508,83,44,24,0,15,68
70509,120,61,32,0,27,93
70510,16,14,0,0,2,14
70511,47,5,30,1,11,36
70512,184,57,58,27,42,142
70513,104,29,49,5,21,83
70514,106,49,18,16,23,83
70515,161,116,22,0,23,138
70516,140,89,31,0,20,120
70517,258,127,77,0,54,204
70518,90,36,32,1,21,69
70519,19,16,0,0,3,16
70520,25,6,15,0,4,21
70521,301,140,94,6,61,240
70522,56,8,33,0,15,41
70523,33,26,3,1,3,30
70524,34,15,10,0,9,25
70525,154,100,3,17,34,120
70526,375,258,35,0,82,293
70527,56,29,7,9,11,45
70528,187,75,44,29,39,148
70529,147,70,25,22,30,117
70530,221,110,45,22,44,177
70531,23,1,14,1,7,16
70532,75,51,9,0,15,60
70533,4,1,3,0,0,4
70534,37,4,20,4,9,28
70535,96,26,36,13,21,75
70536,46,18,20,0,8,38
70537,74,35,4,24,11,63
70538,28,15,4,5,4,24
70539,619,360,142,17,100,519
70540,78,46,18,0,14,64
70541,367,158,129,11,69,298
70542,145,81,28,1,35,110
70543,51,26,17,1,7,44
70544,69,34,24,1,10,59
70545,85,56,15,0,14,71
70546,35,18,9,2,6,29
70547,237,105,87,1,44,193
70548,46,18,20,0,8,38
70549,12,4,7,0,1,11
70550,49,13,28,1,7,42
70551,63,33,14,0,16,47
70552,32,21,9,0,2,30
70553,462,170,153,44,95,367
70554,46,18,20,0,8,38
70555,109,59,25,4,21,88
70556,61,18,33,1,9,52
70557,27,4,15,0,8,19
70558,443,138,183,23,99,344
70559,85,33,15,17,20,65
70560,148,65,28,20,35,113
70561,12,5,3,1,3,9
70562,91,35,14,18,24,67
70563,34,9,22,0,3,31
70564,35,9,15,3,8,27
70565,230,55,73,52,50,180
70566,39,24,8,0,7,32
70567,356,178,102,2,74,282
70568,47,27,5,0,15,32
70569,367,215,76,0,76,291
70570,529,296,115,17,101,428
70571,28,6,16,2,4,24
70572,58,33,16,0,9,49
70573,58,38,7,0,13,45
70574,109,56,17,15,21,88
70575,92,59,12,2,19,73
70576,62,24,17,7,14,48
70577,123,28,37,23,35,88
70578,220,150,30,0,40,180
70579,45,10,15,11,9,36
70580,49,19,25,0,5,44
70581,77,24,37,3,13,64
70582,156,81,45,1,29,127
70583,91,35,36,8,12,79
70584,28,11,9,2,6,22
70585,22,12,6,0,4,18
70586,320,194,56,0,70,250
70587,435,208,108,32,87,348
70588,89,57,13,3,16,73
70589,19,0,11,0,8,11
70590,45,21,15,1,8,37
70591,152,80,47,0,25,127
70592,10,3,5,1,1,9
70593,29,8,15,0,6,23
70594,17,9,4,0,4,13
70595,16,7,3,2,4,12
70596,21,7,4,6,4,17
70597,71,16,31,8,16,55
70598,182,140,2,1,39,143
70599,87,35,34,1,17,70
70600,41,23,10,3,5,36
70601,3,2,0,1,0,3
70602,59,10,32,4,13,46
70603,65,33,13,3,16,49
70604,125,35,58,6,26,99
70605,87,35,35,0,17,70
70606,25,4,9,5,7,18
70607,15,0,12,0,3,12
70608,435,223,106,12,94,341
70609,12,11,0,1,0,12
70610,21,1,14,1,5,16
70611,23,3,12,0,8,15
70612,74,41,13,4,16,58
70613,263,179,19,4,61,202
70614,455,157,156,48,94,361
70615,57,2,46,0,9,48
70616,26,4,16,0,6,20
70617,23,7,12,0,4,19
70618,32,21,9,0,2,30
70619,34,9,14,2,9,25
70620,126,41,35,28,22,104
70621,207,115,51,10,31,176
70622,49,26,10,1,12,37
70623,56,12,32,0,12,44
70624,62,43,10,0,9,53
70625,169,129,5,2,33,136
70626,83,30,20,10,23,60
70627,161,68,34,21,38,123
70628,71,60,2,0,9,62
70629,68,28,24,0,16,52
70630,47,14,25,1,7,40
70631,32,21,9,0,2,30
70632,510,294,98,11,107,403
70633,50,37,1,0,12,38
70634,78,26,32,9,11,67
70635,54,27,17,1,9,45
70636,6,4,2,0,0,6
70637,141,89,28,0,24,117
70638,2,1,1,0,0,2
70639,40,7,25,1,7,33
70640,339,146,118,6,69,270
70641,61,18,22,10,11,50
70642,44,13,11,11,9,35
70643,103,66,10,5,22,81
70644,80,21,38,8,13,67
70645,67,50,6,1,10,57
70646,164,62,46,20,36,128
70647,180,79,66,0,35,145
70648,151,48,52,21,30,121
70649,47,10,27,0,10,37
70650,141,66,44,11,20,121
70651,110,84,2,0,24,86
70652,41,19,11,1,10,31
70653,5,2,2,0,1,4
70654,59,9,34,2,14,45
70655,205,71,21,77,36,169
70656,77,52,9,0,16,61
70657,64,27,26,0,11,53
70658,22,7,7,0,8,14
70659,37,14,5,9,9,28
70660,158,112,22,0,24,134
70661,95,21,32,24,18,77
70662,18,1,14,0,3,15
70663,73,33,19,10,11,62
70664,50,19,18,1,12,38
70665,46,13,11,13,9,37
70666,65,24,6,21,14,51
70667,8,0,6,1,1,7
70668,14,2,4,1,7,7
70669,11,8,2,0,1,10
70670,40,23,7,1,9,31
70671,11,3,5,0,3,8
70672,87,50,19,4,14,73
70673,221,119,34,26,42,179
70674,35,21,5,1,8,27
70675,129,44,50,8,27,102
70676,84,16,41,8,19,65
70677,30,6,19,1,4,26
70678,88,40,32,1,15,73
70679,26,5,5,9,7,19
70680,133,43,39,28,23,110
70681,44,26,16,0,2,42
70682,36,19,8,0,9,27
70683,19,4,13,0,2,17
70684,96,31,49,0,16,80
70685,143,10,84,19,30,113
70686,19,7,5,1,6,13
70687,62,18,24,12,8,54
70688,220,91,14,77,38,182
70689,12,1,7,0,4,8
70690,38,7,24,1,6,32
70691,90,31,31,9,19,71
70692,101,38,38,6,19,82
70693,31,19,3,0,9,22
70694,115,50,39,5,21,94
70695,76,29,30,0,17,59
70696,71,38,3,17,13,58
70697,32,13,10,0,9,23
70698,280,93,127,14,46,234
70699,141,50,36,30,25,116
70700,317,204,44,13,56,261
70701,163,57,78,0,28,135
70702,31,8,4,15,4,27
70703,63,31,12,7,13,50
70704,550,393,45,1,111,439
70705,34,4,17,2,11,23
70706,19,8,5,0,6,13
70707,20,12,5,0,3,17
70708,43,22,14,0,7,36
70709,79,31,30,3,15,64
70710,99,74,2,0,23,76
70711,46,33,3,0,10,36
70712,140,78,24,7,31,109
70713,31,27,1,0,3,28
70714,194,142,14,1,37,157
70715,189,89,47,16,37,152
70716,347,150,123,6,68,279
70717,44,31,5,0,8,36
70718,75,35,28,0,12,63
70719,14,4,2,6,2,12
70720,53,15,19,10,9,44
70721,63,35,8,7,13,50
70722,65,5,57,0,3,62
70723,26,18,0,0,8,18
70724,19,7,11,0,1,18
70725,19,7,6,0,6,13
70726,123,25,67,1,30,93
70727,62,8,40,2,12,50
70728,6,0,6,0,0,6
70729,32,21,9,0,2,30
70730,87,54,18,4,11,76
70731,234,68,113,15,38,196
70732,111,38,44,11,18,93
70733,286,143,82,5,56,230
70734,62,16,23,6,17,45
70735,124,25,43,23,33,91
70736,70,28,28,0,14,56
70737,71,17,30,0,24,47
70738,152,60,61,0,31,121
70739,150,98,15,6,31,119
70740,363,161,127,6,69,294
70741,105,48,19,14,24,81
70742,222,53,29,104,36,186
70743,15,11,3,0,1,14
70744,97,28,40,3,26,71
70745,4,2,2,0,0,4
70746,102,30,56,0,16,86
70747,35,14,13,2,6,29
70748,41,9,14,7,11,30
70749,42,6,27,3,6,36
70750,31,20,3,0,8,23
70751,20,11,5,1,3,17
70752,33,18,11,0,4,29
70753,37,24,2,0,11,26
70754,159,79,24,26,30,129
70755,149,103,22,0,24,125
70756,21,15,5,0,1,20
70757,34,2,25,0,7,27
70758,5,2,0,2,1,4
70759,36,9,14,5,8,28
70760,12,7,5,0,0,12
70761,190,62,61,24,43,147
70762,75,31,8,23,13,62
70763,4,2,0,0,2,2
70764,101,67,15,0,19,82
70765,395,233,82,16,64,331
70766,104,37,26,23,18,86
70767,171,52,87,0,32,139
70768,349,164,86,27,72,277
70769,142,98,18,0,26,116
70770,48,36,0,0,12,36
70771,77,40,20,0,17,60
70772,203,113,29,23,38,165
70773,46,18,20,0,8,38
70774,55,27,21,0,7,48
70775,95,53,25,0,17,78
70776,93,39,35,1,18,75
70777,20,0,16,2,2,18
70778,15,4,10,0,1,14
70779,443,209,96,43,95,348
70780,92,42,25,5,20,72
70781,140,48,48,11,33,107
70782,77,25,27,14,11,66
70783,101,57,24,3,17,84
70784,23,8,13,0,2,21
70785,67,37,19,0,11,56
70786,175,78,28,28,41,134
70787,94,41,31,5,17,77
70788,44,9,28,1,6,38
70789,35,16,6,7,6,29
70790,2,0,2,0,0,2
70791,128,43,46,7,32,96
70792,122,73,11,19,19,103
70793,22,7,6,3,6,16
70794,47,30,12,1,4,43
70795,160,112,23,0,25,135
70796,140,73,46,0,21,119
70797,18,8,8,0,2,16
70798,588,431,39,1,117,471
70799,442,135,184,31,92,350
70800,40,22,9,1,8,32
70801,32,21,9,0,2,30
70802,62,8,40,2,12,50
70803,67,37,10,2,18,49
70804,65,29,17,9,10,55
70805,52,42,1,0,9,43
70806,34,2,26,1,5,29
70807,247,170,17,3,57,190
70808,84,45,24,0,15,69
70809,57,25,10,14,8,49
70810,66,46,7,1,12,54
70811,71,33,24,2,12,59
70812,26,9,6,6,5,21
70813,123,42,48,8,25,98
70814,137,104,4,2,27,110
70815,33,8,18,4,3,30
70816,61,33,9,7,12,49
70817,42,11,21,0,10,32
70818,135,90,15,3,27,108
70819,175,119,17,0,39,136
70820,61,19,24,6,12,49
70821,71,14,35,5,17,54
70822,13,3,8,0,2,11
70823,37,8,13,6,10,27
70824,151,86,18,20,27,124
70825,396,132,158,19,87,309
70826,48,17,21,4,6,42
70827,129,65,25,8,31,98
70828,32,21,9,0,2,30
70829,3,3,0,0,0,3
70830,84,53,5,12,14,70
70831,131,28,47,30,26,105
70832,44,21,13,3,7,37
70833,89,49,25,4,11,78
70834,673,392,147,18,116,557
70835,525,336,78,4,107,418
70836,32,21,9,0,2,30
70837,31,13,10,0,8,23
70838,25,11,8,0,6,19
70839,15,10,3,1,1,14
70840,90,39,8,26,17,73
70841,35,6,7,11,11,24
70842,23,0,19,0,4,19
70843,68,26,31,1,10,58
70844,46,18,20,0,8,38
70845,57,30,11,7,9,48
70846,427,227,114,17,69,358
70847,144,81,26,1,36,108
70848,81,35,21,5,20,61
70849,78,30,9,22,17,61
70850,67,9,47,0,11,56
70851,44,10,24,3,7,37
70852,25,5,1,16,3,22
70853,221,67,105,2,47,174
70854,25,13,6,1,5,20
70855,2,0,1,0,1,1
70856,91,55,7,14,15,76
70857,37,18,13,0,6,31
70858,35,17,8,3,7,28
70859,193,47,29,83,34,159
70860,126,29,43,30,24,102
70861,29,10,11,0,8,21
70862,30,17,7,2,4,26
70863,283,136,80,12,55,228
70864,53,32,10,2,9,44
70865,168,50,94,4,20,148
70866,37,15,14,0,8,29
70867,206,155,22,1,28,178
70868,38,23,5,3,7,31
70869,48,17,23,0,8,40
70870,404,132,171,13,88,316
70871,39,15,11,3,10,29
70872,211,140,23,0,48,163
70873,466,346,22,0,98,368
70874,34,26,3,1,4,30
70875,56,22,21,1,12,44
70876,33,8,16,0,9,24
70877,7,2,3,0,2,5
70878,373,194,107,4,68,305
70879,46,28,4,6,8,38
70880,6,2,3,0,1,5
70881,42,22,8,0,12,30
70882,154,102,29,0,23,131
70883,79,45,13,6,15,64
70884,13,4,8,0,1,12
70885,105,44,47,0,14,91
70886,154,46,10,72,26,128
70887,12,2,6,0,4,8
70888,32,21,9,0,2,30
70889,15,6,2,3,4,11
70890,44,12,18,2,12,32
70891,66,32,13,0,21,45
70892,56,9,36,0,11,45
70893,12,3,5,0,4,8
70894,12,5,3,1,3,9
70895,45,21,15,0,9,36
70896,34,21,7,1,5,29
70897,37,5,25,0,7,30
70898,54,7,33,4,10,44
70899,9,3,6,0,0,9
70900,68,39,12,3,14,54
70901,39,26,9,1,3,36
70902,81,36,30,0,15,66
70903,36,9,18,0,9,27
70904,14,3,7,0,4,10
70905,68,17,38,0,13,55
70906,474,224,154,13,83,391
70907,149,79,33,7,30,119
70908,85,16,52,0,17,68
70909,55,12,26,1,16,39
70910,53,34,13,0,6,47
70911,146,39,10,71,26,120
70912,122,43,45,8,26,96
70913,261,104,96,16,45,216
70914,23,15,4,0,4,19
70915,74,59,1,0,14,60
70916,32,21,9,0,2,30
70917,484,276,75,37,96,388
70918,46,18,20,0,8,38
70919,115,38,53,4,20,95
70920,34,2,25,0,7,27
70921,327,197,62,0,68,259
70922,62,26,8,13,15,47
70923,274,151,63,0,60,214
70924,271,202,15,0,54,217
70925,50,12,30,0,8,42
70926,31,17,9,0,5,26
70927,32,21,9,0,2,30
70928,6,5,0,1,0,6
70929,59,38,7,0,14,45
70930,30,9,7,5,9,21
70931,76,39,20,0,17,59
70932,40,15,19,1,5,35
70933,1,0,1,0,0,1
70934,46,35,0,0,11,35
70935,280,32,196,2,50,230
70936,368,161,131,10,66,302
70937,445,331,20,0,94,351
70938,49,1,39,0,9,40
70939,180,88,33,29,30,150
70940,118,61,33,1,23,95
70941,128,55,30,16,27,101
70942,79,43,16,1,19,60
70943,43,24,11,0,8,35
70944,18,14,1,0,3,15
70945,90,26,36,8,20,70
70946,36,19,6,2,9,27
70947,237,156,36,0,45,192
70948,75,38,16,6,15,60
70949,90,10,49,8,23,67
70950,127,68,11,24,24,103
70951,18,6,8,1,3,15
70952,21,10,7,0,4,17
70953,190,61,61,24,44,146
70954,69,51,7,3,8,61
70955,19,7,9,0,3,16
70956,262,187,14,3,58,204
70957,44,14,18,0,12,32
70958,92,50,15,3,24,68
70959,187,78,43,22,44,143
70960,48,6,34,0,8,40
70961,199,110,49,10,30,169
70962,35,8,17,2,8,27
70963,93,59,12,2,20,73
70964,518,286,126,20,86,432
70965,156,100,3,17,36,120
70966,99,37,33,7,22,77
70967,32,19,6,1,6,26
70968,138,45,36,23,34,104
70969,10,4,4,0,2,8
70970,78,7,48,6,17,61
70971,22,1,17,0,4,18
70972,2,2,0,0,0,2
70973,39,19,11,0,9,30
70974,3,3,0,0,0,3
70975,37,28,1,2,6,31
70976,15,5,9,0,1,14
70977,42,27,7,0,8,34
70978,32,21,9,0,2,30
70979,40,22,13,0,5,35
70980,32,21,9,0,2,30
70981,8,1,6,0,1,7
70982,10,7,0,0,3,7
70983,10,3,3,0,4,6
70984,135,12,95,1,27,108
70985,29,8,12,1,8,21
70986,234,55,24,117,38,196
70987,270,27,189,2,52,218
70988,5,3,0,0,2,3
70989,24,16,5,1,2,22
70990,51,26,10,7,8,43
70991,50,14,25,0,11,39
70992,35,14,14,1,6,29
70993,36,17,11,0,8,28
70994,58,33,3,12,10,48
70995,33,13,14,1,5,28
70996,33,19,6,0,8,25
70997,20,2,13,1,4,16
70998,73,23,23,10,17,56
70999,33,25,5,0,3,30
71000,174,123,14,2,35,139
71001,206,88,42,28,48,158
71002,188,75,45,22,46,142
71003,129,89,9,5,26,103
71004,14,10,1,0,3,11
71005,30,8,15,0,7,23
71006,43,2,28,7,6,37
71007,27,10,12,2,3,24
71008,0,0,0,0,0,0
71009,187,103,54,0,30,157
71010,12,1,5,4,2,10
71011,34,15,11,0,8,26
71012,21,1,14,1,5,16
71013,38,12,16,0,10,28
71014,32,21,9,0,2,30
71015,31,1,23,0,7,24
71016,26,10,11,2,3,23
71017,42,29,1,0,12,30
71018,36,7,22,0,7,29
71019,21,6,9,0,6,15
71020,51,21,20,3,7,44
71021,92,43,18,15,16,76
71022,32,21,9,0,2,30
71023,120,59,31,0,30,90
71024,91,35,16,14,26,65
71025,35,23,7,1,4,31
71026,9,6,3,0,0,9
71027,21,6,12,0,3,18
71028,22,10,8,0,4,18
71029,8,5,1,2,0,8
71030,16,6,7,0,3,13
71031,37,23,6,1,7,30
71032,57,44,6,3,4,53
71033,79,39,22,3,15,64
71034,91,66,6,0,19,72
71035,106,45,21,17,23,83
71036,125,66,31,6,22,103
71037,31,6,14,5,6,25
71038,467,237,121,14,95,372
71039,15,5,5,0,5,10
71040,76,13,7,36,20,56
71041,71,24,31,2,14,57
71042,135,98,6,3,28,107
71043,151,42,70,4,35,116
71044,9,1,7,0,1,8
71045,44,1,31,0,12,32
71046,50,28,13,1,8,42
71047,25,8,8,1,8,17
71048,32,21,9,0,2,30
71049,85,61,7,0,17,68
71050,232,130,55,3,44,188
71051,42,12,20,0,10,32
71052,142,116,4,0,22,120
71053,37,22,6,2,7,30
71054,92,25,53,1,13,79
71055,42,23,10,0,9,33
71056,180,133,13,1,33,147
71057,16,9,2,0,5,11
71058,37,20,11,0,6,31
71059,33,12,11,1,9,24
71060,178,101,33,0,44,134
71061,83,36,24,0,23,60
71062,20,10,7,0,3,17
71063,81,38,5,16,22,59
71064,39,24,8,0,7,32
71065,32,21,9,0,2,30
71066,37,22,10,0,5,32
71067,46,35,2,5,4,42
71068,15,0,12,0,3,12
71069,27,6,16,0,5,22
71070,50,23,20,0,7,43
71071,96,54,19,1,22,74
71072,18,3,5,1,9,9
71073,110,58,20,10,22,88
71074,148,98,26,0,24,124
71075,15,11,2,0,2,13
71076,3,1,0,0,2,1
71077,63,19,29,3,12,51
71078,76,10,43,5,18,58
71079,72,37,16,8,11,61
71080,72,37,18,0,17,55
71081,61,20,22,11,8,53
71082,190,104,57,0,29,161
71083,75,28,30,4,13,62
71084,46,18,20,0,8,38
71085,7,2,3,0,2,5
71086,66,37,12,1,16,50
71087,157,11,91,25,30,127
71088,66,31,19,2,14,52
71089,52,21,17,3,11,41
71090,136,43,65,4,24,112
71091,19,12,5,1,1,18
71092,37,26,7,1,3,34
71093,164,96,38,1,29,135
71094,73,39,19,4,11,62
71095,141,82,12,19,28,113
71096,26,9,10,3,4,22
71097,29,6,14,3,6,23
71098,91,20,48,9,14,77
71099,52,23,13,2,14,38
71100,16,10,4,0,2,14
71101,72,38,14,0,20,52
71102,21,10,6,0,5,16
71103,41,25,8,0,8,33
71104,58,43,9,0,6,52
71105,13,10,3,0,0,13
71106,91,71,1,0,19,72
71107,38,13,14,2,9,29
71108,16,10,3,1,2,14
71109,46,18,20,0,8,38
71110,407,215,103,20,69,338
71111,41,23,9,1,8,33
71112,7,1,5,0,1,6
71113,159,59,49,23,28,131
71114,365,207,81,0,77,288
71115,49,33,6,2,8,41
71116,57,47,0,0,10,47
71117,64,34,15,4,11,53
71118,59,23,16,6,14,45
71119,130,34,48,16,32,98
71120,32,21,9,0,2,30
71121,273,124,98,3,48,225
71122,53,16,27,0,10,43
71123,38,18,16,0,4,34
71124,98,59,12,5,22,76
71125,59,40,10,0,9,50
71126,87,55,17,4,11,76
71127,28,6,13,2,7,21
71128,22,16,3,0,3,19
71129,141,66,26,18,31,110
71130,28,12,11,0,5,23
71131,36,24,2,0,10,26
71132,31,20,3,0,8,23
71133,40,20,11,1,8,32
71134,5,0,4,0,1,4
71135,261,173,36,3,49,212
71136,60,42,5,1,12,48
71137,151,40,85,0,26,125
71138,93,34,31,7,21,72
71139,110,45,26,17,22,88
71140,48,23,15,0,10,38
71141,138,104,3,1,30,108
71142,30,7,12,5,6,24
71143,77,39,20,0,18,59
71144,234,94,14,83,43,191
71145,25,0,20,0,5,20
71146,32,12,6,8,6,26
71147,104,71,9,5,19,85
71148,68,39,16,0,13,55
71149,49,24,11,5,9,40
71150,67,8,32,8,19,48
71151,69,28,18,13,10,59
71152,40,6,24,0,10,30
71153,34,12,15,0,7,27
71154,61,45,1,0,15,46
71155,63,31,15,5,12,51
71156,8,6,0,0,2,6
71157,33,22,5,1,5,28
71158,105,40,29,15,21,84
71159,12,3,7,0,2,10
71160,108,47,30,12,19,89
71161,41,11,21,0,9,32
71162,112,60,24,4,24,88
71163,54,37,5,1,11,43
71164,201,152,7,0,42,159
71165,17,7,9,0,1,16
71166,6,1,3,0,2,4
71167,25,15,7,0,3,22
71168,31,22,2,0,7,24
71169,83,48,19,3,13,70
71170,89,45,5,27,12,77
71171,41,0,33,2,6,35
71172,75,21,26,12,16,59
71173,102,32,49,0,21,81
71174,4,2,1,0,1,3
71175,18,6,5,1,6,12
71176,77,42,22,2,11,66
71177,50,10,30,1,9,41
71178,29,20,3,0,6,23
71179,8,2,4,0,2,6
71180,98,72,16,1,9,89
71181,19,7,7,0,5,14
71182,58,33,16,0,9,49
71183,77,28,31,4,14,63
71184,246,57,25,124,40,206
71185,111,33,56,0,22,89
71186,37,18,11,1,7,30
71187,118,46,40,8,24,94
71188,340,141,123,6,70,270
71189,104,30,57,0,17,87
71190,7,5,0,1,1,6
71191,60,37,12,1,10,50
71192,16,5,8,1,2,14
71193,59,24,25,0,10,49
71194,495,344,51,2,98,397
71195,17,9,5,0,3,14
71196,90,40,26,1,23,67
71197,386,224,84,0,78,308
71198,233,176,13,0,44,189
71199,160,74,56,3,27,133
71200,59,20,25,1,13,46
71201,32,13,11,0,8,24
71202,46,18,20,0,8,38
71203,116,58,20,17,21,95
71204,54,8,28,5,13,41
71205,112,62,27,2,21,91
71206,251,176,16,5,54,197
71207,335,172,94,5,64,271
71208,219,166,18,2,33,186
71209,25,5,16,0,4,21
71210,197,106,34,22,35,162
71211,433,206,121,14,92,341
71212,67,23,31,0,13,54
71213,78,33,10,22,13,65
71214,36,23,7,0,6,30
71215,169,24,80,27,38,131
71216,203,155,19,1,28,175
71217,140,103,9,0,28,112
71218,40,12,21,1,6,34
71219,2,0,2,0,0,2
71220,59,31,11,8,9,50
71221,43,25,6,2,10,33
71222,7,4,1,0,2,5
71223,14,4,3,2,5,9
71224,85,45,17,3,20,65
71225,28,14,6,0,8,20
71226,31,4,9,11,7,24
71227,145,84,34,0,27,118
71228,446,205,148,11,82,364
71229,61,35,9,4,13,48
71230,13,2,6,0,5,8
71231,11,9,0,0,2,9
71232,190,64,58,25,43,147
71233,136,84,19,4,29,107
71234,685,397,157,20,111,574
71235,93,31,22,22,18,75
71236,82,21,38,9,14,68
71237,194,93,62,0,39,155
71238,336,171,105,4,56,280
71239,140,84,20,2,34,106
71240,31,21,3,0,7,24
71241,50,36,2,0,12,38
71242,130,99,4,2,25,105
71243,22,5,15,0,2,20
71244,345,187,89,15,54,291
71245,17,5,7,0,5,12
71246,23,9,7,1,6,17
71247,146,58,37,21,30,116
71248,67,38,9,4,16,51
71249,10,6,2,1,1,9
71250,27,15,6,3,3,24
71251,23,11,11,0,1,22
71252,364,178,116,2,68,296
71253,12,4,5,0,3,9
71254,15,10,3,0,2,13
71255,22,16,3,0,3,19
71256,4,2,1,0,1,3
71257,31,6,13,6,6,25
71258,31,12,10,0,9,22
71259,43,25,10,0,8,35
71260,107,49,30,2,26,81
71261,288,214,12,2,60,228
71262,88,40,33,1,14,74
71263,101,69,6,0,26,75
71264,44,39,1,0,4,40
71265,33,8,19,1,5,28
71266,137,62,50,5,20,117
71267,49,25,17,0,7,42
71268,29,11,10,0,8,21
71269,164,70,35,21,38,126
71270,25,6,11,5,3,22
71271,27,6,12,2,7,20
71272,364,193,104,3,64,300
71273,109,62,10,13,24,85
71274,32,16,7,1,8,24
71275,127,67,29,5,26,101
71276,18,8,6,0,4,14
71277,138,82,30,0,26,112
71278,41,7,27,0,7,34
71279,36,16,9,3,8,28
71280,124,91,5,2,26,98
71281,12,5,5,0,2,10
71282,190,136,13,7,34,156
71283,120,59,24,16,21,99
71284,1,0,1,0,0,1
71285,121,24,58,4,35,86
71286,87,35,12,25,15,72
71287,100,23,48,10,19,81
71288,91,27,39,6,19,72
71289,58,6,40,0,12,46
71290,31,15,8,0,8,23
71291,46,21,14,0,11,35
71292,72,39,3,17,13,59
71293,22,15,6,1,0,22
71294,83,44,24,3,12,71
71295,57,23,23,1,10,47
71296,444,139,193,14,98,346
71297,118,63,11,18,26,92
71298,61,12,30,4,15,46
71299,126,75,21,3,27,99
71300,86,31,28,10,17,69
71301,276,101,116,15,44,232
71302,10,1,4,0,5,5
71303,210,87,41,28,54,156
71304,42,31,2,0,9,33
71305,46,30,12,0,4,42
71306,36,25,8,0,3,33
71307,49,35,6,1,7,42
71308,28,2,12,8,6,22
71309,121,63,28,7,23,98
71310,26,14,8,0,4,22
71311,32,21,9,0,2,30
71312,186,79,61,2,44,142
71313,91,13,43,18,17,74
71314,7,4,1,0,2,5
71315,61,37,9,3,12,49
71316,27,13,6,1,7,20
71317,26,6,14,1,5,21
71318,55,7,35,4,9,46
71319,16,9,5,0,2,14
71320,41,28,1,0,12,29
71321,99,52,28,2,17,82
71322,46,18,20,0,8,38
71323,203,88,62,18,35,168
71324,271,136,74,0,61,210
71325,25,6,10,3,6,19
71326,146,37,76,1,32,114
71327,0,0,0,0,0,0
71328,38,19,13,1,5,33
71329,110,66,21,7,16,94
71330,10,4,3,1,2,8
71331,35,1,26,0,8,27
71332,103,24,64,0,15,88
71333,77,10,53,1,13,64
71334,4,2,1,1,0,4
71335,59,11,33,4,11,48
71336,46,18,20,0,8,38
71337,93,19,47,11,16,77
71338,57,47,0,0,10,47
71339,129,54,30,19,26,103
71340,44,19,15,2,8,36
71341,58,1,49,0,8,50
71342,473,222,122,29,100,373
71343,96,45,15,11,25,71
71344,146,59,58,8,21,125
71345,369,222,71,13,63,306
71346,48,14,24,0,10,38
71347,72,51,6,0,15,57
71348,300,132,102,4,62,238
71349,21,8,10,0,3,18
71350,211,114,48,0,49,162
71351,221,20,161,2,38,183
71352,37,9,17,3,8,29
71353,82,36,11,10,25,57
71354,20,5,10,0,5,15
71355,11,1,9,0,1,10
71356,154,54,39,30,31,123
71357,35,10,17,1,7,28
71358,130,58,45,0,27,103
71359,33,25,5,0,3,30
71360,37,15,11,1,10,27
71361,380,202,104,3,71,309
71362,26,11,8,4,3,23
71363,22,12,4,0,6,16
71364,432,198,138,10,86,346
71365,48,13,19,10,6,42
71366,5,2,1,0,2,3
71367,91,28,29,16,18,73
71368,483,246,116,19,102,381
71369,70,32,25,0,13,57
71370,395,203,117,3,72,323
71371,157,108,26,0,23,134
71372,105,38,33,8,26,79
71373,40,30,0,0,10,30
71374,95,53,19,1,22,73
71375,188,137,14,1,36,152
71376,22,7,9,0,6,16
71377,45,9,22,0,14,31
71378,83,28,29,8,18,65
71379,125,82,15,7,21,104
71380,30,10,7,10,3,27
71381,13,7,4,0,2,11
71382,62,46,5,0,11,51
71383,102,59,20,4,19,83
71384,0,0,0,0,0,0
71385,549,309,114,12,114,435
71386,150,88,27,1,34,116
71387,104,25,57,3,19,85
71388,7,3,1,0,3,4
71389,12,2,6,0,4,8
71390,95,40,35,1,19,76
71391,130,41,25,44,20,110
71392,46,18,20,0,8,38
71393,110,41,38,9,22,88
71394,51,18,16,6,11,40
71395,75,31,27,2,15,60
71396,161,83,47,1,30,131
71397,497,260,92,45,100,397
71398,89,31,18,10,30,59
71399,61,17,20,10,14,47
71400,76,4,54,1,17,59
71401,29,10,9,2,8,21
71402,64,30,17,7,10,54
71403,20,4,11,1,4,16
71404,211,53,109,14,35,176
71405,37,23,9,1,4,33
71406,32,21,9,0,2,30
71407,98,60,17,3,18,80
71408,27,16,8,0,3,24
71409,128,65,22,14,27,101
71410,44,18,17,0,9,35
71411,113,41,35,14,23,90
71412,51,27,14,0,10,41
71413,46,23,7,3,13,33
71414,83,51,18,0,14,69
71415,62,33,17,1,11,51
71416,566,316,116,13,121,445
71417,267,180,22,4,61,206
71418,20,9,5,2,4,16
71419,88,34,18,10,26,62
71420,71,37,18,0,16,55
71421,120,44,36,21,19,101
71422,115,47,40,8,20,95
71423,32,2,23,0,7,25
71424,16,5,8,0,3,13
71425,86,51,16,2,17,69
71426,32,13,13,1,5,27
71427,101,23,47,11,20,81
71428,90,57,15,0,18,72
71429,403,115,164,35,89,314
71430,22,11,6,0,5,17
71431,4,3,0,0,1,3
71432,116,45,26,24,21,95
71433,28,6,15,1,6,22
71434,75,26,20,9,20,55
71435,31,10,14,4,3,28
71436,124,93,4,2,25,99
71437,148,22,98,1,27,121
71438,54,16,25,0,13,41
71439,82,51,13,3,15,67
71440,43,23,11,0,9,34
71441,31,9,18,0,4,27
71442,46,13,11,13,9,37
71443,97,60,17,3,17,80
71444,75,37,20,0,18,57
71445,116,85,4,2,25,91
71446,29,11,14,0,4,25
71447,33,14,11,3,5,28
71448,8,6,0,0,2,6
71449,92,26,48,7,11,81
71450,578,354,102,7,115,463
71451,124,93,3,0,28,96
71452,65,34,16,4,11,54
71453,32,3,21,0,8,24
71454,47,28,12,0,7,40
71455,73,37,23,1,12,61
71456,32,21,9,0,2,30
71457,261,162,39,0,60,201
71458,186,86,59,4,37,149
71459,433,248,98,0,87,346
71460,115,44,26,25,20,95
71461,44,27,3,8,6,38
71462,294,152,98,0,44,250
71463,39,17,16,0,6,33
71464,207,136,53,4,14,193
71465,83,24,49,2,8,75
71466,26,16,4,0,6,20
71467,17,7,7,1,2,15
71468,32,12,16,1,3,29
71469,88,36,16,10,26,62
71470,34,5,21,1,7,27
71471,122,43,60,0,19,103
71472,37,23,3,0,11,26
71473,20,10,6,3,1,19
71474,56,25,14,6,11,45
71475,33,15,12,1,5,28
71476,70,21,28,6,15,55
71477,416,254,69,4,89,327
71478,152,44,69,4,35,117
71479,68,18,34,4,12,56
71480,128,48,46,8,26,102
71481,167,73,53,3,38,129
71482,65,7,49,1,8,57
71483,38,26,2,3,7,31
71484,26,10,11,0,5,21
71485,79,50,15,0,14,65
71486,423,219,99,13,92,331
71487,67,38,18,1,10,57
71488,74,41,7,3,23,51
71489,28,5,11,5,7,21
71490,141,63,44,0,34,107
71491,21,1,4,13,3,18
71492,142,46,73,3,20,122
71493,2,1,0,0,1,1
71494,71,26,13,21,11,60
71495,75,47,14,0,14,61
71496,67,4,52,2,9,58
71497,250,135,74,0,41,209
71498,47,25,11,0,11,36
71499,15,6,2,4,3,12
71500,17,11,4,0,2,15
71501,105,39,34,9,23,82
71502,435,227,98,13,97,338
71503,610,343,147,19,101,509
71504,32,12,12,2,6,26
71505,103,66,10,5,22,81
71506,186,107,22,23,34,152
71507,95,60,19,2,14,81
71508,30,15,10,0,5,25
71509,26,14,4,2,6,20
71510,14,6,3,1,4,10
71511,16,13,0,0,3,13
71512,16,4,8,1,3,13
71513,44,26,9,0,9,35
71514,55,13,25,5,12,43
71515,134,48,30,26,30,104
71516,333,144,121,3,65,268
71517,28,12,14,0,2,26
71518,109,33,56,0,20,89
71519,514,307,111,12,84,430
71520,97,23,32,26,16,81
71521,21,10,7,0,4,17
71522,32,20,8,1,3,29
71523,56,1,21,26,8,48
71524,468,218,151,13,86,382
71525,61,39,8,3,11,50
71526,45,15,21,2,7,38
71527,70,20,39,1,10,60
71528,14,4,4,1,5,9
71529,76,46,16,6,8,68
71530,83,18,40,9,16,67
71531,65,31,9,8,17,48
71532,157,46,55,21,35,122
71533,541,266,113,50,112,429
71534,8,1,6,0,1,7
71535,68,52,6,0,10,58
71536,164,99,37,1,27,137
71537,365,192,93,20,60,305
71538,419,113,168,45,93,326
71539,98,43,34,4,17,81
71540,106,30,49,7,20,86
71541,64,38,16,0,10,54
71542,88,50,22,4,12,76
71543,14,7,2,0,5,9
71544,190,137,15,2,36,154
71545,13,8,2,1,2,11
71546,167,86,21,28,32,135
71547,194,38,55,62,39,155
71548,67,47,1,4,15,52
71549,267,80,130,16,41,226
71550,153,24,101,1,27,126
71551,12,2,8,1,1,11
71552,112,88,3,0,21,91
71553,108,50,18,15,25,83
71554,35,20,4,0,11,24
71555,58,19,25,4,10,48
71556,45,9,22,0,14,31
71557,124,93,6,0,25,99
71558,38,28,2,2,6,32
71559,172,121,18,0,33,139
71560,38,23,5,3,7,31
71561,11,7,2,0,2,9
71562,132,70,37,2,23,109
71563,54,22,15,1,16,38
71564,55,22,20,1,12,43
71565,12,3,9,0,0,12
71566,99,41,29,10,19,80
71567,5,0,5,0,0,5
71568,22,3,13,0,6,16
71569,97,35,38,10,14,83
71570,15,2,6,2,5,10
71571,86,56,16,0,14,72
71572,37,17,4,9,7,30
71573,114,75,10,13,16,98
71574,12,5,3,1,3,9
71575,29,16,2,4,7,22
71576,6,0,4,0,2,4
71577,37,17,10,2,8,29
71578,32,21,9,0,2,30
71579,67,44,6,0,17,50
71580,32,20,2,1,9,23
71581,159,67,33,21,38,121
71582,41,30,2,0,9,32
71583,18,6,4,3,5,13
71584,55,34,10,0,11,44
71585,368,210,81,0,77,291
71586,247,133,74,0,40,207
71587,670,391,143,17,119,551
71588,87,59,8,0,20,67
71589,93,54,26,9,4,89
71590,102,57,21,10,14,88
71591,94,34,33,2,25,69
71592,32,21,9,0,2,30
71593,27,4,0,18,5,22
71594,570,402,45,1,122,448
71595,44,19,15,2,8,36
71596,13,6,3,0,4,9
71597,2,1,1,0,0,2
71598,53,27,16,1,9,44
71599,46,18,20,0,8,38
71600,33,12,11,1,9,24
71601,31,10,14,0,7,24
71602,29,9,7,6,7,22
71603,84,46,22,1,15,69
71604,15,2,10,0,3,12
71605,105,29,58,0,18,87
71606,86,32,38,3,13,73
71607,4,1,3,0,0,4
71608,163,68,35,22,38,125
71609,134,56,52,2,24,110
71610,64,17,22,10,15,49
71611,60,33,16,1,10,50
71612,88,45,25,2,16,72
71613,607,408,67,4,128,479
71614,188,87,45,19,37,151
71615,57,25,19,1,12,45
71616,45,21,9,5,10,35
71617,64,35,14,0,15,49
71618,61,29,14,4,14,47
71619,80,32,30,0,18,62
71620,69,22,19,9,19,50
71621,30,10,12,0,8,22
71622,191,109,25,23,34,157
71623,79,34,16,15,14,65
71624,0,0,0,0,0,0
71625,34,12,14,0,8,26
71626,104,36,42,1,25,79
71627,73,31,20,1,21,52
71628,34,17,12,0,5,29
71629,68,25,34,0,9,59
71630,24,4,13,0,7,17
71631,193,62,90,3,38,155
71632,71,48,7,1,15,56
71633,10,1,6,0,3,7
71634,27,9,11,0,7,20
71635,67,39,13,2,13,54
71636,385,195,114,2,74,311
71637,28,13,5,0,10,18
71638,555,324,112,18,101,454
71639,23,14,0,5,4,19
71640,46,2,36,0,8,38
71641,91,32,40,1,18,73
71642,77,38,16,0,23,54
71643,178,82,58,4,34,144
71644,139,74,32,9,24,115
71645,46,18,20,0,8,38
71646,34,16,12,1,5,29
71647,25,7,13,0,5,20
71648,101,54,22,0,25,76
71649,109,65,19,7,18,91
71650,592,344,124,19,105,487
71651,14,10,0,0,4,10
71652,36,8,18,1,9,27
71653,84,59,5,0,20,64
71654,207,77,77,7,46,161
71655,253,193,10,1,49,204
71656,55,12,13,22,8,47
71657,11,5,3,0,3,8
71658,49,26,6,8,9,40
71659,10,2,5,1,2,8
71660,137,73,26,10,28,109
71661,203,77,76,7,43,160
71662,80,45,19,1,15,65
71663,29,13,12,0,4,25
71664,29,12,7,8,2,27
71665,52,26,16,0,10,42
71666,68,21,26,2,19,49
71667,37,3,28,1,5,32
71668,66,40,9,1,16,50
71669,61,28,18,1,14,47
71670,38,18,16,0,4,34
71671,21,9,9,0,3,18
71672,84,21,45,7,11,73
71673,76,59,2,0,15,61
71674,37,27,0,1,9,28
71675,12,8,4,0,0,12
71676,79,54,11,4,10,69
71677,23,11,8,0,4,19
71678,52,23,16,6,7,45
71679,112,43,42,10,17,95
71680,12,2,9,0,1,11
71681,34,12,19,0,3,31
71682,98,56,26,1,15,83
71683,90,25,41,18,6,84
71684,35,14,11,3,7,28
71685,9,6,0,0,3,6
71686,116,40,30,20,26,90
71687,58,25,21,0,12,46
71688,32,7,19,3,3,29
71689,25,5,14,1,5,20
71690,30,4,8,11,7,23
71691,95,42,28,1,24,71
71692,274,89,127,15,43,231
71693,680,406,135,23,116,564
71694,87,47,21,4,15,72
71695,45,30,2,0,13,32
71696,177,76,26,30,45,132
71697,266,195,11,0,60,206
71698,96,28,36,12,20,76
71699,102,45,9,24,24,78
71700,29,16,5,4,4,25
71701,49,14,22,6,7,42
71702,60,20,28,1,11,49
71703,64,5,45,0,14,50
71704,33,9,18,0,6,27
71705,38,26,8,0,4,34
71706,25,13,4,0,8,17
71707,373,146,107,39,81,292
71708,29,11,13,0,5,24
71709,52,23,13,2,14,38
71710,52,42,1,0,9,43
71711,73,36,19,4,14,59
71712,127,28,40,24,35,92
71713,232,92,14,83,43,189
71714,11,8,1,0,2,9
71715,190,111,24,21,34,156
71716,55,20,22,1,12,43
71717,109,59,25,4,21,88
71718,95,36,18,12,29,66
71719,64,27,19,1,17,47
71720,586,427,40,1,118,468
71721,73,32,22,3,16,57
71722,70,40,15,3,12,58
71723,388,226,82,17,63,325
71724,652,376,143,18,115,537
71725,35,2,25,0,8,27
71726,43,27,3,7,6,37
71727,387,172,133,11,71,316
71728,48,12,20,5,11,37
71729,20,12,2,0,6,14
71730,88,62,5,9,12,76
71731,66,26,26,3,11,55
71732,33,3,6,17,7,26
71733,272,160,55,0,57,215
71734,40,13,20,1,6,34
71735,429,317,22,0,90,339
71736,37,15,14,0,8,29
71737,142,98,22,1,21,121
71738,282,124,105,2,51,231
71739,52,22,20,1,9,43
71740,26,12,8,0,6,20
71741,95,62,14,2,17,78
71742,176,20,95,25,36,140
71743,14,3,6,0,5,9
71744,285,161,33,33,58,227
71745,322,90,150,6,76,246
71746,76,66,0,1,9,67
71747,5,0,4,0,1,4
71748,114,72,17,3,22,92
71749,51,27,14,0,10,41
71750,34,19,11,0,4,30
71751,380,171,130,11,68,312
71752,100,29,45,6,20,80
71753,81,46,14,0,21,60
71754,90,34,38,0,18,72
71755,50,23,12,6,9,41
71756,4,3,0,1,0,4
71757,137,50,65,0,22,115
71758,155,55,38,30,32,123
71759,15,3,5,4,3,12
71760,351,179,104,4,64,287
71761,30,2,22,1,5,25
71762,39,6,26,1,6,33
71763,358,272,19,2,65,293
71764,21,8,10,0,3,18
71765,55,26,8,8,13,42
71766,47,14,16,9,8,39
71767,176,107,47,13,9,167
71768,24,18,2,0,4,20
71769,48,11,27,1,9,39
71770,187,88,48,15,36,151
71771,32,21,9,0,2,30
71772,75,9,43,5,18,57
71773,229,97,47,27,58,171
71774,79,46,18,2,13,66
71775,174,67,44,25,38,136
71776,494,261,87,50,96,398
71777,2,1,0,0,1,1
71778,393,105,153,46,89,304
71779,115,47,41,6,21,94
71780,38,19,9,1,9,29
71781,11,3,6,0,2,9
71782,44,11,19,6,8,36
71783,15,3,6,1,5,10
71784,377,160,121,24,72,305
71785,43,8,22,1,12,31
71786,50,20,14,4,12,38
71787,152,99,3,16,34,118
71788,57,20,25,2,10,47
71789,56,16,33,0,7,49
71790,524,379,35,1,109,415
71791,32,10,14,3,5,27
71792,575,409,45,1,120,455
71793,183,98,26,23,36,147
71794,132,103,6,0,23,109
71795,72,29,13,14,16,56
71796,50,23,13,3,11,39
71797,53,9,31,2,11,42
71798,84,53,17,0,14,70
71799,549,405,33,1,110,439
71800,7,3,3,0,1,6
71801,43,18,12,1,12,31
71802,49,15,21,1,12,37
71803,78,39,26,1,12,66
71804,51,28,4,3,16,35
71805,108,29,51,2,26,82
71806,143,96,18,0,29,114
71807,10,5,1,2,2,8
71808,181,66,57,26,32,149
71809,31,14,6,5,6,25
71810,23,9,10,1,3,20
71811,64,9,47,4,4,60
71812,46,16,20,0,10,36
71813,258,125,90,0,43,215
71814,15,8,3,0,4,11
71815,113,75,2,13,23,90
71816,32,21,9,0,2,30
71817,82,39,5,16,22,60
71818,11,4,3,3,1,10
71819,116,45,14,38,19,97
71820,33,22,7,0,4,29
71821,42,30,5,0,7,35
71822,16,9,2,1,4,12
71823,246,188,13,0,45,201
71824,163,111,27,0,25,138
71825,60,16,25,11,8,52
71826,54,26,21,0,7,47
71827,48,19,18,2,9,39
71828,57,42,9,0,6,51
71829,153,106,20,2,25,128
71830,134,105,11,0,18,116
71831,18,4,5,8,1,17
71832,63,42,13,0,8,55
71833,57,25,14,3,15,42
71834,102,48,35,4,15,87
71835,88,45,25,2,16,72
71836,20,1,13,1,5,15
71837,39,9,19,3,8,31
71838,125,50,41,5,29,96
71839,7,6,0,0,1,6
71840,18,13,3,0,2,16
71841,33,21,5,1,6,27
71842,13,5,5,0,3,10
71843,12,4,7,0,1,11
71844,8,2,3,0,3,5
71845,23,0,21,0,2,21
71846,49,13,27,0,9,40
71847,33,23,0,0,10,23
71848,115,61,34,0,20,95
71849,178,66,47,33,32,146
71850,101,54,19,9,19,82
71851,75,58,6,1,10,65
71852,1,1,0,0,0,1
71853,67,25,28,0,14,53
71854,45,28,10,0,7,38
71855,112,62,24,0,26,86
71856,171,114,27,1,29,142
71857,458,210,158,9,81,377
71858,17,2,12,0,3,14
71859,60,39,5,4,12,48
71860,32,14,12,0,6,26
71861,38,22,8,0,8,30
71862,19,8,5,0,6,13
71863,189,89,47,16,37,152
71864,558,383,52,1,122,436
71865,82,25,44,0,13,69
71866,89,26,25,21,17,72
71867,57,7,41,0,9,48
71868,111,85,2,0,24,87
71869,38,19,9,1,9,29
71870,19,9,5,0,5,14
71871,67,39,14,3,11,56
71872,53,6,34,0,13,40
71873,77,49,12,2,14,63
71874,156,112,20,0,24,132
71875,23,1,19,0,3,20
71876,61,23,20,3,15,46
71877,106,83,7,0,16,90
71878,18,12,4,0,2,16
71879,144,113,5,6,20,124
71880,87,55,9,4,19,68
71881,28,13,11,1,3,25
71882,7,1,2,0,4,3
71883,24,7,15,0,2,22
71884,78,41,9,18,10,68
71885,171,114,27,1,29,142
71886,18,5,11,1,1,17
71887,55,38,2,0,15,40
71888,224,75,84,15,50,174
71889,9,8,0,0,1,8
71890,129,60,47,5,17,112
71891,74,4,53,0,17,57
71892,62,44,4,0,14,48
71893,35,9,20,0,6,29
71894,49,33,6,2,8,41
71895,17,1,12,1,3,14
71896,30,23,0,0,7,23
71897,56,21,18,5,12,44
71898,20,9,3,3,5,15
71899,20,1,8,9,2,18
71900,61,26,19,3,13,48
71901,17,0,13,0,4,13
71902,158,75,53,2,28,130
71903,5,0,4,1,0,5
71904,199,134,21,0,44,155
71905,38,21,3,7,7,31
71906,32,21,9,0,2,30
71907,143,67,48,5,23,120
71908,152,70,43,0,39,113
71909,35,15,13,1,6,29
71910,14,4,8,0,2,12
71911,320,240,13,2,65,255
71912,232,79,89,15,49,183
71913,39,25,4,1,9,30
71914,57,20,26,0,11,46
71915,63,32,14,5,12,51
71916,60,19,22,11,8,52
71917,69,26,25,2,16,53
71918,123,51,31,19,22,101
71919,147,42,80,0,25,122
71920,341,146,120,6,69,272
71921,28,11,10,1,6,22
71922,127,71,37,1,18,109
71923,449,155,153,48,93,356
71924,27,8,9,0,10,17
71925,46,18,20,0,8,38
71926,46,18,20,0,8,38
71927,18,0,15,0,3,15
71928,40,28,7,0,5,35
71929,121,44,56,0,21,100
71930,65,37,12,2,14,51
71931,38,22,3,0,13,25
71932,293,144,79,12,58,235
71933,68,46,5,3,14,54
71934,34,12,17,2,3,31
71935,107,45,22,21,19,88
71936,113,50,22,14,27,86
71937,15,5,3,2,5,10
71938,77,30,37,1,9,68
71939,19,7,8,0,4,15
71940,12,2,10,0,0,12
71941,103,58,14,11,20,83
71942,46,18,20,0,8,38
71943,19,4,13,0,2,17
71944,72,35,12,7,18,54
71945,17,6,5,1,5,12
71946,202,28,94,33,47,155
71947,23,10,6,4,3,20
71948,64,42,5,0,17,47
71949,48,28,14,0,6,42
71950,68,31,19,0,18,50
71951,47,9,27,0,11,36
71952,47,21,19,0,7,40
71953,267,20,196,2,49,218
71954,57,28,21,0,8,49
71955,149,41,69,4,35,114
71956,88,40,23,3,22,66
71957,246,132,34,30,50,196
71958,180,45,65,27,43,137
71959,80,26,35,4,15,65
71960,74,25,37,2,10,64
71961,2,1,0,0,1,1
71962,63,23,4,27,9,54
71963,13,2,9,0,2,11
71964,12,1,8,0,3,9
71965,231,157,33,0,41,190
71966,36,19,10,0,7,29
71967,11,1,7,0,3,8
71968,5,1,3,0,1,4
71969,5,1,3,0,1,4
71970,181,14,133,0,34,147
71971,13,6,2,2,3,10
71972,64,45,4,6,9,55
71973,9,2,3,0,4,5
71974,14,2,6,2,4,10
71975,62,40,12,0,10,52
71976,29,9,13,2,5,24
71977,90,29,19,23,19,71
71978,74,19,46,0,9,65
71979,33,12,14,0,7,26
71980,34,13,13,0,8,26
71981,18,3,12,0,3,15
71982,16,5,6,0,5,11
71983,28,12,5,5,6,22
71984,22,8,6,2,6,16
71985,75,47,17,0,11,64
71986,48,18,17,1,12,36
71987,28,13,5,0,10,18
71988,38,28,3,0,7,31
71989,311,151,61,39,60,251
71990,62,32,14,3,13,49
71991,70,23,39,0,8,62
71992,35,17,8,4,6,29
71993,10,6,1,0,3,7
71994,415,192,136,7,80,335
71995,73,37,9,17,10,63
71996,82,40,19,2,21,61
71997,113,69,22,0,22,91
71998,133,48,29,26,30,103
71999,27,15,2,4,6,21
72000,148,118,6,0,24,124
72001,179,81,59,5,34,145
72002,82,39,5,16,22,60
72003,36,0,30,0,6,30
72004,66,41,6,3,16,50
72005,345,250,17,2,76,269
72006,38,14,18,2,4,34
72007,27,5,15,4,3,24
72008,166,89,58,4,15,151
72009,44,32,4,0,8,36
72010,40,8,18,0,14,26
72011,169,82,53,3,31,138
72012,107,31,41,10,25,82
72013,88,40,34,1,13,75
72014,78,45,18,2,13,65
72015,359,158,127,6,68,291
72016,570,336,127,15,92,478
72017,41,4,29,0,8,33
72018,33,8,11,4,10,23
72019,4,1,3,0,0,4
72020,71,42,8,3,18,53
72021,96,25,48,3,20,76
72022,34,11,15,1,7,27
72023,40,28,1,1,10,30
72024,22,10,8,0,4,18
72025,177,71,55,7,44,133
72026,2,1,1,0,0,2
72027,28,6,16,0,6,22
72028,95,52,29,1,13,82
72029,273,153,35,32,53,220
72030,44,32,4,0,8,36
72031,6,2,4,0,0,6
72032,108,35,53,1,19,89
72033,4,1,3,0,0,4
72034,41,12,19,1,9,32
72035,156,121,9,3,23,133
72036,557,316,136,17,88,469
72037,39,8,13,8,10,29
72038,48,33,8,1,6,42
72039,117,41,43,8,25,92
72040,55,24,15,2,14,41
72041,23,2,17,0,4,19
72042,4,1,2,0,1,3
72043,15,2,7,0,6,9
72044,88,33,35,7,13,75
72045,73,39,9,5,20,53
72046,123,42,44,7,30,93
72047,67,42,15,0,10,57
72048,188,39,98,1,50,138
72049,497,257,92,49,99,398
72050,17,6,5,1,5,12
72051,83,25,20,27,11,72
72052,591,427,43,1,120,471
72053,45,28,15,0,2,43
72054,8,2,4,0,2,6
72055,71,39,15,4,13,58
72056,32,19,6,0,7,25
72057,46,23,12,1,10,36
72058,33,1,7,19,6,27
72059,32,21,9,0,2,30
72060,109,59,25,4,21,88
72061,106,54,30,4,18,88
72062,56,13,20,6,17,39
72063,46,18,20,0,8,38
72064,437,207,122,14,94,343
72065,79,27,31,10,11,68
72066,474,219,157,13,85,389
72067,355,155,126,6,68,287
72068,49,8,28,4,9,40
72069,72,36,10,8,18,54
72070,231,158,32,0,41,190
72071,44,19,9,8,8,36
72072,112,37,36,12,27,85
72073,102,37,24,20,21,81
72074,88,54,13,5,16,72
72075,26,10,11,0,5,21
72076,84,27,26,9,22,62
72077,58,41,9,2,6,52
72078,46,18,20,0,8,38
72079,77,10,44,5,18,59
72080,32,21,9,0,2,30
72081,36,15,12,3,6,30
72082,49,31,11,0,7,42
72083,199,108,31,21,39,160
72084,56,3,41,1,11,45
72085,7,5,0,2,0,7
72086,72,42,10,4,16,56
72087,154,72,45,0,37,117
72088,37,16,11,0,10,27
72089,14,7,2,0,5,9
72090,32,21,9,0,2,30
72091,209,89,62,20,38,171
72092,40,27,7,0,6,34
72093,226,172,8,0,46,180
72094,81,44,22,4,11,70
72095,106,41,33,9,23,83
72096,23,6,11,0,6,17
72097,157,80,46,1,30,127
72098,10,1,5,0,4,6
72099,37,17,6,7,7,30
72100,12,4,5,0,3,9
72101,44,8,18,9,9,35
72102,28,16,5,0,7,21
72103,231,21,166,2,42,189
72104,130,72,29,0,29,101
72105,32,7,20,2,3,29
72106,4,3,0,1,0,4
72107,58,40,4,1,13,45
72108,14,7,4,0,3,11
72109,507,265,93,47,102,405
72110,3,2,0,0,1,2
72111,35,16,10,0,9,26
72112,80,41,20,2,17,63
72113,26,19,4,0,3,23
72114,125,49,29,16,31,94
72115,80,51,12,2,15,65
72116,327,168,83,19,57,270
72117,160,7,127,0,26,134
72118,13,1,9,0,3,10
72119,70,38,20,1,11,59
72120,101,47,33,1,20,81
72121,584,409,51,1,123,461
72122,39,13,18,0,8,31
72123,114,66,16,9,23,91
72124,72,35,13,7,17,55
72125,144,51,47,17,29,115
72126,31,10,4,11,6,25
72127,46,18,20,0,8,38
72128,28,9,9,3,7,21
72129,20,5,11,0,4,16
72130,69,21,32,5,11,58
72131,86,52,19,4,11,75
72132,35,24,3,0,8,27
72133,16,6,2,4,4,12
72134,12,3,6,0,3,9
72135,347,97,165,6,79,268
72136,34,2,25,0,7,27
72137,105,48,29,2,26,79
72138,163,85,42,6,30,133
72139,145,69,49,5,22,123
72140,243,150,42,5,46,197
72141,221,55,31,99,36,185
72142,320,181,67,0,72,248
72143,47,17,20,4,6,41
72144,34,2,25,0,7,27
72145,5,4,1,0,0,5
72146,44,19,13,2,10,34
72147,164,77,49,6,32,132
72148,59,28,21,1,9,50
72149,52,9,27,6,10,42
72150,358,164,120,6,68,290
72151,314,177,66,0,71,243
72152,10,0,10,0,0,10
72153,102,53,29,0,20,82
72154,76,54,2,2,18,58
72155,48,11,21,9,7,41
72156,99,47,15,23,14,85
72157,147,108,6,0,33,114
72158,25,1,20,0,4,21
72159,16,5,3,4,4,12
72160,70,47,7,1,15,55
72161,80,43,19,1,17,63
72162,64,5,45,0,14,50
72163,72,44,15,0,13,59
72164,60,22,27,0,11,49
72165,28,14,7,2,5,23
72166,57,20,26,0,11,46
72167,19,3,9,2,5,14
72168,19,8,4,2,5,14
72169,93,19,41,12,21,72
72170,39,22,10,0,7,32
72171,14,7,3,0,4,10
72172,419,197,119,13,90,329
72173,26,12,9,0,5,21
72174,90,48,27,4,11,79
72175,46,18,20,0,8,38
72176,218,148,30,0,40,178
72177,50,25,10,7,8,42
72178,148,31,51,35,31,117
72179,47,29,10,0,8,39
72180,51,9,29,2,11,40
72181,30,10,13,4,3,27
72182,32,21,9,0,2,30
72183,20,9,5,0,6,14
72184,20,9,4,1,6,14
72185,138,40,61,4,33,105
72186,45,10,23,0,12,33
72187,140,75,37,0,28,112
72188,75,20,29,13,13,62
72189,69,41,11,0,17,52
72190,44,4,30,0,10,34
72191,120,57,42,3,18,102
72192,228,98,15,76,39,189
72193,88,65,9,0,14,74
72194,197,105,49,0,43,154
72195,83,68,2,0,13,70
72196,518,278,95,40,105,413
72197,45,11,24,0,10,35
72198,24,16,3,0,5,19
72199,0,0,0,0,0,0
72200,125,28,39,24,34,91
72201,139,58,46,8,27,112
72202,95,66,7,9,13,82
72203,51,22,19,3,7,44
72204,38,28,0,1,9,29
72205,46,18,20,0,8,38
72206,25,5,10,4,6,19
72207,29,6,21,0,2,27
72208,49,8,27,5,9,40
72209,32,21,9,0,2,30
72210,67,28,7,19,13,54
72211,146,59,45,9,33,113
72212,7,0,7,0,0,7
72213,476,134,201,39,102,374
72214,67,47,6,0,14,53
72215,130,71,29,8,22,108
72216,60,9,35,2,14,46
72217,53,19,22,0,12,41
72218,8,2,2,0,4,4
72219,229,65,112,15,37,192
72220,17,1,14,0,2,15
72221,93,48,13,2,30,63
72222,46,18,20,0,8,38
72223,96,63,11,2,20,76
72224,110,42,35,7,26,84
72225,7,5,0,0,2,5
72226,228,111,64,0,53,175
72227,344,206,47,27,64,280
72228,21,9,7,0,5,16
72229,222,68,105,2,47,175
72230,93,48,28,1,16,77
72231,8,0,7,0,1,7
72232,6,3,1,0,2,4
72233,97,40,31,1,25,72
72234,79,38,16,6,19,60
72235,33,15,5,4,9,24
72236,428,132,157,49,90,338
72237,35,1,27,1,6,29
72238,32,21,9,0,2,30
72239,108,43,15,17,33,75
72240,22,3,14,0,5,17
72241,257,144,35,29,49,208
72242,88,73,3,0,12,76
72243,153,98,30,0,25,128
72244,127,43,46,8,30,97
72245,77,37,20,8,12,65
72246,41,8,13,9,11,30
72247,25,3,14,1,7,18
72248,69,34,13,7,15,54
72249,80,47,18,1,14,66
72250,57,39,4,1,13,44
72251,16,4,9,0,3,13
72252,65,42,13,1,9,56
72253,140,46,52,8,34,106
72254,40,25,5,1,9,31
72255,211,114,34,23,40,171
72256,89,41,26,11,11,78
72257,10,0,7,0,3,7
72258,47,15,21,2,9,38
72259,110,35,35,14,26,84
72260,140,66,43,10,21,119
72261,112,33,42,10,27,85
72262,174,84,46,14,30,144
72263,37,26,1,0,10,27
72264,43,22,10,0,11,32
72265,585,391,60,6,128,457
72266,5,4,1,0,0,5
72267,43,9,14,9,11,32
72268,77,4,56,0,17,60
72269,178,101,33,0,44,134
72270,3,2,0,0,1,2
72271,67,28,17,6,16,51
72272,237,113,80,0,44,193
72273,43,11,20,0,12,31
72274,433,208,108,32,85,348
72275,46,18,20,0,8,38
72276,56,14,20,7,15,41
72277,121,28,42,30,21,100
72278,219,149,30,0,40,179
72279,64,47,3,0,14,50
72280,44,12,22,1,9,35
72281,42,0,37,0,5,37
72282,69,35,23,4,7,62
72283,41,15,14,5,7,34
72284,126,86,17,2,21,105
72285,492,227,108,55,102,390
72286,51,35,3,0,13,38
72287,56,16,30,0,10,46
72288,32,21,9,0,2,30
72289,4,2,1,0,1,3
72290,24,5,15,0,4,20
72291,82,36,14,14,18,64
72292,419,309,20,0,90,329
72293,46,18,20,0,8,38
72294,12,0,10,0,2,10
72295,117,55,38,3,21,96
72296,475,248,85,43,99,376
72297,349,152,124,6,67,282
72298,205,77,40,38,50,155
72299,121,45,17,39,20,101
72300,67,31,24,0,12,55
72301,31,12,16,0,3,28
72302,75,17,44,0,14,61
72303,64,42,5,0,17,47
72304,28,4,12,4,8,20
72305,0,0,0,0,0,0
72306,97,49,16,2,30,67
72307,113,55,19,17,22,91
72308,80,41,14,6,19,61
72309,116,49,51,1,15,101
72310,94,46,29,2,17,77
72311,61,34,13,0,14,47
72312,47,14,27,1,5,42
72313,159,115,10,0,34,125
72314,40,5,29,1,5,35
72315,94,59,19,2,14,80
72316,48,18,15,4,11,37
72317,53,2,26,19,6,47
72318,39,24,8,0,7,32
72319,679,407,134,21,117,562
72320,467,220,143,12,92,375
72321,102,26,56,3,17,85
72322,35,23,7,0,5,30
72323,43,3,33,0,7,36
72324,62,22,19,11,10,52
72325,42,13,16,8,5,37
72326,15,6,4,3,2,13
72327,43,28,10,0,5,38
72328,218,92,14,76,36,182
72329,46,18,20,0,8,38
72330,27,19,5,1,2,25
72331,43,14,20,2,7,36
72332,27,10,12,0,5,22
72333,88,42,22,1,23,65
72334,33,3,6,17,7,26
72335,7,4,3,0,0,7
72336,33,3,6,17,7,26
72337,25,15,4,0,6,19
72338,20,10,5,4,1,19
72339,68,11,8,29,20,48
72340,10,6,2,0,2,8
72341,85,26,38,5,16,69
72342,68,26,23,6,13,55
72343,37,25,4,3,5,32
72344,501,268,84,48,101,400
72345,59,19,15,14,11,48
72346,197,145,14,1,37,160
72347,46,18,20,0,8,38
72348,32,21,9,0,2,30
72349,72,49,7,0,16,56
72350,155,63,31,31,30,125
72351,229,54,31,106,38,191
72352,161,65,56,16,24,137
72353,1025,385,402,46,192,833
72354,133,73,24,4,32,101
72355,86,57,15,0,14,72
72356,113,47,45,5,16,97
72357,80,38,29,4,9,71
72358,9,9,0,0,0,9
72359,46,13,11,13,9,37
72360,15,7,4,1,3,12
72361,328,153,96,14,65,263
72362,46,18,20,0,8,38
72363,484,202,126,51,105,379
72364,450,216,91,44,99,351
72365,32,15,8,1,8,24
72366,26,15,5,0,6,20
72367,134,34,75,0,25,109
72368,182,88,37,26,31,151
72369,40,7,28,0,5,35
72370,193,99,33,27,34,159
72371,48,17,21,4,6,42
72372,33,13,11,1,8,25
72373,414,194,135,11,74,340
72374,56,8,31,4,13,43
72375,44,32,4,0,8,36
72376,85,53,17,0,15,70
72377,38,11,20,0,7,31
72378,342,131,101,37,73,269
72379,545,401,32,1,111,434
72380,86,35,16,16,19,67
72381,133,37,45,18,33,100
72382,70,44,8,4,14,56
72383,224,19,165,2,38,186
72384,36,23,6,0,7,29
72385,25,10,8,1,6,19
72386,32,21,9,0,2,30
72387,572,329,120,17,106,466
72388,35,7,18,1,9,26
72389,70,23,25,4,18,52
72390,81,35,33,0,13,68
72391,133,80,27,0,26,107
72392,8,1,6,0,1,7
72393,28,15,9,0,4,24
72394,29,20,3,1,5,24
72395,19,6,11,0,2,17
72396,25,13,4,0,8,17
72397,19,9,5,0,5,14
72398,391,178,97,34,82,309
72399,59,19,28,4,8,51
72400,12,2,6,0,4,8
72401,209,50,30,93,36,173
72402,97,32,40,9,16,81
72403,38,6,17,3,12,26
72404,137,50,65,0,22,115
72405,14,7,2,3,2,12
72406,11,1,9,0,1,10
72407,252,157,42,6,47,205
72408,91,43,24,4,20,71
72409,39,28,3,2,6,33
72410,31,13,7,6,5,26
72411,9,2,5,0,2,7
72412,581,428,37,1,115,466
72413,96,22,50,0,24,72
72414,12,6,4,0,2,10
72415,20,9,5,2,4,16
72416,110,39,28,20,23,87
72417,307,156,83,15,53,254
72418,36,19,8,3,6,30
72419,173,80,54,3,36,137
72420,40,30,1,0,9,31
72421,35,1,27,1,6,29
72422,57,22,15,6,14,43
72423,84,67,4,2,11,73
72424,92,64,8,0,20,72
72425,61,42,6,1,12,49
72426,92,29,33,12,18,74
72427,59,7,38,2,12,47
72428,47,7,32,0,8,39
72429,149,97,25,3,24,125
72430,17,11,3,0,3,14
72431,14,5,5,1,3,11
72432,148,58,62,4,24,124
72433,62,27,21,4,10,52
72434,82,27,43,0,12,70
72435,56,36,7,0,13,43
72436,567,324,120,17,106,461
72437,462,220,143,13,86,376
72438,41,12,19,0,10,31
72439,14,2,9,0,3,11
72440,38,14,16,0,8,30
72441,7,1,4,0,2,5
72442,47,17,19,2,9,38
72443,150,97,27,1,25,125
72444,69,36,11,7,15,54
72445,92,67,7,0,18,74
72446,18,7,4,1,6,12
72447,59,15,26,6,12,47
72448,27,17,3,0,7,20
72449,147,72,27,17,31,116
72450,359,156,125,11,67,292
72451,37,8,13,11,5,32
72452,19,10,5,0,4,15
72453,473,222,144,12,95,378
72454,621,363,142,16,100,521
72455,33,14,11,0,8,25
72456,50,29,16,0,5,45
72457,151,71,41,0,39,112
72458,145,79,29,1,36,109
72459,56,23,24,2,7,49
72460,14,0,10,0,4,10
72461,177,72,35,28,42,135
72462,40,20,10,1,9,31
72463,297,144,74,19,60,237
72464,11,5,2,0,4,7
72465,389,243,56,21,69,320
72466,56,13,20,6,17,39
72467,19,15,3,0,1,18
72468,400,289,32,0,79,321
72469,94,49,22,9,14,80
72470,191,129,20,0,42,149
72471,428,240,100,0,88,340
72472,111,44,38,7,22,89
72473,22,2,18,0,2,20
72474,37,9,19,0,9,28
72475,84,34,29,1,20,64
72476,70,33,15,4,18,52
72477,35,18,8,0,9,26
72478,116,52,38,1,25,91
72479,99,67,11,0,21,78
72480,38,10,18,2,8,30
72481,64,37,17,0,10,54
72482,170,113,27,1,29,141
72483,46,18,20,0,8,38
72484,19,7,7,0,5,14
72485,87,55,17,4,11,76
72486,37,25,2,1,9,28
72487,19,6,5,2,6,13
72488,14,9,0,2,3,11
72489,18,0,14,0,4,14
72490,504,244,106,56,98,406
72491,49,25,10,6,8,41
72492,72,18,38,1,15,57
72493,11,3,4,0,4,7
72494,70,36,21,0,13,57
72495,26,11,12,0,3,23
72496,10,6,4,0,0,10
72497,144,57,32,26,29,115
72498,10,8,1,0,1,9
72499,124,55,19,18,32,92
72500,41,7,23,3,8,33
72501,9,7,0,0,2,7
72502,315,87,147,6,75,240
72503,60,37,13,3,7,53
72504,137,50,51,14,22,115
72505,32,1,29,0,2,30
72506,55,25,13,6,11,44
72507,25,8,10,4,3,22
72508,29,9,15,0,5,24
72509,49,33,6,2,8,41
72510,27,16,6,0,5,22
72511,43,26,8,0,9,34
72512,44,19,7,7,11,33
72513,70,22,27,12,9,61
72514,64,44,9,2,9,55
72515,230,113,63,13,41,189
72516,122,56,27,16,23,99
72517,32,16,4,5,7,25
72518,42,7,16,8,11,31
72519,19,13,4,0,2,17
72520,24,14,7,0,3,21
72521,62,13,31,5,13,49
72522,18,11,4,0,3,15
72523,81,39,5,16,21,60
72524,362,178,116,1,67,295
72525,118,28,36,22,32,86
72526,543,265,114,53,111,432
72527,29,3,17,0,9,20
72528,69,58,0,0,11,58
72529,32,21,9,0,2,30
72530,53,22,6,17,8,45
72531,177,35,51,54,37,140
72532,77,47,19,0,11,66
72533,76,36,20,0,20,56
72534,87,71,0,4,12,75
72535,152,63,35,20,34,118
72536,38,20,9,1,8,30
72537,76,43,19,0,14,62
72538,28,7,7,6,8,20
72539,41,17,8,6,10,31
72540,97,58,18,3,18,79
72541,160,109,26,0,25,135
72542,36,9,20,0,7,29
72543,17,1,13,1,2,15
72544,76,27,37,0,12,64
72545,77,40,17,3,17,60
72546,10,3,5,0,2,8
72547,25,8,11,0,6,19
72548,40,30,0,0,10,30
72549,66,19,8,26,13,53
72550,73,29,29,0,15,58
72551,48,30,1,5,12,36
72552,55,22,12,10,11,44
72553,60,15,29,2,14,46
72554,36,19,10,0,7,29
72555,230,157,32,0,41,189
72556,130,43,35,29,23,107
72557,72,27,22,8,15,57
72558,58,11,34,4,9,49
72559,12,1,9,0,2,10
72560,34,18,3,0,13,21
72561,28,6,12,2,8,20
72562,43,26,10,1,6,37
72563,50,17,26,0,7,43
72564,3,2,0,0,1,2
72565,104,28,37,16,23,81
72566,19,13,2,2,2,17
72567,17,10,5,1,1,16
72568,443,217,119,14,93,350
72569,42,13,21,0,8,34
72570,134,103,5,2,24,110
72571,26,17,3,0,6,20
72572,60,50,2,0,8,52
72573,154,68,32,23,31,123
72574,5,2,2,0,1,4
72575,40,22,10,1,7,33
72576,18,7,7,0,4,14
72577,11,7,2,0,2,9
72578,78,32,21,4,21,57
72579,90,34,35,8,13,77
72580,72,47,9,2,14,58
72581,406,190,138,7,71,335
72582,114,45,38,8,23,91
72583,28,10,12,1,5,23
72584,37,10,12,4,11,26
72585,40,23,7,4,6,34
72586,16,8,5,0,3,13
72587,39,18,11,0,10,29
72588,141,59,28,23,31,110
72589,57,27,15,6,9,48
72590,99,37,23,16,23,76
72591,138,12,97,2,27,111
72592,183,124,18,0,41,142
72593,420,213,100,26,81,339
72594,30,13,10,1,6,24
72595,67,25,7,22,13,54
72596,72,23,27,0,22,50
72597,72,44,15,0,13,59
72598,67,20,22,15,10,57
72599,235,155,23,3,54,181
72600,101,60,24,0,17,84
72601,217,46,54,75,42,175
72602,79,24,26,9,20,59
72603,63,32,7,4,20,43
72604,157,78,36,10,33,124
72605,324,164,91,15,54,270
72606,66,52,2,0,12,54
72607,68,10,46,0,12,56
72608,75,36,16,0,23,52
72609,49,4,8,23,14,35
72610,6,1,4,0,1,5
72611,17,7,8,0,2,15
72612,66,26,29,0,11,55
72613,45,23,7,3,12,33
72614,32,16,8,0,8,24
72615,192,75,34,34,49,143
72616,41,19,7,3,12,29
72617,147,37,76,1,33,114
72618,124,78,30,0,16,108
72619,154,106,22,0,26,128
72620,32,15,9,1,7,25
72621,62,2,45,0,15,47
72622,33,17,9,2,5,28
72623,89,29,34,5,21,68
72624,48,24,11,1,12,36
72625,72,27,6,25,14,58
72626,165,86,39,0,40,125
72627,616,422,61,2,131,485
72628,88,47,12,2,27,61
72629,82,58,6,0,18,64
72630,43,12,21,0,10,33
72631,138,63,50,5,20,118
72632,243,101,15,83,44,199
72633,45,13,19,2,11,34
72634,43,19,12,0,12,31
72635,191,60,80,13,38,153
72636,67,19,32,5,11,56
72637,54,12,27,2,13,41
72638,69,43,13,2,11,58
72639,154,70,29,19,36,118
72640,115,48,40,2,25,90
72641,58,16,30,0,12,46
72642,14,2,8,0,4,10
72643,46,18,20,0,8,38
72644,489,300,81,3,105,384
72645,72,28,24,2,18,54
72646,83,20,45,7,11,72
72647,24,10,7,2,5,19
72648,92,41,34,1,16,76
72649,27,1,18,0,8,19
72650,44,31,4,1,8,36
72651,24,9,10,1,4,20
72652,55,31,14,0,10,45
72653,111,33,57,1,20,91
72654,37,17,11,1,8,29
72655,11,0,7,0,4,7
72656,62,25,19,0,18,44
72657,127,79,13,9,26,101
72658,43,7,26,2,8,35
72659,60,11,33,0,16,44
72660,74,28,25,11,10,64
72661,11,9,0,0,2,9
72662,111,63,29,1,18,93
72663,58,10,34,4,10,48
72664,87,35,24,11,17,70
72665,24,4,11,1,8,16
72666,130,106,8,0,16,114
72667,31,13,10,0,8,23
72668,62,42,7,0,13,49
72669,45,29,6,2,8,37
72670,132,36,48,16,32,100
72671,139,28,48,24,39,100
72672,264,153,23,33,55,209
72673,156,77,48,1,30,126
72674,48,23,17,0,8,40
72675,38,23,10,1,4,34
72676,52,14,17,7,14,38
72677,46,18,20,0,8,38
72678,94,50,19,0,25,69
72679,14,0,12,0,2,12
72680,28,7,7,5,9,19
72681,188,97,50,7,34,154
72682,475,233,92,48,102,373
72683,44,25,8,4,7,37
72684,50,11,23,1,15,35
72685,167,127,7,0,33,134
72686,642,378,143,18,103,539
72687,9,5,2,0,2,7
72688,25,5,1,16,3,22
72689,51,16,24,2,9,42
72690,32,21,9,0,2,30
72691,85,56,15,0,14,71
72692,681,382,164,23,112,569
72693,76,28,22,17,9,67
72694,39,23,7,3,6,33
72695,221,151,30,0,40,181
72696,30,14,13,0,3,27
72697,120,42,49,11,18,102
72698,202,60,20,92,30,172
72699,245,188,11,2,44,201
72700,6,0,4,0,2,4
72701,29,7,17,0,5,24
72702,130,91,16,0,23,107
72703,7,0,7,0,0,7
72704,193,89,48,19,37,156
72705,9,7,0,1,1,8
72706,27,12,8,0,7,20
72707,31,7,19,0,5,26
72708,62,17,29,2,14,48
72709,77,37,4,24,12,65
72710,33,19,11,0,3,30
72711,12,5,5,1,1,11
72712,87,45,25,0,17,70
72713,29,12,9,0,8,21
72714,59,40,1,4,14,45
72715,46,18,20,0,8,38
72716,488,273,74,40,101,387
72717,16,2,14,0,0,16
72718,139,62,41,9,27,112
72719,61,18,23,5,15,46
72720,35,23,6,0,6,29
72721,51,22,23,1,5,46
72722,43,28,6,0,9,34
72723,250,185,13,1,51,199
72724,32,21,9,0,2,30
72725,32,21,9,0,2,30
72726,69,38,21,0,10,59
72727,322,241,19,2,60,262
72728,47,28,12,0,7,40
72729,77,45,14,1,17,60
72730,29,8,7,5,9,20
72731,50,25,17,0,8,42
72732,86,41,30,0,15,71
72733,86,56,21,0,9,77
72734,53,34,4,2,13,40
72735,15,7,6,0,2,13
72736,555,402,35,1,117,438
72737,105,36,47,10,12,93
72738,11,0,8,0,3,8
72739,31,15,9,0,7,24
72740,121,57,33,0,31,90
72741,289,199,22,2,66,223
72742,127,75,22,3,27,100
72743,27,15,5,0,7,20
72744,662,391,140,17,114,548
72745,52,11,38,0,3,49
72746,345,146,124,6,69,276
72747,171,114,27,1,29,142
72748,154,55,43,31,25,129
72749,80,41,20,2,17,63
72750,64,37,12,2,13,51
72751,81,43,21,3,14,67
72752,88,59,11,0,18,70
72753,129,44,49,8,28,101
72754,24,3,0,13,8,16
72755,32,21,9,0,2,30
72756,124,68,22,2,32,92
72757,78,59,8,0,11,67
72758,112,48,14,17,33,79
72759,486,243,92,52,99,387
72760,111,47,24,21,19,92
72761,86,46,7,14,19,67
72762,612,342,151,20,99,513
72763,16,11,2,0,3,13
72764,161,103,9,12,37,124
72765,67,14,32,4,17,50
72766,59,40,4,1,14,45
72767,46,21,13,6,6,40
72768,463,231,123,13,96,367
72769,226,96,81,2,47,179
72770,34,7,23,0,4,30
72771,51,31,7,2,11,40
72772,96,37,5,42,12,84
72773,53,12,26,1,14,39
72774,674,394,150,19,111,563
72775,26,6,15,0,5,21
72776,18,1,14,0,3,15
72777,122,96,6,0,20,102
72778,25,18,0,0,7,18
72779,84,42,17,9,16,68
72780,32,21,9,0,2,30
72781,126,31,61,5,29,97
72782,27,2,11,8,6,21
72783,322,132,131,5,54,268
72784,172,83,36,23,30,142
72785,65,44,8,0,13,52
72786,48,34,4,0,10,38
72787,31,3,18,1,9,22
72788,73,46,15,0,12,61
72789,19,2,12,0,5,14
72790,171,65,43,25,38,133
72791,39,9,12,7,11,28
72792,193,139,11,7,36,157
72793,107,63,8,11,25,82
72794,91,16,41,17,17,74
72795,326,135,132,5,54,272
72796,47,28,7,2,10,37
72797,5,0,5,0,0,5
72798,88,27,23,21,17,71
72799,30,11,15,1,3,27
72800,91,39,19,11,22,69
72801,55,26,17,1,11,44
72802,44,4,27,4,9,35
72803,57,23,12,8,14,43
72804,673,393,144,17,119,554
72805,157,84,37,0,36,121
72806,46,10,15,9,12,34
72807,648,383,129,20,116,532
72808,286,159,70,7,50,236
72809,155,54,65,7,29,126
72810,68,25,24,2,17,51
72811,139,77,28,5,29,110
72812,131,46,56,0,29,102
72813,33,7,18,1,7,26
72814,62,23,14,17,8,54
72815,157,77,48,1,31,126
72816,42,21,14,0,7,35
72817,152,63,35,20,34,118
72818,142,63,45,9,25,117
72819,100,66,17,0,17,83
72820,66,43,11,1,11,55
72821,88,46,22,0,20,68
72822,223,150,33,0,40,183
72823,167,73,53,3,38,129
72824,161,92,21,20,28,133
72825,63,16,35,0,12,51
72826,208,159,6,2,41,167
72827,97,28,39,3,27,70
72828,36,7,22,0,7,29
72829,123,77,23,0,23,100
72830,25,9,9,2,5,20
72831,63,39,14,1,9,54
72832,60,29,21,4,6,54
72833,42,28,8,0,6,36
72834,54,39,2,1,12,42
72835,78,23,39,1,15,63
72836,511,277,113,13,108,403
72837,76,40,16,2,18,58
72838,441,203,147,12,79,362
72839,39,2,27,2,8,31
72840,382,276,21,0,85,297
72841,32,13,12,2,5,27
72842,17,6,8,0,3,14
72843,159,84,40,6,29,130
72844,209,69,83,15,42,167
72845,46,18,20,0,8,38
72846,8,2,4,0,2,6
72847,58,48,0,1,9,49
72848,77,43,12,5,17,60
72849,35,17,10,3,5,30
72850,83,67,4,2,10,73
72851,243,62,33,109,39,204
72852,647,378,144,15,110,537
72853,16,0,15,0,1,15
72854,18,5,6,4,3,15
72855,34,21,4,0,9,25
72856,57,33,17,0,7,50
72857,59,33,17,0,9,50
72858,125,61,44,1,19,106
72859,66,22,19,17,8,58
72860,129,30,62,4,33,96
72861,15,5,8,0,2,13
72862,55,5,9,28,13,42
72863,169,31,106,1,31,138
72864,485,242,92,49,102,383
72865,126,56,37,8,25,101
72866,147,66,45,10,26,121
72867,10,3,5,0,2,8
72868,76,42,10,3,21,55
72869,83,46,22,4,11,72
72870,99,70,7,2,20,79
72871,141,62,31,18,30,111
72872,16,8,4,0,4,12
72873,22,9,8,0,5,17
72874,31,28,0,0,3,28
72875,86,37,21,13,15,71
72876,210,57,54,59,40,170
72877,92,27,38,10,17,75
72878,201,91,57,12,41,160
72879,132,67,16,19,30,102
72880,20,0,15,0,5,15
72881,20,3,0,10,7,13
72882,147,60,45,9,33,114
72883,55,27,13,3,12,43
72884,56,25,21,1,9,47
72885,210,117,32,23,38,172
72886,141,40,65,3,33,108
72887,129,40,47,17,25,104
72888,353,155,111,10,77,276
72889,125,33,57,6,29,96
72890,40,10,16,6,8,32
72891,223,168,9,0,46,177
72892,35,12,14,0,9,26
72893,38,16,16,0,6,32
72894,57,0,39,3,15,42
72895,7,5,1,0,1,6
72896,140,56,44,9,31,109
72897,75,34,24,0,17,58
72898,48,17,4,19,8,40
72899,417,192,117,27,81,336
72900,22,2,17,0,3,19
72901,46,18,20,0,8,38
72902,32,17,6,2,7,25
72903,51,25,18,2,6,45
72904,103,55,22,7,19,84
72905,33,7,19,0,7,26
72906,233,142,9,31,51,182
72907,1026,385,403,46,192,834
72908,182,93,53,0,36,146
72909,391,237,66,6,82,309
72910,13,5,5,0,3,10
72911,2,0,2,0,0,2
72912,105,34,37,13,21,84
72913,109,55,27,7,20,89
72914,16,5,8,0,3,13
72915,32,21,9,0,2,30
72916,52,37,3,5,7,45
72917,213,161,7,2,43,170
72918,14,3,8,0,3,11
72919,50,29,9,1,11,39
72920,37,16,8,5,8,29
72921,11,9,0,0,2,9
72922,38,0,32,0,6,32
72923,38,13,21,1,3,35
72924,174,91,46,0,37,137
72925,56,3,41,1,11,45
72926,34,18,10,0,6,28
72927,249,191,13,0,45,204
72928,82,42,20,0,20,62
72929,31,15,9,0,7,24
72930,85,36,24,3,22,63
72931,23,0,21,0,2,21
72932,34,19,7,2,6,28
72933,204,85,34,38,47,157
72934,196,106,58,0,32,164
72935,71,30,22,0,19,52
72936,26,3,20,1,2,24
72937,52,0,42,2,8,44
72938,179,127,14,1,37,142
72939,21,3,14,0,4,17
72940,27,18,5,0,4,23
72941,170,18,93,23,36,134
72942,198,55,53,51,39,159
72943,183,131,15,1,36,147
72944,90,52,18,5,15,75
72945,122,50,36,9,27,95
72946,203,51,40,78,34,169
72947,153,54,38,30,31,122
72948,74,54,7,3,10,64
72949,35,18,7,5,5,30
72950,16,2,10,1,3,13
72951,6,1,2,0,3,3
72952,81,39,31,1,10,71
72953,8,0,6,1,1,7
72954,24,9,10,0,5,19
72955,155,72,49,5,29,126
72956,67,47,1,4,15,52
72957,185,126,23,5,31,154
72958,5,0,2,1,2,3
72959,2,0,2,0,0,2
72960,20,6,6,3,5,15
72961,56,28,14,1,13,43
72962,73,23,27,10,13,60
72963,17,5,4,0,8,9
72964,42,8,23,0,11,31
72965,50,32,7,0,11,39
72966,235,118,58,20,39,196
72967,20,3,10,1,6,14
72968,19,3,16,0,0,19
72969,409,232,94,0,83,326
72970,75,49,5,8,13,62
72971,17,4,9,0,4,13
72972,40,1,34,0,5,35
72973,33,11,13,0,9,24
72974,65,24,14,13,14,51
72975,54,2,42,0,10,44
72976,51,17,16,3,15,36
72977,376,257,40,1,78,298
72978,95,37,33,10,15,80
72979,117,46,28,21,22,95
72980,36,13,16,0,7,29
72981,214,73,80,15,46,168
72982,19,6,11,0,2,17
72983,41,14,16,1,10,31
72984,133,52,34,15,32,101
72985,202,142,45,2,13,189
72986,127,75,22,3,27,100
72987,24,3,15,0,6,18
72988,64,21,25,4,14,50
72989,149,64,47,9,29,120
72990,60,19,28,4,9,51
72991,33,24,0,2,7,26
72992,14,8,4,0,2,12
72993,23,19,1,0,3,20
72994,195,77,35,34,49,146
72995,83,18,32,15,18,65
72996,422,135,175,16,96,326
72997,32,21,9,0,2,30
72998,218,75,81,15,47,171
72999,71,32,27,1,11,60
73000,109,48,30,12,19,90
73001,224,91,42,38,53,171
73002,202,30,94,32,46,156
73003,56,18,25,4,9,47
73004,177,39,100,9,29,148
73005,34,19,8,0,7,27
73006,22,10,6,1,5,17
73007,58,9,35,0,14,44
73008,7,3,2,0,2,5
73009,158,100,3,18,37,121
73010,63,5,9,30,19,44
73011,4,1,3,0,0,4
73012,376,188,117,1,70,306
73013,65,31,21,0,13,52
73014,21,12,2,5,2,19
73015,100,35,26,21,18,82
73016,52,36,5,3,8,44
73017,167,31,104,1,31,136
73018,90,19,31,22,18,72
73019,225,63,112,4,46,179
73020,13,3,8,0,2,11
73021,32,21,9,0,2,30
73022,11,7,1,0,3,8
73023,591,408,55,1,127,464
73024,447,237,108,14,88,359
73025,59,30,14,4,11,48
73026,95,31,36,3,25,70
73027,72,37,15,0,20,52
73028,35,17,8,3,7,28
73029,24,2,16,4,2,22
73030,48,30,6,0,12,36
73031,21,13,4,0,4,17
73032,5,0,0,0,5,0
73033,643,358,157,24,104,539
73034,99,50,29,0,20,79
73035,75,51,7,1,16,59
73036,34,14,10,2,8,26
73037,30,4,8,11,7,23
73038,143,111,1,1,30,113
73039,21,11,5,0,5,16
73040,188,84,62,10,32,156
73041,56,22,23,1,10,46
73042,86,66,8,1,11,75
73043,17,5,7,0,5,12
73044,229,125,51,15,38,191
73045,9,1,5,0,3,6
73046,261,200,15,0,46,215
73047,89,54,21,0,14,75
73048,11,8,1,0,2,9
73049,54,21,23,1,9,45
73050,79,15,36,13,15,64
73051,6,3,2,0,1,5
73052,16,5,9,2,0,16
73053,13,2,9,0,2,11
73054,41,11,26,0,4,37
73055,67,32,14,0,21,46
73056,94,45,31,0,18,76
73057,135,45,63,4,23,112
73058,397,233,82,16,66,331
73059,9,2,4,0,3,6
73060,55,38,2,0,15,40
73061,14,5,4,3,2,12
73062,17,3,11,0,3,14
73063,35,20,7,0,8,27
73064,19,10,2,3,4,15
73065,224,75,85,15,49,175
73066,76,45,19,2,10,66
73067,64,33,7,5,19,45
73068,109,76,9,6,18,91
73069,24,7,9,0,8,16
73070,12,0,11,0,1,11
73071,126,75,21,3,27,99
73072,77,55,2,2,18,59
73073,90,57,17,0,16,74
73074,233,169,16,4,44,189
73075,117,59,20,17,21,96
73076,42,19,18,0,5,37
73077,37,15,12,4,6,31
73078,31,19,3,0,9,22
73079,8,4,3,0,1,7
73080,141,80,22,3,36,105
73081,159,98,33,0,28,131
73082,126,75,21,3,27,99
73083,61,25,21,3,12,49
73084,96,53,26,0,17,79
73085,240,21,173,2,44,196
73086,135,63,39,5,28,107
73087,7,5,1,0,1,6
73088,4,2,1,0,1,3
73089,55,22,20,1,12,43
73090,78,29,29,9,11,67
73091,94,26,21,35,12,82
73092,77,40,25,4,8,69
73093,46,11,24,1,10,36
73094,46,25,13,2,6,40
73095,344,149,121,6,68,276
73096,122,63,30,6,23,99
73097,16,7,5,0,4,12
73098,35,4,27,0,4,31
73099,196,81,53,23,39,157
73100,22,11,7,0,4,18
73101,201,111,29,23,38,163
73102,84,27,35,7,15,69
73103,175,120,42,2,11,164
73104,46,18,20,0,8,38
73105,100,47,15,24,14,86
73106,11,9,0,0,2,9
73107,131,75,39,9,8,123
73108,112,32,33,25,22,90
73109,1,0,1,0,0,1
73110,80,37,28,1,14,66
73111,22,1,17,0,4,18
73112,11,2,9,0,0,11
73113,139,102,9,0,28,111
73114,30,17,7,2,4,26
73115,45,25,6,2,12,33
73116,6,0,4,0,2,4
73117,52,38,8,0,6,46
73118,55,39,6,1,9,46
73119,65,30,19,2,14,51
73120,33,15,10,0,8,25
73121,52,16,17,7,12,40
73122,131,71,36,0,24,107
73123,64,33,7,5,19,45
73124,92,55,17,5,15,77
73125,84,34,36,1,13,71
73126,73,5,52,1,15,58
73127,152,12,108,0,32,120
73128,13,1,8,1,3,10
73129,30,12,14,1,3,27
73130,46,17,15,4,10,36
73131,24,5,6,9,4,20
73132,13,6,1,0,6,7
73133,131,66,28,6,31,100
73134,25,19,3,0,3,22
73135,393,130,160,17,86,307
73136,130,91,21,0,18,112
73137,71,48,6,3,14,57
73138,6,0,5,0,1,5
73139,348,260,19,2,67,281
73140,153,88,38,1,26,127
73141,55,39,6,1,9,46
73142,107,42,38,6,21,86
73143,106,50,20,17,19,87
73144,129,48,39,16,26,103
73145,47,17,22,0,8,39
73146,22,1,16,1,4,18
73147,31,8,11,5,7,24
73148,77,54,14,0,9,68
73149,70,26,7,22,15,55
73150,474,261,76,41,96,378
73151,52,24,18,1,9,43
73152,44,14,16,8,6,38
73153,91,30,19,23,19,72
73154,3,1,0,0,2,1
73155,42,25,5,7,5,37
73156,151,24,99,1,27,124
73157,156,106,3,15,32,124
73158,43,9,18,8,8,35
73159,198,109,39,14,36,162
73160,136,32,74,1,29,107
73161,220,74,83,15,48,172
73162,101,52,31,1,17,84
73163,62,36,14,0,12,50
73164,155,59,39,22,35,120
73165,75,23,35,4,13,62
73166,41,32,1,0,8,33
73167,32,21,3,1,7,25
73168,14,6,1,3,4,10
73169,92,59,12,2,19,73
73170,88,36,32,7,13,75
73171,71,37,17,0,17,54
73172,45,19,17,2,7,38
73173,25,6,13,1,5,20
73174,62,30,15,5,12,50
73175,88,56,11,2,19,69
73176,57,21,26,0,10,47
73177,287,25,205,2,55,232
73178,103,67,7,7,22,81
73179,595,410,56,1,128,467
73180,26,8,9,1,8,18
73181,15,6,6,0,3,12
73182,110,30,59,0,21,89
73183,4,1,2,0,1,3
73184,101,42,22,18,19,82
73185,68,8,54,0,6,62
73186,133,37,60,3,33,100
73187,188,134,13,9,32,156
73188,153,65,34,25,29,124
73189,156,25,102,1,28,128
73190,48,10,30,0,8,40
73191,200,134,22,0,44,156
73192,40,23,8,2,7,33
73193,44,18,16,3,7,37
73194,34,21,6,3,4,30
73195,49,19,26,0,4,45
73196,15,3,8,3,1,14
73197,107,70,4,12,21,86
73198,459,228,116,19,96,363
73199,48,30,6,3,9,39
73200,12,5,4,2,1,11
73201,32,11,8,2,11,21
73202,75,37,11,8,19,56
73203,102,64,20,0,18,84
73204,76,43,15,4,14,62
73205,55,9,27,5,14,41
73206,96,30,46,1,19,77
73207,27,14,6,2,5,22
73208,55,25,22,2,6,49
73209,17,4,6,2,5,12
73210,370,276,19,2,73,297
73211,134,57,54,1,22,112
73212,32,21,9,0,2,30
73213,37,7,10,16,4,33
73214,63,37,13,0,13,50
73215,206,84,66,20,36,170
73216,60,46,4,0,10,50
73217,29,17,6,0,6,23
73218,121,49,29,14,29,92
73219,46,18,20,0,8,38
73220,84,32,34,1,17,67
73221,20,11,7,0,2,18
73222,21,15,1,1,4,17
73223,73,34,21,0,18,55
73224,70,46,4,10,10,60
73225,98,66,9,4,19,79
73226,46,18,20,0,8,38
73227,20,9,8,0,3,17
73228,31,2,24,0,5,26
73229,219,91,44,27,57,162
73230,209,110,48,0,51,158
73231,35,6,21,0,8,27
73232,315,165,75,19,56,259
73233,20,2,6,9,3,17
73234,2,1,0,0,1,1
73235,71,19,26,10,16,55
73236,63,43,9,2,9,54
73237,25,2,14,0,9,16
73238,42,13,16,7,6,36
73239,210,128,35,6,41,169
73240,20,16,2,0,2,18
73241,83,51,18,0,14,69
73242,32,23,3,0,6,26
73243,418,133,174,23,88,330
73244,24,10,10,0,4,20
73245,8,2,4,0,2,6
73246,68,32,22,0,14,54
73247,104,39,34,7,24,80
73248,47,34,7,0,6,41
73249,48,29,6,2,11,37
73250,167,72,32,20,43,124
73251,131,68,30,4,29,102
73252,9,2,5,0,2,7
73253,29,14,3,6,6,23
73254,2,1,1,0,0,2
73255,32,21,9,0,2,30
73256,31,6,17,3,5,26
73257,9,3,3,0,3,6
73258,78,20,45,1,12,66
73259,141,59,51,3,28,113
73260,11,2,5,1,3,8
73261,138,56,55,2,25,113
73262,17,1,14,0,2,15
73263,149,59,48,9,33,116
73264,65,23,31,2,9,56
73265,38,19,11,0,8,30
73266,67,35,21,1,10,57
73267,221,75,83,15,48,173
73268,86,19,52,8,7,79
73269,32,25,4,0,3,29
73270,81,42,9,19,11,70
73271,56,38,12,0,6,50
73272,112,28,32,22,30,82
73273,133,47,31,26,29,104
73274,12,1,8,0,3,9
73275,193,94,61,0,38,155
73276,277,134,67,19,57,220
73277,222,177,8,0,37,185
73278,147,64,54,1,28,119
73279,59,28,25,1,5,54
73280,60,13,31,0,16,44
73281,96,37,41,0,18,78
73282,33,13,11,1,8,25
73283,79,48,17,0,14,65
73284,28,16,5,0,7,21
73285,23,5,13,2,3,20
73286,62,42,5,0,15,47
73287,31,10,12,0,9,22
73288,92,26,43,2,21,71
73289,27,5,15,0,7,20
73290,107,58,29,0,20,87
73291,391,173,135,11,72,319
73292,128,42,49,13,24,104
73293,27,5,5,10,7,20
73294,26,8,15,0,3,23
73295,119,53,36,2,28,91
73296,64,41,10,0,13,51
73297,47,37,1,0,9,38
73298,61,17,33,3,8,53
73299,154,25,100,1,28,126
73300,58,18,15,14,11,47
73301,37,8,20,0,9,28
73302,42,6,26,0,10,32
73303,479,225,155,11,88,391
73304,99,32,34,13,20,79
73305,31,12,9,0,10,21
73306,54,17,19,7,11,43
73307,62,38,12,0,12,50
73308,48,12,20,5,11,37
73309,162,88,22,21,31,131
73310,69,46,9,0,14,55
73311,20,2,17,0,1,19
73312,5,0,4,0,1,4
73313,9,3,5,0,1,8
73314,91,48,24,1,18,73
73315,54,33,14,0,7,47
73316,14,6,3,3,2,12
73317,66,42,8,2,14,52
73318,32,21,9,0,2,30
73319,43,14,24,0,5,38
73320,24,15,3,0,6,18
73321,150,41,12,70,27,123
73322,439,139,187,14,99,340
73323,40,4,29,0,7,33
73324,170,113,27,1,29,141
73325,26,17,6,1,2,24
73326,58,14,30,1,13,45
73327,135,92,19,1,23,112
73328,68,25,16,14,13,55
73329,87,55,11,2,19,68
73330,61,27,22,1,11,50
73331,46,18,20,0,8,38
73332,86,21,26,27,12,74
73333,33,9,17,0,7,26
73334,7,0,5,0,2,5
73335,347,188,89,15,55,292
73336,74,37,18,0,19,55
73337,56,17,12,18,9,47
73338,63,42,4,0,17,46
73339,36,22,9,0,5,31
73340,66,19,31,1,15,51
73341,144,100,6,3,35,109
73342,62,37,14,1,10,52
73343,387,220,89,0,78,309
73344,281,127,103,5,46,235
73345,467,222,95,49,101,366
73346,92,30,41,6,15,77
73347,120,91,3,0,26,94
73348,14,7,2,4,1,13
73349,147,79,39,0,29,118
73350,688,400,157,19,112,576
73351,146,109,3,4,30,116
73352,50,28,11,0,11,39
73353,142,110,1,1,30,112
73354,96,60,23,0,13,83
73355,518,239,120,45,114,404
73356,26,10,11,0,5,21
73357,396,226,90,0,80,316
73358,22,18,0,0,4,18
73359,51,29,9,3,10,41
73360,6,3,2,0,1,5
73361,135,69,41,0,25,110
73362,364,181,99,14,70,294
73363,24,16,5,0,3,21
73364,123,56,46,1,20,103
73365,13,4,7,0,2,11
73366,17,7,1,3,6,11
73367,167,31,67,31,38,129
73368,95,67,11,0,17,78
73369,67,36,15,4,12,55
73370,16,9,4,0,3,13
73371,43,34,1,0,8,35
73372,11,1,5,0,5,6
73373,13,5,4,0,4,9
73374,0,0,0,0,0,0
73375,64,27,26,0,11,53
73376,45,10,22,0,13,32
73377,88,47,12,2,27,61
73378,23,5,8,4,6,17
73379,178,36,66,34,42,136
73380,9,3,5,0,1,8
73381,19,9,5,0,5,14
73382,88,44,5,27,12,76
73383,71,4,51,0,16,55
73384,14,0,12,0,2,12
73385,32,21,9,0,2,30
73386,80,52,11,0,17,63
73387,110,60,28,2,20,90
73388,154,72,48,5,29,125
73389,20,16,3,0,1,19
73390,38,19,9,1,9,29
73391,43,2,35,0,6,37
73392,8,1,6,0,1,7
73393,46,20,10,8,8,38
73394,46,18,20,0,8,38
73395,46,18,20,0,8,38
73396,66,18,3,31,14,52
73397,26,6,11,2,7,19
73398,466,253,116,21,76,390
73399,39,31,2,0,6,33
73400,65,44,14,1,6,59
73401,84,41,24,0,19,65
73402,28,6,18,0,4,24
73403,72,38,14,8,12,60
73404,198,63,82,14,39,159
73405,47,27,13,0,7,40
73406,42,6,19,12,5,37
73407,95,66,8,0,21,74
73408,89,45,5,27,12,77
73409,669,373,166,22,108,561
73410,259,161,38,0,60,199
73411,127,75,22,3,27,100
73412,54,17,25,0,12,42
73413,20,5,8,0,7,13
73414,94,48,14,2,30,64
73415,136,52,47,14,23,113
73416,46,18,20,0,8,38
73417,129,44,49,8,28,101
73418,18,7,6,0,5,13
73419,33,13,12,2,6,27
73420,45,29,9,0,7,38
73421,51,29,3,11,8,43
73422,34,12,11,5,6,28
73423,126,36,40,24,26,100
73424,136,78,22,3,33,103
73425,18,9,6,0,3,15
73426,64,30,14,10,10,54
73427,64,42,5,0,17,47
73428,42,5,30,0,7,35
73429,32,21,9,0,2,30
73430,34,15,11,0,8,26
73431,27,15,6,1,5,22
73432,34,0,30,0,4,30
73433,5,5,0,0,0,5
73434,32,21,9,0,2,30
73435,25,11,9,1,4,21
73436,27,8,9,5,5,22
73437,64,42,5,0,17,47
73438,97,44,34,6,13,84
73439,220,152,26,2,40,180
73440,221,151,30,0,40,181
73441,240,100,14,83,43,197
73442,78,43,16,0,19,59
73443,73,17,39,2,15,58
73444,77,10,44,5,18,59
73445,11,6,4,0,1,10
73446,114,72,10,10,22,92
73447,447,140,189,25,93,354
73448,57,32,14,0,11,46
73449,21,10,8,0,3,18
73450,102,69,1,12,20,82
73451,51,23,13,3,12,39
73452,77,41,22,0,14,63
73453,114,66,17,8,23,91
73454,55,17,25,0,13,42
73455,0,0,0,0,0,0
73456,23,7,10,0,6,17
73457,207,158,12,0,37,170
73458,44,9,14,9,12,32
73459,133,74,23,3,33,100
73460,111,39,52,1,19,92
73461,20,5,12,0,3,17
73462,97,47,28,5,17,80
73463,81,15,42,2,22,59
73464,74,39,11,5,19,55
73465,66,57,2,0,7,59
73466,10,1,5,1,3,7
73467,13,4,8,0,1,12
73468,34,18,3,0,13,21
73469,176,116,27,0,33,143
73470,39,11,24,0,4,35
73471,297,176,55,0,66,231
73472,11,9,0,0,2,9
73473,15,2,2,10,1,14
73474,320,142,119,5,54,266
73475,38,9,17,10,2,36
73476,32,9,12,4,7,25
73477,172,115,27,1,29,143
73478,37,15,14,0,8,29
73479,329,88,139,27,75,254
73480,233,14,175,0,44,189
73481,152,59,39,21,33,119
73482,62,44,8,4,6,56
73483,42,19,11,0,12,30
73484,170,119,14,0,37,133
73485,85,27,44,0,14,71
73486,74,49,8,2,15,59
73487,71,29,25,3,14,57
73488,22,6,9,2,5,17
73489,47,15,25,1,6,41
73490,100,75,4,2,19,81
73491,8,2,3,0,3,5
73492,90,50,24,4,12,78
73493,162,57,51,25,29,133
73494,120,92,4,2,22,98
73495,74,4,43,8,19,55
73496,115,80,10,2,23,92
73497,126,77,11,19,19,107
73498,64,38,13,2,11,53
73499,31,17,8,0,6,25
73500,98,50,19,13,16,82
73501,9,6,2,0,1,8
73502,47,23,9,5,10,37
73503,139,34,47,30,28,111
73504,526,224,137,49,116,410
73505,23,12,2,5,4,19
73506,55,14,30,0,11,44
73507,72,19,28,12,13,59
73508,193,141,14,1,37,156
73509,44,18,9,6,11,33
73510,81,66,2,0,13,68
73511,19,2,15,0,2,17
73512,382,102,150,47,83,299
73513,139,96,12,4,27,112
73514,61,23,27,1,10,51
73515,45,11,24,0,10,35
73516,8,0,4,0,4,4
73517,192,136,8,7,41,151
73518,46,18,20,0,8,38
73519,118,93,4,0,21,97
73520,28,12,10,0,6,22
73521,169,88,41,0,40,129
73522,386,160,105,38,83,303
73523,41,22,10,0,9,32
73524,32,21,9,0,2,30
73525,76,17,39,2,18,58
73526,98,58,26,1,13,85
73527,109,28,65,1,15,94
73528,24,18,0,0,6,18
73529,66,30,28,0,8,58
73530,77,51,9,3,14,63
73531,96,43,17,11,25,71
73532,17,6,6,0,5,12
73533,27,5,15,0,7,20
73534,110,76,11,1,22,88
73535,124,41,43,11,29,95
73536,54,21,21,1,11,43
73537,68,40,16,4,8,60
73538,85,56,15,0,14,71
73539,70,48,13,0,9,61
73540,53,22,6,17,8,45
73541,13,9,3,0,1,12
73542,9,1,8,0,0,9
73543,75,43,17,2,13,62
73544,103,51,23,4,25,78
73545,95,65,7,9,14,81
73546,10,8,2,0,0,10
73547,286,161,35,33,57,229
73548,1061,393,427,46,195,866
73549,26,8,13,0,5,21
73550,46,18,20,0,8,38
73551,34,11,10,7,6,28
73552,176,50,47,44,35,141
73553,77,40,26,4,7,70
73554,70,15,29,9,17,53
73555,66,21,31,3,11,55
73556,49,17,21,0,11,38
73557,87,68,0,4,15,72
73558,156,76,49,1,30,126
73559,62,38,14,1,9,53
73560,75,30,23,5,17,58
73561,34,15,11,0,8,26
73562,158,123,9,1,25,133
73563,88,35,5,36,12,76
73564,160,106,24,1,29,131
73565,46,18,20,0,8,38
73566,19,11,7,1,0,19
73567,96,25,53,0,18,78
73568,7,1,4,0,2,5
73569,116,45,32,13,26,90
73570,30,17,4,0,9,21
73571,150,111,14,1,24,126
73572,175,86,24,25,40,135
73573,26,0,15,0,11,15
73574,8,5,2,0,1,7
73575,129,67,12,23,27,102
73576,38,23,5,3,7,31
73577,156,80,45,1,30,126
73578,121,64,21,14,22,99
73579,151,38,78,1,34,117
73580,39,0,28,0,11,28
73581,67,17,26,9,15,52
73582,8,3,3,0,2,6
73583,354,260,17,0,77,277
73584,77,39,16,6,16,61
73585,68,46,5,3,14,54
73586,12,5,5,0,2,10
73587,127,28,45,30,24,103
73588,139,75,34,0,30,109
73589,130,44,50,12,24,106
73590,55,35,7,0,13,42
73591,40,22,13,0,5,35
73592,13,0,10,0,3,10
73593,665,382,139,20,124,541
73594,36,7,19,0,10,26
73595,63,36,17,0,10,53
73596,45,15,18,2,10,35
73597,57,20,26,0,11,46
73598,21,4,6,4,7,14
73599,152,107,18,0,27,125
73600,75,33,19,12,11,64
73601,76,31,8,17,20,56
73602,52,23,12,4,13,39
73603,185,72,60,7,46,139
73604,37,19,11,0,7,30
73605,79,41,22,3,13,66
73606,155,49,79,2,25,130
73607,43,14,17,4,8,35
73608,100,64,23,0,13,87
73609,45,17,10,7,11,34
73610,94,51,17,7,19,75
73611,32,18,9,0,5,27
73612,140,79,13,22,26,114
73613,39,17,11,3,8,31
73614,583,338,121,18,106,477
73615,33,9,13,4,7,26
73616,41,14,18,4,5,36
73617,97,49,27,2,19,78
73618,61,18,29,2,12,49
73619,83,60,3,2,18,65
73620,85,20,36,0,29,56
73621,28,19,7,0,2,26
73622,46,30,9,0,7,39
73623,52,37,5,1,9,43
73624,103,46,9,24,24,79
73625,34,14,9,0,11,23
73626,16,4,8,0,4,12
73627,7,4,1,0,2,5
73628,134,37,44,20,33,101
73629,1,0,0,0,1,0
73630,295,160,79,0,56,239
73631,32,12,6,8,6,26
73632,336,140,124,6,66,270
73633,91,66,7,0,18,73
73634,44,30,1,0,13,31
73635,161,69,34,20,38,123
73636,102,67,10,2,23,79
73637,25,7,12,1,5,20
73638,59,15,35,1,8,51
73639,100,40,21,18,21,79
73640,30,11,13,0,6,24
73641,113,44,41,6,22,91
73642,40,8,25,0,7,33
73643,33,13,12,1,7,26
73644,117,48,15,18,36,81
73645,243,16,185,0,42,201
73646,82,45,10,18,9,73
73647,34,16,9,0,9,25
73648,49,20,20,1,8,41
73649,68,12,35,7,14,54
73650,36,18,10,3,5,31
73651,17,4,8,0,5,12
73652,53,20,16,5,12,41
73653,47,30,8,2,7,40
73654,76,45,15,3,13,63
73655,47,7,29,1,10,37
73656,75,9,43,5,18,57
73657,8,0,6,0,2,6
73658,103,68,1,13,21,82
73659,87,35,16,16,20,67
73660,91,21,45,7,18,73
73661,20,16,0,0,4,16
73662,44,21,9,5,9,35
73663,86,39,32,0,15,71
73664,59,40,3,1,15,44
73665,9,3,3,1,2,7
73666,21,11,7,0,3,18
73667,38,14,16,1,7,31
73668,78,61,3,0,14,64
73669,192,129,21,0,42,150
73670,21,0,14,1,6,15
73671,453,120,193,39,101,352
73672,235,67,118,4,46,189
73673,49,20,23,0,6,43
73674,70,36,12,7,15,55
73675,68,18,28,0,22,46
73676,117,55,27,3,32,85
73677,144,107,3,1,33,111
73678,58,24,21,1,12,46
73679,46,18,20,0,8,38
73680,73,35,28,0,10,63
73681,66,20,26,0,20,46
73682,27,8,14,0,5,22
73683,22,14,1,0,7,15
73684,172,51,57,26,38,134
73685,44,7,28,3,6,38
73686,45,20,16,0,9,36
73687,90,29,32,12,17,73
73688,37,14,14,0,9,28
73689,81,39,15,7,20,61
73690,122,27,60,5,30,92
73691,68,27,16,6,19,49
73692,79,50,12,4,13,66
73693,22,8,9,0,5,17
73694,9,1,6,1,1,8
73695,3,0,1,0,2,1
73696,29,10,11,0,8,21
73697,6,2,4,0,0,6
73698,36,13,16,0,7,29
73699,207,43,56,68,40,167
73700,8,1,5,0,2,6
73701,21,8,6,0,7,14
73702,70,31,27,0,12,58
73703,64,18,24,13,9,55
73704,16,10,2,1,3,13
73705,36,15,8,3,10,26
73706,17,10,0,3,4,13
73707,18,6,6,2,4,14
73708,111,54,31,0,26,85
73709,129,34,73,0,22,107
73710,38,19,9,1,9,29
73711,34,7,16,1,10,24
73712,26,8,13,0,5,21
73713,46,25,17,0,4,42
73714,5,0,0,0,5,0
73715,60,32,10,2,16,44
73716,86,51,17,5,13,73
73717,80,40,23,2,15,65
73718,85,58,14,2,11,74
73719,59,14,21,6,18,41
73720,142,107,3,4,28,114
73721,79,46,11,0,22,57
73722,80,43,13,9,15,65
73723,76,5,54,1,16,60
73724,23,9,8,0,6,17
73725,44,18,19,0,7,37
73726,13,4,6,2,1,12
73727,39,13,13,6,7,32
73728,134,62,41,5,26,108
73729,40,0,36,1,3,37
73730,575,320,121,13,121,454
73731,43,12,12,9,10,33
73732,6,4,2,0,0,6
73733,13,1,11,0,1,12
73734,64,35,14,4,11,53
73735,83,14,56,0,13,70
73736,119,39,50,0,30,89
73737,1,1,0,0,0,1
73738,193,74,45,31,43,150
73739,46,18,20,0,8,38
73740,171,125,17,2,27,144
73741,54,44,1,0,9,45
73742,66,28,11,17,10,56
73743,37,15,15,0,7,30
73744,57,22,30,0,5,52
73745,10,0,7,0,3,7
73746,84,57,8,0,19,65
73747,16,11,3,0,2,14
73748,76,48,8,1,19,57
73749,32,21,9,0,2,30
73750,189,53,50,50,36,153
73751,131,59,26,19,27,104
73752,109,61,15,10,23,86
73753,157,81,46,1,29,128
73754,27,16,2,0,9,18
73755,58,14,29,2,13,45
73756,156,90,38,1,27,129
73757,46,12,22,0,12,34
