,total_wells_within_5_mils,close_functional_wells,close_non_functional_wells,close_functional_needs_repair_wells,close_unknown_wells,close_known_wells
0,24,15,5,1,3,21
1,36,21,6,2,7,29
2,25,17,1,0,7,18
3,35,6,20,0,9,26
4,43,30,4,2,7,36
5,35,20,7,0,8,27
6,91,37,35,2,17,74
7,34,11,14,0,9,25
8,25,8,15,0,2,23
9,104,41,34,9,20,84
10,130,46,50,0,34,96
11,73,35,16,0,22,51
12,62,35,12,4,11,51
13,363,273,20,2,68,295
14,12,5,3,1,3,9
15,24,13,6,1,4,20
16,190,107,26,19,38,152
17,151,83,25,12,31,120
18,97,25,47,7,18,79
19,46,31,1,2,12,34
20,60,44,5,4,7,53
21,32,21,9,0,2,30
22,147,71,19,23,34,113
23,126,42,33,28,23,103
24,77,35,11,16,15,62
25,508,267,92,43,106,402
26,22,15,1,6,0,22
27,87,55,11,2,19,68
28,431,135,179,25,92,339
29,365,265,18,2,80,285
30,14,7,4,0,3,11
31,233,155,32,0,46,187
32,490,192,145,46,107,383
33,98,62,23,0,13,85
34,22,9,4,2,7,15
35,450,239,116,18,77,373
36,212,9,168,0,35,177
37,61,26,5,16,14,47
38,77,51,9,0,17,60
39,70,35,13,8,14,56
40,109,62,23,1,23,86
41,40,29,1,0,10,30
42,134,79,28,0,27,107
43,90,21,43,15,11,79
44,359,196,90,14,59,300
45,94,44,33,1,16,78
46,20,7,3,9,1,19
47,171,106,5,20,40,131
48,79,47,15,0,17,62
49,61,44,4,0,13,48
50,412,192,95,42,83,329
51,33,12,10,1,10,23
52,348,167,113,1,67,281
53,46,18,20,0,8,38
54,126,44,47,8,27,99
55,334,157,84,26,67,267
56,317,204,42,9,62,255
57,686,398,141,21,126,560
58,61,40,6,1,14,47
59,78,30,23,6,19,59
60,128,54,38,0,36,92
61,64,25,18,12,9,55
62,278,68,45,116,49,229
63,410,190,136,12,72,338
64,66,42,3,10,11,55
65,29,7,11,3,8,21
66,34,12,13,0,9,25
67,97,32,38,9,18,79
68,68,32,14,5,17,51
69,126,57,22,19,28,98
70,19,5,12,0,2,17
71,25,9,12,0,4,21
72,36,8,17,4,7,29
73,138,75,38,1,24,114
74,21,14,5,0,2,19
75,131,51,50,12,18,113
76,138,104,4,2,28,110
77,86,38,32,0,16,70
78,39,28,4,0,7,32
79,77,41,13,5,18,59
80,64,52,1,0,11,53
81,47,26,7,7,7,40
82,490,267,108,15,100,390
83,54,33,6,3,12,42
84,10,3,5,0,2,8
85,24,14,8,0,2,22
86,25,12,6,0,7,18
87,36,13,14,1,8,28
88,221,151,29,0,41,180
89,27,5,9,8,5,22
90,231,58,31,105,37,194
91,76,21,27,12,16,60
92,204,97,61,1,45,159
93,103,52,24,0,27,76
94,104,39,40,11,14,90
95,45,28,5,6,6,39
96,47,11,16,11,9,38
97,47,28,10,0,9,38
98,64,22,16,16,10,54
99,17,9,5,1,2,15
100,64,22,27,1,14,50
101,25,9,9,1,6,19
102,113,62,21,5,25,88
103,33,3,6,16,8,25
104,576,413,43,1,119,457
105,72,21,30,6,15,57
106,28,16,7,0,5,23
107,20,7,9,1,3,17
108,17,9,8,0,0,17
109,193,88,47,20,38,155
110,451,205,155,9,82,369
111,458,212,148,11,87,371
112,18,12,3,1,2,16
113,53,22,21,1,9,44
114,47,24,12,2,9,38
115,11,1,7,1,2,9
116,16,6,6,0,4,12
117,24,3,16,0,5,19
118,42,15,17,1,9,33
119,6,1,5,0,0,6
120,140,110,5,0,25,115
121,81,30,25,7,19,62
122,70,38,22,3,7,63
123,55,38,6,1,10,45
124,263,178,63,3,19,244
125,56,25,18,1,12,44
126,23,12,8,1,2,21
127,168,127,6,1,34,134
128,26,12,6,0,8,18
129,107,23,66,0,18,89
130,19,11,4,0,4,15
131,324,168,86,15,55,269
132,41,8,10,16,7,34
133,35,13,16,0,6,29
134,58,20,26,0,12,46
135,104,86,3,3,12,92
136,10,5,4,0,1,9
137,7,2,4,0,1,6
138,40,24,3,0,13,27
139,47,19,14,4,10,37
140,268,17,201,2,48,220
141,50,26,8,5,11,39
142,4,1,2,0,1,3
143,127,41,47,15,24,103
144,60,20,21,5,14,46
145,381,219,83,0,79,302
146,43,17,14,1,11,32
147,73,43,14,0,16,57
148,70,33,28,0,9,61
149,188,62,59,24,43,145
150,18,10,3,0,5,13
151,50,20,6,16,8,42
152,33,12,17,0,4,29
153,56,20,25,2,9,47
154,145,63,29,21,32,113
155,23,3,14,0,6,17
156,68,46,8,4,10,58
157,54,19,16,4,15,39
158,116,71,16,3,26,90
159,14,2,10,1,1,13
160,123,75,24,0,24,99
161,16,5,8,2,1,15
162,126,66,24,12,24,102
163,148,58,32,28,30,118
164,77,17,44,0,16,61
165,15,4,9,0,2,13
166,30,16,7,2,5,25
167,3,1,1,0,1,2
168,32,21,9,0,2,30
169,33,9,8,13,3,30
170,93,41,32,4,16,77
171,41,13,13,6,9,32
172,67,45,7,0,15,52
173,353,156,122,6,69,284
174,16,2,9,1,4,12
175,49,27,11,2,9,40
176,22,17,5,0,0,22
177,32,21,9,0,2,30
178,39,7,22,2,8,31
179,144,70,37,0,37,107
180,64,34,16,0,14,50
181,69,44,12,1,12,57
182,179,127,15,2,35,144
183,16,5,8,2,1,15
184,32,16,2,6,8,24
185,68,19,32,1,16,52
186,41,15,13,5,8,33
187,12,6,3,1,2,10
188,86,34,28,6,18,68
189,78,35,5,16,22,56
190,82,32,33,1,16,66
191,55,35,10,0,10,45
192,38,23,9,0,6,32
193,230,157,31,0,42,188
194,200,143,9,10,38,162
195,23,11,8,0,4,19
196,150,60,36,19,35,115
197,227,61,123,6,37,190
198,91,29,46,0,16,75
199,22,14,3,2,3,19
200,41,9,14,9,9,32
201,84,38,30,5,11,73
202,34,12,13,0,9,25
203,88,51,20,0,17,71
204,107,39,38,7,23,84
205,145,58,50,15,22,123
206,113,34,48,7,24,89
207,449,238,108,14,89,360
208,22,5,10,0,7,15
209,71,59,3,0,9,62
210,94,47,15,9,23,71
211,269,48,163,4,54,215
212,74,6,48,5,15,59
213,47,11,27,1,8,39
214,55,21,17,10,7,48
215,186,14,137,0,35,151
216,182,97,46,6,33,149
217,105,44,42,1,18,87
218,369,192,95,20,62,307
219,140,53,39,13,35,105
220,77,22,28,15,12,65
221,189,78,44,21,46,143
222,313,130,114,10,59,254
223,63,34,4,13,12,51
224,31,16,6,1,8,23
225,27,2,20,0,5,22
226,37,16,12,0,9,28
227,38,21,12,1,4,34
228,57,20,16,6,15,42
229,7,4,1,0,2,5
230,48,19,14,1,14,34
231,170,13,94,29,34,136
232,87,23,36,17,11,76
233,44,17,15,4,8,36
234,58,29,13,0,16,42
235,123,65,46,0,12,111
236,44,21,14,0,9,35
237,94,31,34,13,16,78
238,68,2,41,18,7,61
239,14,3,6,1,4,10
240,54,16,19,7,12,42
241,68,35,23,0,10,58
242,38,2,22,0,14,24
243,52,22,20,0,10,42
244,35,26,2,0,7,28
245,155,63,50,16,26,129
246,50,35,4,3,8,42
247,74,44,16,0,14,60
248,532,276,92,51,113,419
249,35,15,13,0,7,28
250,34,15,12,2,5,29
251,21,7,10,0,4,17
252,474,135,198,38,103,371
253,46,18,20,0,8,38
254,69,54,1,0,14,55
255,60,24,25,0,11,49
256,46,18,20,0,8,38
257,33,8,16,2,7,26
258,66,36,15,0,15,51
259,64,19,32,1,12,52
260,39,15,16,5,3,36
261,49,19,24,0,6,43
262,39,10,16,0,13,26
263,71,30,26,1,14,57
264,9,4,2,0,3,6
265,447,256,83,15,93,354
266,78,27,13,22,16,62
267,15,7,4,0,4,11
268,139,82,42,0,15,124
269,34,8,21,0,5,29
270,81,46,17,2,16,65
271,47,9,29,0,9,38
272,68,24,30,1,13,55
273,83,33,31,0,19,64
274,51,8,22,7,14,37
275,40,11,22,1,6,34
276,127,74,22,3,28,99
277,45,25,12,0,8,37
278,247,102,86,16,43,204
279,43,9,14,8,12,31
280,73,28,7,22,16,57
281,161,84,35,7,35,126
282,31,19,4,4,4,27
283,654,377,150,19,108,546
284,15,2,2,9,2,13
285,46,18,20,0,8,38
286,400,192,110,14,84,316
287,40,31,3,2,4,36
288,32,11,14,0,7,25
289,48,27,8,4,9,39
290,72,39,12,8,13,59
291,30,18,5,0,7,23
292,224,167,18,2,37,187
293,79,61,1,0,17,62
294,489,233,100,49,107,382
295,30,9,13,4,4,26
296,41,1,33,0,7,34
297,32,16,3,5,8,24
298,10,1,8,1,0,10
299,18,7,8,0,3,15
300,106,39,29,14,24,82
301,46,18,20,0,8,38
302,39,19,11,0,9,30
303,214,75,92,2,45,169
304,39,20,9,3,7,32
305,3,3,0,0,0,3
306,46,18,20,0,8,38
307,217,80,14,81,42,175
308,9,5,0,4,0,9
309,95,58,14,4,19,76
310,63,25,27,2,9,54
311,55,27,17,1,10,45
312,273,14,206,0,53,220
313,95,30,38,9,18,77
314,52,9,30,0,13,39
315,85,43,32,2,8,77
316,8,1,5,1,1,7
317,21,9,10,1,1,20
318,120,56,34,0,30,90
319,124,32,48,15,29,95
320,110,54,27,6,23,87
321,32,21,9,0,2,30
322,40,27,7,0,6,34
323,46,18,20,0,8,38
324,15,6,3,4,2,13
325,15,4,10,0,1,14
326,46,18,20,0,8,38
327,264,55,57,96,56,208
328,23,12,4,1,6,17
329,14,4,3,1,6,8
330,14,5,4,0,5,9
331,171,85,34,21,31,140
332,94,54,26,1,13,81
333,48,18,18,1,11,37
334,84,44,21,3,16,68
335,6,3,1,0,2,4
336,8,1,7,0,0,8
337,48,38,1,0,9,39
338,72,31,22,0,19,53
339,4,0,3,0,1,3
340,5,4,0,0,1,4
341,35,26,2,0,7,28
342,37,16,12,0,9,28
343,673,392,144,17,120,553
344,96,53,19,1,23,73
345,435,140,156,43,96,339
346,32,21,9,0,2,30
347,126,90,4,5,27,99
348,88,24,36,3,25,63
349,44,9,28,4,3,41
350,31,21,6,0,4,27
351,76,38,24,0,14,62
352,82,25,25,14,18,64
353,96,50,13,17,16,80
354,75,31,32,2,10,65
355,33,12,3,14,4,29
356,293,146,86,12,49,244
357,17,5,6,2,4,13
358,98,40,28,10,20,78
359,14,8,2,1,3,11
360,36,24,6,0,6,30
361,2,0,1,0,1,1
362,97,65,11,2,19,78
363,38,19,9,1,9,29
364,129,40,33,23,33,96
365,129,66,12,23,28,101
366,470,216,147,14,93,377
367,104,29,55,0,20,84
368,38,9,19,2,8,30
369,342,143,126,6,67,275
370,46,18,20,0,8,38
371,33,25,3,1,4,29
372,29,15,8,0,6,23
373,14,5,7,0,2,12
374,177,86,31,26,34,143
375,22,1,16,0,5,17
376,16,8,2,1,5,11
377,32,6,14,5,7,25
378,33,3,6,16,8,25
379,29,12,9,0,8,21
380,76,47,12,2,15,61
381,434,212,106,29,87,347
382,94,73,3,0,18,76
383,124,61,14,18,31,93
384,125,73,21,3,28,97
385,47,16,19,2,10,37
386,5,0,4,0,1,4
387,21,3,14,0,4,17
388,53,32,5,0,16,37
389,62,41,2,2,17,45
390,48,26,14,1,7,41
391,14,4,6,2,2,12
392,168,128,7,6,27,141
393,410,234,93,0,83,327
394,373,113,138,45,77,296
395,80,39,15,11,15,65
396,61,43,7,0,11,50
397,62,16,27,9,10,52
398,16,5,5,1,5,11
399,52,29,8,4,11,41
400,15,0,10,0,5,10
401,60,30,13,5,12,48
402,82,21,34,7,20,62
403,178,67,75,3,33,145
404,43,26,9,0,8,35
405,107,55,31,2,19,88
406,33,18,5,3,7,26
407,85,46,20,0,19,66
408,26,12,9,0,5,21
409,19,15,1,1,2,17
410,31,4,24,0,3,28
411,29,7,14,3,5,24
412,28,12,11,1,4,24
413,40,19,16,1,4,36
414,149,65,30,20,34,115
415,110,73,23,0,14,96
416,24,5,14,0,5,19
417,383,218,86,0,79,304
418,86,42,22,1,21,65
419,148,70,49,5,24,124
420,246,177,21,5,43,203
421,274,196,14,3,61,213
422,27,4,16,0,7,20
423,191,71,50,29,41,150
424,23,1,13,1,8,15
425,284,112,99,21,52,232
426,37,30,2,1,4,33
427,102,37,23,20,22,80
428,248,119,69,0,60,188
429,42,18,18,0,6,36
430,369,219,65,6,79,290
431,63,31,20,0,12,51
432,108,103,0,5,0,108
433,32,21,9,0,2,30
434,179,110,6,20,43,136
435,122,66,29,4,23,99
436,683,378,166,24,115,568
437,128,59,44,4,21,107
438,36,5,23,0,8,28
439,59,19,17,8,15,44
440,14,0,11,0,3,11
441,36,6,28,0,2,34
442,196,77,36,33,50,146
443,32,21,3,0,8,24
444,6,3,1,0,2,4
445,15,7,3,3,2,13
446,9,7,0,0,2,7
447,80,48,9,3,20,60
448,35,13,4,9,9,26
449,210,144,51,2,13,197
450,44,1,33,0,10,34
451,37,14,13,3,7,30
452,155,119,9,3,24,131
453,337,190,73,17,57,280
454,15,11,0,1,3,12
455,5,2,0,0,3,2
456,358,164,119,6,69,289
457,181,126,7,4,44,137
458,42,8,18,7,9,33
459,91,38,34,1,18,73
460,131,60,27,16,28,103
461,10,3,4,0,3,7
462,104,35,40,10,19,85
463,54,17,18,3,16,38
464,261,55,142,7,57,204
465,12,8,2,1,1,11
466,21,17,2,0,2,19
467,102,66,15,3,18,84
468,6,1,3,0,2,4
469,55,16,26,0,13,42
470,102,32,50,0,20,82
471,88,20,44,10,14,74
472,24,10,8,0,6,18
473,77,31,27,2,17,60
474,45,15,14,6,10,35
475,62,34,18,0,10,52
476,35,15,10,0,10,25
477,632,365,148,17,102,530
478,254,69,131,7,47,207
479,4,1,2,0,1,3
480,21,12,2,4,3,18
481,59,31,16,1,11,48
482,15,2,2,9,2,13
483,610,360,132,15,103,507
484,15,12,0,0,3,12
485,77,39,25,1,12,65
486,55,33,6,0,16,39
487,72,16,40,2,14,58
488,42,30,0,0,12,30
489,14,0,11,0,3,11
490,88,46,22,4,16,72
491,83,46,11,6,20,63
492,63,20,20,7,16,47
493,21,7,10,0,4,17
494,24,7,9,2,6,18
495,37,15,13,1,8,29
496,152,62,37,18,35,117
497,53,38,5,0,10,43
498,63,4,50,0,9,54
499,185,100,43,0,42,143
500,83,39,25,2,17,66
501,18,5,4,3,6,12
502,27,9,10,1,7,20
503,70,35,23,1,11,59
504,448,140,185,24,99,349
505,35,9,14,4,8,27
506,27,3,20,1,3,24
507,244,121,73,10,40,204
508,15,6,6,0,3,12
509,619,355,143,17,104,515
510,35,3,23,5,4,31
511,124,44,31,20,29,95
512,159,55,51,24,29,130
513,97,74,7,1,15,82
514,44,18,18,0,8,36
515,41,17,16,0,8,33
516,70,39,15,3,13,57
517,441,240,99,12,90,351
518,89,33,31,2,23,66
519,196,107,30,20,39,157
520,451,311,42,1,97,354
521,56,11,13,24,8,48
522,17,15,0,0,2,15
523,15,0,10,0,5,10
524,140,55,47,14,24,116
525,42,19,17,0,6,36
526,133,54,44,8,27,106
527,105,74,12,11,8,97
528,16,10,4,0,2,14
529,23,13,5,0,5,18
530,86,34,33,0,19,67
531,58,30,14,4,10,48
532,204,97,61,1,45,159
533,5,2,3,0,0,5
534,27,10,12,0,5,22
535,3,1,1,0,1,2
536,26,18,0,0,8,18
537,91,29,36,10,16,75
538,123,58,26,16,23,100
539,76,5,53,1,17,59
540,157,92,27,1,37,120
541,120,58,23,16,23,97
542,199,87,61,15,36,163
543,56,39,3,0,14,42
544,123,91,6,0,26,97
545,459,140,194,30,95,364
546,49,29,12,8,0,49
547,13,0,11,1,1,12
548,29,12,7,7,3,26
549,127,75,21,3,28,99
550,61,17,33,1,10,51
551,37,12,16,3,6,31
552,53,35,10,0,8,45
553,151,115,9,3,24,127
554,30,9,16,0,5,25
555,12,2,5,0,5,7
556,99,33,26,21,19,80
557,54,30,4,3,17,37
558,15,6,5,1,3,12
559,68,46,5,2,15,53
560,14,6,2,3,3,11
561,38,11,20,0,7,31
562,94,51,25,4,14,80
563,423,129,177,30,87,336
564,27,6,19,0,2,25
565,28,9,12,0,7,21
566,5,5,0,0,0,5
567,420,237,103,0,80,340
568,172,119,38,3,12,160
569,64,25,29,1,9,55
570,115,32,33,27,23,92
571,108,45,36,1,26,82
572,69,41,7,8,13,56
573,295,80,34,132,49,246
574,177,101,31,0,45,132
575,28,15,9,0,4,24
576,19,6,10,0,3,16
577,63,46,5,1,11,52
578,36,11,18,0,7,29
579,101,30,51,0,20,81
580,57,12,31,1,13,44
581,29,17,6,0,6,23
582,36,16,12,0,8,28
583,48,16,17,6,9,39
584,18,8,6,0,4,14
585,97,47,20,4,26,71
586,20,6,9,0,5,15
587,123,55,40,10,18,105
588,40,24,5,2,9,31
589,347,188,88,15,56,291
590,63,18,27,7,11,52
591,166,110,25,1,30,136
592,21,5,9,0,7,14
593,75,9,42,5,19,56
594,37,5,19,5,8,29
595,47,24,13,1,9,38
596,207,51,40,79,37,170
597,50,32,8,2,8,42
598,189,136,7,4,42,147
599,67,33,25,0,9,58
600,1304,527,181,337,259,1045
601,2,1,0,0,1,1
602,50,14,16,10,10,40
603,64,40,11,1,12,52
604,64,18,25,6,15,49
605,6,3,3,0,0,6
606,7,2,4,0,1,6
607,42,27,5,2,8,34
608,54,35,8,0,11,43
609,73,39,18,4,12,61
610,81,38,5,15,23,58
611,85,35,36,0,14,71
612,14,7,5,0,2,12
613,66,35,17,0,14,52
614,27,15,5,0,7,20
615,37,8,19,0,10,27
616,26,3,19,1,3,23
617,14,0,11,0,3,11
618,195,112,26,20,37,158
619,29,12,12,0,5,24
620,89,63,15,1,10,79
621,83,58,2,2,21,62
622,44,35,2,0,7,37
623,114,65,16,7,26,88
624,80,41,27,0,12,68
625,23,4,14,1,4,19
626,20,0,11,1,8,12
627,135,46,42,22,25,110
628,142,69,37,0,36,106
629,127,60,33,0,34,93
630,14,7,3,0,4,10
631,71,28,18,15,10,61
632,6,1,4,1,0,6
633,36,5,26,0,5,31
634,23,14,2,0,7,16
635,424,103,180,45,96,328
636,69,2,55,0,12,57
637,38,19,12,0,7,31
638,11,4,2,0,5,6
639,479,233,95,50,101,378
640,82,35,17,14,16,66
641,33,25,1,0,7,26
642,432,209,106,31,86,346
643,15,3,5,3,4,11
644,257,150,55,0,52,205
645,131,43,34,29,25,106
646,189,128,17,0,44,145
647,358,173,116,1,68,290
648,54,23,19,0,12,42
649,42,12,20,2,8,34
650,194,76,34,34,50,144
651,159,54,44,33,28,131
652,10,6,1,2,1,9
653,81,40,9,19,13,68
654,88,37,8,24,19,69
655,28,2,12,7,7,21
656,27,7,15,0,5,22
657,123,45,39,14,25,98
658,41,6,25,4,6,35
659,32,21,9,0,2,30
660,21,3,15,0,3,18
661,157,79,20,27,31,126
662,13,9,1,0,3,10
663,32,16,11,0,5,27
664,298,121,115,7,55,243
665,132,89,18,1,24,108
666,42,14,15,1,12,30
667,78,45,10,3,20,58
668,34,2,24,0,8,26
669,57,16,31,0,10,47
670,46,19,16,2,9,37
671,1,0,0,0,1,0
672,75,38,22,1,14,61
673,56,34,14,0,8,48
674,32,18,8,0,6,26
675,104,49,35,4,16,88
676,157,118,4,2,33,124
677,333,139,122,10,62,271
678,46,18,20,0,8,38
679,16,8,4,0,4,12
680,119,41,49,10,19,100
681,10,1,8,0,1,9
682,67,46,6,0,15,52
683,146,62,54,1,29,117
684,132,46,28,26,32,100
685,17,3,12,0,2,15
686,55,23,21,1,10,45
687,24,9,7,4,4,20
688,82,24,40,3,15,67
689,48,15,26,4,3,45
690,42,19,13,2,8,34
691,80,33,22,11,14,66
692,93,39,24,13,17,76
693,34,16,8,1,9,25
694,86,24,23,21,18,68
695,134,73,23,2,36,98
696,40,12,19,0,9,31
697,32,21,9,0,2,30
698,22,5,15,0,2,20
699,141,104,9,0,28,113
700,49,22,15,0,12,37
701,51,18,17,4,12,39
702,253,138,73,0,42,211
703,365,201,75,15,74,291
704,99,56,12,14,17,82
705,124,73,9,14,28,96
706,43,12,20,0,11,32
707,54,17,22,4,11,43
708,78,52,6,2,18,60
709,83,42,21,8,12,71
710,23,11,10,0,2,21
711,73,41,18,0,14,59
712,38,23,5,2,8,30
713,67,9,50,0,8,59
714,46,8,30,0,8,38
715,185,43,100,11,31,154
716,449,204,103,48,94,355
717,138,50,50,14,24,114
718,23,7,12,0,4,19
719,497,237,122,32,106,391
720,32,21,9,0,2,30
721,225,74,85,15,51,174
722,16,9,4,0,3,13
723,37,15,14,0,8,29
724,83,47,18,3,15,68
725,71,39,15,1,16,55
726,520,358,55,1,106,414
727,400,193,99,29,79,321
728,5,5,0,0,0,5
729,206,102,33,33,38,168
730,13,3,7,0,3,10
731,47,22,15,2,8,39
732,92,48,7,17,20,72
733,32,21,9,0,2,30
734,46,29,2,10,5,41
735,25,12,8,0,5,20
736,21,3,8,0,10,11
737,26,13,7,1,5,21
738,15,9,1,5,0,15
739,8,2,2,3,1,7
740,43,18,15,2,8,35
741,51,32,9,0,10,41
742,155,66,33,18,38,117
743,71,54,5,4,8,63
744,42,5,28,0,9,33
745,26,3,18,1,4,22
746,153,66,47,9,31,122
747,164,127,7,0,30,134
748,83,53,13,9,8,75
749,486,248,117,19,102,384
750,155,80,44,1,30,125
751,36,7,18,0,11,25
752,95,55,16,1,23,72
753,46,18,20,0,8,38
754,25,14,6,0,5,20
755,32,21,9,0,2,30
756,29,5,13,7,4,25
757,21,9,5,4,3,18
758,41,5,26,0,10,31
759,38,19,11,0,8,30
760,105,22,66,0,17,88
761,622,361,143,17,101,521
762,35,19,9,0,7,28
763,24,4,15,0,5,19
764,72,27,8,24,13,59
765,171,113,27,1,30,141
766,38,11,21,1,5,33
767,75,5,53,1,16,59
768,66,38,14,0,14,52
769,29,9,8,9,3,26
770,54,15,12,21,6,48
771,146,57,32,26,31,115
772,323,139,110,6,68,255
773,69,32,24,2,11,58
774,30,14,10,3,3,27
775,152,59,39,20,34,118
776,42,27,7,0,8,34
777,33,13,16,0,4,29
778,78,13,41,7,17,61
779,15,4,8,1,2,13
780,12,3,4,0,5,7
781,63,38,5,7,13,50
782,12,8,0,0,4,8
783,414,195,112,20,87,327
784,3,2,0,0,1,2
785,70,31,26,1,12,58
786,25,12,5,2,6,19
787,52,22,19,1,10,42
788,23,8,13,0,2,21
789,68,15,41,1,11,57
790,396,184,135,7,70,326
791,11,8,3,0,0,11
792,172,87,34,21,30,142
793,58,36,14,0,8,50
794,224,70,107,11,36,188
795,112,50,15,23,24,88
796,57,28,17,1,11,46
797,190,102,57,0,31,159
798,32,21,9,0,2,30
799,78,44,16,2,16,62
800,55,11,38,0,6,49
801,4,0,4,0,0,4
802,49,30,10,0,9,40
803,12,2,7,0,3,9
804,70,28,26,1,15,55
805,72,6,49,1,16,56
806,469,217,146,14,92,377
807,69,35,11,7,16,53
808,25,4,19,0,2,23
809,81,12,53,0,16,65
810,15,1,11,0,3,12
811,53,0,33,3,17,36
812,34,9,20,1,4,30
813,33,22,7,0,4,29
814,46,16,15,3,12,34
815,39,9,23,4,3,36
816,17,9,3,1,4,13
817,85,41,25,1,18,67
818,22,7,10,0,5,17
819,29,3,22,2,2,27
820,170,125,19,0,26,144
821,8,0,6,0,2,6
822,54,17,18,7,12,42
823,204,58,109,5,32,172
824,110,37,43,11,19,91
825,54,41,3,2,8,46
826,55,33,14,2,6,49
827,59,17,34,1,7,52
828,3,0,3,0,0,3
829,70,22,35,2,11,59
830,268,200,15,0,53,215
831,28,14,7,0,7,21
832,126,31,48,16,31,95
833,31,11,6,7,7,24
834,440,202,139,12,87,353
835,508,274,86,43,105,403
836,21,10,9,0,2,19
837,204,113,29,23,39,165
838,1267,507,171,336,253,1014
839,32,21,9,0,2,30
840,147,36,76,1,34,113
841,8,7,1,0,0,8
842,19,12,1,2,4,15
843,35,22,6,0,7,28
844,50,35,10,0,5,45
845,73,40,10,5,18,55
846,31,18,10,0,3,28
847,79,30,22,12,15,64
848,237,100,15,80,42,195
849,56,26,12,0,18,38
850,63,19,32,1,11,52
851,60,30,14,4,12,48
852,13,5,7,0,1,12
853,125,29,41,30,25,100
854,12,2,9,0,1,11
855,11,2,6,0,3,8
856,51,19,18,0,14,37
857,301,184,50,0,67,234
858,55,40,8,0,7,48
859,103,44,19,17,23,80
860,161,28,102,1,30,131
861,160,54,80,0,26,134
862,46,21,13,3,9,37
863,88,25,38,10,15,73
864,21,11,6,0,4,17
865,1,0,1,0,0,1
866,72,33,15,14,10,62
867,16,6,9,0,1,15
868,180,73,40,21,46,134
869,130,77,28,0,25,105
870,171,106,44,13,8,163
871,583,403,54,1,125,458
872,52,19,24,0,9,43
873,77,9,53,1,14,63
874,44,36,2,0,6,38
875,22,9,4,2,7,15
876,188,121,25,9,33,155
877,186,63,83,0,40,146
878,132,46,27,27,32,100
879,160,54,50,24,32,128
880,155,79,45,1,30,125
881,537,339,72,7,119,418
882,227,174,6,2,45,182
883,76,39,18,8,11,65
884,179,103,31,0,45,134
885,27,14,6,0,7,20
886,79,40,17,2,20,59
887,8,2,1,3,2,6
888,75,50,7,1,17,58
889,68,5,46,4,13,55
890,84,22,43,4,15,69
891,104,75,12,9,8,96
892,59,10,35,1,13,46
893,6,2,3,0,1,5
894,26,3,17,0,6,20
895,5,2,2,0,1,4
896,200,82,35,34,49,151
897,184,101,35,1,47,137
898,551,392,41,1,117,434
899,224,136,39,6,43,181
900,16,9,4,0,3,13
901,22,3,12,3,4,18
902,36,17,9,0,10,26
903,123,60,31,5,27,96
904,171,69,37,21,44,127
905,99,53,22,1,23,76
906,56,27,6,4,19,37
907,172,69,51,7,45,127
908,13,5,5,1,2,11
909,3,1,2,0,0,3
910,89,32,36,2,19,70
911,32,21,9,0,2,30
912,159,86,22,22,29,130
913,451,243,106,14,88,363
914,37,9,21,0,7,30
915,32,11,9,5,7,25
916,58,11,31,0,16,42
917,84,31,26,9,18,66
918,25,6,16,0,3,22
919,88,32,37,3,16,72
920,35,14,12,0,9,26
921,184,118,51,1,14,170
922,108,53,31,5,19,89
923,69,14,39,0,16,53
924,204,97,61,1,45,159
925,42,33,2,0,7,35
926,28,12,10,0,6,22
927,17,9,2,1,5,12
928,49,24,3,14,8,41
929,162,55,78,0,29,133
930,84,41,17,4,22,62
931,33,16,10,0,7,26
932,112,40,49,0,23,89
933,106,42,33,10,21,85
934,60,45,5,3,7,53
935,157,10,91,25,31,126
936,178,100,20,17,41,137
937,15,4,6,0,5,10
938,111,87,3,0,21,90
939,32,21,9,0,2,30
940,93,21,49,3,20,73
941,41,12,18,0,11,30
942,477,132,199,38,108,369
943,52,32,12,8,0,52
944,41,17,16,0,8,33
945,87,56,10,0,21,66
946,25,12,9,0,4,21
947,258,197,13,0,48,210
948,16,2,9,1,4,12
949,48,11,24,0,13,35
950,129,43,49,12,25,104
951,53,38,4,0,11,42
952,87,26,49,0,12,75
953,103,67,1,13,22,81
954,23,13,4,1,5,18
955,90,44,29,1,16,74
956,51,26,20,0,5,46
957,66,37,21,0,8,58
958,81,38,24,2,17,64
959,68,32,14,0,22,46
960,32,21,9,0,2,30
961,79,52,17,0,10,69
962,18,14,1,0,3,15
963,47,29,11,0,7,40
964,74,27,17,7,23,51
965,46,18,20,0,8,38
966,12,7,2,0,3,9
967,41,27,3,0,11,30
968,39,9,16,5,9,30
969,179,101,33,0,45,134
970,55,19,14,5,17,38
971,32,21,9,0,2,30
972,4,0,2,2,0,4
973,87,40,26,2,19,68
974,40,21,11,1,7,33
975,13,8,2,0,3,10
976,56,29,20,0,7,49
977,153,62,31,30,30,123
978,498,229,111,53,105,393
979,48,9,28,1,10,38
980,273,19,200,2,52,221
981,47,20,10,8,9,38
982,108,41,37,2,28,80
983,579,326,140,21,92,487
984,101,66,9,2,24,77
985,44,29,9,0,6,38
986,107,56,23,0,28,79
987,58,9,38,0,11,47
988,17,10,2,0,5,12
989,23,9,10,1,3,20
990,195,39,53,65,38,157
991,327,137,121,10,59,268
992,32,21,9,0,2,30
993,664,390,142,17,115,549
994,45,17,11,10,7,38
995,249,120,81,4,44,205
996,31,6,15,2,8,23
997,117,65,41,0,11,106
998,198,77,37,33,51,147
999,81,51,7,1,22,59
1000,62,22,4,26,10,52
1001,37,21,7,0,9,28
1002,49,15,11,17,6,43
1003,47,21,17,0,9,38
1004,37,14,15,1,7,30
1005,360,177,114,1,68,292
1006,14,6,2,0,6,8
1007,37,28,5,0,4,33
1008,54,19,24,0,11,43
1009,37,15,16,2,4,33
1010,190,135,40,2,13,177
1011,73,30,20,1,22,51
1012,46,7,27,4,8,38
1013,0,0,0,0,0,0
1014,71,20,26,8,17,54
1015,132,102,10,0,20,112
1016,362,164,122,6,70,292
1017,10,1,8,0,1,9
1018,59,22,25,0,12,47
1019,33,16,9,0,8,25
1020,86,20,49,8,9,77
1021,43,25,9,0,9,34
1022,89,55,22,10,2,87
1023,461,137,188,37,99,362
1024,8,0,5,0,3,5
1025,51,29,14,0,8,43
1026,7,4,3,0,0,7
1027,70,41,15,0,14,56
1028,19,13,6,0,0,19
1029,78,35,18,12,13,65
1030,140,56,29,20,35,105
1031,43,14,19,3,7,36
1032,95,34,38,10,13,82
1033,235,57,71,53,54,181
1034,522,210,145,53,114,408
1035,444,144,159,48,93,351
1036,88,58,10,4,16,72
1037,42,22,5,6,9,33
1038,43,29,9,0,5,38
1039,69,44,12,1,12,57
1040,90,40,34,0,16,74
1041,144,106,9,0,29,115
1042,153,97,30,1,25,128
1043,43,14,19,3,7,36
1044,398,231,87,0,80,318
1045,60,26,19,2,13,47
1046,53,38,8,0,7,46
1047,89,28,28,12,21,68
1048,40,19,15,1,5,35
1049,80,38,28,4,10,70
1050,17,2,13,0,2,15
1051,72,11,46,0,15,57
1052,196,103,49,0,44,152
1053,23,8,12,0,3,20
1054,32,21,9,0,2,30
1055,163,47,60,22,34,129
1056,166,132,5,3,26,140
1057,10,2,8,0,0,10
1058,91,55,17,2,17,74
1059,325,99,115,40,71,254
1060,45,12,22,3,8,37
1061,64,41,5,0,18,46
1062,53,36,4,1,12,41
1063,17,4,7,0,6,11
1064,78,25,33,7,13,65
1065,76,53,12,1,10,66
1066,8,1,3,0,4,4
1067,30,20,2,0,8,22
1068,292,162,79,0,51,241
1069,16,2,13,0,1,15
1070,259,134,86,0,39,220
1071,28,18,4,0,6,22
1072,168,112,25,1,30,138
1073,127,74,22,3,28,99
1074,134,18,67,23,26,108
1075,178,126,15,2,35,143
1076,57,21,21,1,14,43
1077,24,20,2,0,2,22
1078,27,18,5,0,4,23
1079,46,18,20,0,8,38
1080,73,36,17,8,12,61
1081,9,4,4,0,1,8
1082,10,5,5,0,0,10
1083,102,33,39,3,27,75
1084,150,42,82,0,26,124
1085,8,2,6,0,0,8
1086,14,8,5,0,1,13
1087,46,28,8,4,6,40
1088,87,43,25,2,17,70
1089,61,18,32,1,10,51
1090,150,113,4,2,31,119
1091,42,7,24,2,9,33
1092,147,50,7,65,25,122
1093,42,6,25,0,11,31
1094,155,51,75,0,29,126
1095,63,19,27,4,13,50
1096,225,76,84,15,50,175
1097,12,7,4,0,1,11
1098,11,4,2,0,5,6
1099,152,100,24,3,25,127
1100,32,13,11,0,8,24
1101,48,15,18,2,13,35
1102,66,11,44,0,11,55
1103,444,143,181,18,102,342
1104,32,23,4,0,5,27
1105,27,13,8,0,6,21
1106,293,55,179,4,55,238
1107,21,8,9,0,4,17
1108,75,41,10,0,24,51
1109,51,27,14,2,8,43
1110,71,43,16,1,11,60
1111,71,49,8,0,14,57
1112,28,19,0,2,7,21
1113,50,29,10,1,10,40
1114,133,103,10,0,20,113
1115,43,32,9,2,0,43
1116,6,6,0,0,0,6
1117,108,63,14,11,20,88
1118,52,18,17,5,12,40
1119,19,4,5,7,3,16
1120,75,39,24,4,8,67
1121,155,100,3,17,35,120
1122,46,18,20,0,8,38
1123,18,7,3,1,7,11
1124,81,32,34,1,14,67
1125,49,33,5,2,9,40
1126,25,7,10,0,8,17
1127,37,17,12,3,5,32
1128,46,24,3,11,8,38
1129,59,1,49,0,9,50
1130,61,37,11,0,13,48
1131,125,51,33,15,26,99
1132,86,51,10,0,25,61
1133,105,43,47,0,15,90
1134,64,45,2,0,17,47
1135,86,32,34,8,12,74
1136,49,30,4,6,9,40
1137,320,104,135,14,67,253
1138,78,30,8,22,18,60
1139,50,0,40,2,8,42
1140,72,40,16,0,16,56
1141,29,13,10,0,6,23
1142,35,23,7,0,5,30
1143,40,2,31,1,6,34
1144,332,141,116,6,69,263
1145,24,14,4,0,6,18
1146,295,83,39,127,46,249
1147,55,33,10,0,12,43
1148,107,52,32,5,18,89
1149,56,3,40,1,12,44
1150,1,0,0,0,1,0
1151,94,40,36,2,16,78
1152,75,17,40,7,11,64
1153,187,62,84,0,41,146
1154,176,41,23,81,31,145
1155,170,125,19,0,26,144
1156,84,11,50,4,19,65
1157,16,7,6,0,3,13
1158,109,41,24,20,24,85
1159,54,24,5,12,13,41
1160,54,31,16,0,7,47
1161,69,30,12,8,19,50
1162,64,37,16,0,11,53
1163,94,29,47,1,17,77
1164,97,8,52,20,17,80
1165,40,30,5,0,5,35
1166,434,260,67,26,81,353
1167,84,41,22,6,15,69
1168,32,21,9,0,2,30
1169,114,43,44,7,20,94
1170,115,69,25,0,21,94
1171,97,45,33,1,18,79
1172,138,105,6,0,27,111
1173,26,7,11,0,8,18
1174,249,70,106,16,57,192
1175,79,54,10,0,15,64
1176,51,20,16,4,11,40
1177,245,185,9,1,50,195
1178,363,199,90,15,59,304
1179,79,35,22,0,22,57
1180,21,1,13,1,6,15
1181,47,25,14,0,8,39
1182,13,3,7,0,3,10
1183,104,30,52,4,18,86
1184,44,35,2,0,7,37
1185,101,42,22,18,19,82
1186,65,26,24,3,12,53
1187,178,108,6,21,43,135
1188,8,3,4,0,1,7
1189,8,0,8,0,0,8
1190,74,40,17,0,17,57
1191,46,18,20,0,8,38
1192,50,32,5,4,9,41
1193,248,51,136,3,58,190
1194,37,22,5,2,8,29
1195,82,52,16,0,14,68
1196,3,1,2,0,0,3
1197,11,7,0,0,4,7
1198,174,120,14,0,40,134
1199,8,3,2,0,3,5
1200,586,392,67,4,123,463
1201,62,43,8,4,7,55
1202,2,2,0,0,0,2
1203,33,27,0,1,5,28
1204,43,5,29,0,9,34
1205,70,33,27,0,10,60
1206,18,9,2,2,5,13
1207,364,116,153,19,76,288
1208,32,21,9,0,2,30
1209,49,10,30,0,9,40
1210,21,15,2,1,3,18
1211,170,125,19,0,26,144
1212,241,101,14,82,44,197
1213,54,11,21,8,14,40
1214,23,13,5,1,4,19
1215,54,12,24,8,10,44
1216,21,8,3,3,7,14
1217,46,18,20,0,8,38
1218,33,8,15,1,9,24
1219,6,1,4,0,1,5
1220,129,24,46,23,36,93
1221,18,9,5,1,3,15
1222,20,10,5,3,2,18
1223,19,4,13,1,1,18
1224,131,46,28,27,30,101
1225,76,42,19,0,15,61
1226,27,15,5,3,4,23
1227,74,26,22,8,18,56
1228,257,19,190,0,48,209
1229,35,5,25,1,4,31
1230,109,70,21,0,18,91
1231,425,122,163,47,93,332
1232,19,10,4,3,2,17
1233,367,188,95,19,65,302
1234,467,220,150,13,84,383
1235,26,4,13,2,7,19
1236,30,12,12,0,6,24
1237,33,6,18,0,9,24
1238,643,380,135,16,112,531
1239,29,2,23,0,4,25
1240,32,21,9,0,2,30
1241,43,28,7,0,8,35
1242,61,24,26,1,10,51
1243,80,37,5,16,22,58
1244,60,26,23,0,11,49
1245,166,11,91,30,34,132
1246,404,124,163,31,86,318
1247,116,49,29,17,21,95
1248,43,24,8,0,11,32
1249,16,10,1,4,1,15
1250,46,18,20,0,8,38
1251,45,11,17,6,11,34
1252,32,21,9,0,2,30
1253,104,16,58,0,30,74
1254,6,4,0,2,0,6
1255,53,26,20,0,7,46
1256,59,13,18,12,16,43
1257,95,31,4,46,14,81
1258,48,6,32,0,10,38
1259,41,24,10,4,3,38
1260,34,16,7,3,8,26
1261,401,106,159,48,88,313
1262,148,64,30,18,36,112
1263,36,4,24,1,7,29
1264,21,12,6,0,3,18
1265,31,12,11,0,8,23
1266,33,25,4,0,4,29
1267,193,101,29,28,35,158
1268,342,175,94,5,68,274
1269,36,6,7,10,13,23
1270,78,28,19,11,20,58
1271,173,134,7,0,32,141
1272,30,1,24,0,5,25
1273,49,15,20,1,13,36
1274,20,1,13,3,3,17
1275,203,52,106,6,39,164
1276,5,3,1,0,1,4
1277,32,2,22,0,8,24
1278,22,14,5,0,3,19
1279,69,25,26,3,15,54
1280,100,40,33,5,22,78
1281,40,28,7,0,5,35
1282,512,243,107,58,104,408
1283,110,49,30,11,20,90
1284,77,51,10,0,16,61
1285,43,21,17,0,5,38
1286,621,347,153,22,99,522
1287,28,17,10,0,1,27
1288,60,47,2,0,11,49
1289,257,193,16,0,48,209
1290,546,387,47,1,111,435
1291,48,3,7,22,16,32
1292,74,38,20,0,16,58
1293,21,9,8,2,2,19
1294,24,9,11,0,4,20
1295,34,2,26,1,5,29
1296,27,19,5,0,3,24
1297,147,68,41,0,38,109
1298,85,31,36,4,14,71
1299,31,15,10,0,6,25
1300,35,8,21,1,5,30
1301,149,31,50,35,33,116
1302,70,22,26,12,10,60
1303,46,18,20,0,8,38
1304,55,35,9,0,11,44
1305,76,53,12,1,10,66
1306,105,67,24,0,14,91
1307,276,164,50,0,62,214
1308,2,1,0,0,1,1
1309,47,28,13,0,6,41
1310,28,16,7,0,5,23
1311,33,11,5,6,11,22
1312,458,221,142,13,82,376
1313,53,36,6,1,10,43
1314,156,83,22,20,31,125
1315,100,60,22,4,14,86
1316,14,8,0,2,4,10
1317,131,39,65,2,25,106
1318,251,56,134,3,58,193
1319,29,13,10,0,6,23
1320,70,39,13,3,15,55
1321,103,22,64,0,17,86
1322,89,54,19,0,16,73
1323,13,3,6,0,4,9
1324,595,333,147,21,94,501
1325,13,0,12,0,1,12
1326,33,15,7,0,11,22
1327,176,73,36,27,40,136
1328,34,12,12,2,8,26
1329,4,1,2,1,0,4
1330,52,16,22,4,10,42
1331,43,19,4,15,5,38
1332,160,111,23,0,26,134
1333,32,21,9,0,2,30
1334,32,21,9,0,2,30
1335,137,63,27,23,24,113
1336,99,43,19,12,25,74
1337,13,0,9,0,4,9
1338,74,24,31,4,15,59
1339,148,59,44,9,36,112
1340,42,13,22,0,7,35
1341,89,53,20,4,12,77
1342,64,43,5,2,14,50
1343,50,12,20,5,13,37
1344,14,2,11,0,1,13
1345,367,189,94,20,64,303
1346,26,9,9,0,8,18
1347,10,3,6,0,1,9
1348,12,8,3,0,1,11
1349,89,55,18,0,16,73
1350,20,7,12,0,1,19
1351,78,9,50,3,16,62
1352,140,65,43,10,22,118
1353,49,16,21,3,9,40
1354,42,15,18,0,9,33
1355,509,250,115,32,112,397
1356,179,131,10,2,36,143
1357,107,42,40,2,23,84
1358,18,15,1,0,2,16
1359,155,81,44,5,25,130
1360,68,32,24,1,11,57
1361,35,20,5,1,9,26
1362,39,20,9,1,9,30
1363,55,20,25,2,8,47
1364,40,30,5,0,5,35
1365,300,139,95,12,54,246
1366,94,66,8,2,18,76
1367,182,39,21,91,31,151
1368,27,8,13,0,6,21
1369,12,4,6,0,2,10
1370,115,41,33,15,26,89
1371,106,39,37,9,21,85
1372,83,24,44,2,13,70
1373,437,156,144,45,92,345
1374,196,99,34,24,39,157
1375,31,13,13,1,4,27
1376,214,60,21,101,32,182
1377,103,60,23,5,15,88
1378,158,104,24,1,29,129
1379,84,62,8,1,13,71
1380,96,47,27,5,17,79
1381,271,201,16,0,54,217
1382,464,131,195,37,101,363
1383,40,29,6,5,0,40
1384,68,22,29,2,15,53
1385,181,92,52,0,37,144
1386,45,7,17,11,10,35
1387,38,6,11,16,5,33
1388,155,88,38,1,28,127
1389,72,33,29,0,10,62
1390,91,56,22,10,3,88
1391,18,11,4,0,3,15
1392,99,61,24,0,14,85
1393,13,2,8,0,3,10
1394,11,6,4,0,1,10
1395,175,46,55,38,36,139
1396,96,48,34,0,14,82
1397,326,139,112,6,69,257
1398,34,24,2,0,8,26
1399,46,7,20,12,7,39
1400,41,18,5,4,14,27
1401,433,200,146,9,78,355
1402,72,32,18,5,17,55
1403,441,135,185,26,95,346
1404,435,206,105,35,89,346
1405,71,29,23,4,15,56
1406,38,22,5,3,8,30
1407,27,8,9,1,9,18
1408,20,6,11,0,3,17
1409,4,1,0,1,2,2
1410,697,408,144,21,124,573
1411,13,7,3,0,3,10
1412,50,33,6,5,6,44
1413,23,12,6,0,5,18
1414,359,158,125,6,70,289
1415,50,18,18,1,13,37
1416,221,119,35,23,44,177
1417,42,13,18,0,11,31
1418,35,1,26,1,7,28
1419,49,29,9,2,9,40
1420,13,4,3,1,5,8
1421,55,39,2,1,13,42
1422,25,9,4,2,10,15
1423,123,45,33,17,28,95
1424,46,18,20,0,8,38
1425,64,47,1,0,16,48
1426,315,164,75,19,57,258
1427,132,11,72,18,31,101
1428,64,13,32,4,15,49
1429,3,0,2,0,1,2
1430,10,2,6,0,2,8
1431,32,24,6,2,0,32
1432,70,26,32,0,12,58
1433,193,88,47,20,38,155
1434,99,51,29,1,18,81
1435,19,7,4,1,7,12
1436,62,42,8,1,11,51
1437,104,74,12,10,8,96
1438,2,0,0,0,2,0
1439,66,23,30,5,8,58
1440,240,129,70,0,41,199
1441,11,5,3,0,3,8
1442,192,91,57,1,43,149
1443,11,1,8,0,2,9
1444,27,18,3,0,6,21
1445,37,16,16,0,5,32
1446,24,12,9,1,2,22
1447,49,6,35,0,8,41
1448,95,65,10,2,18,77
1449,32,21,9,0,2,30
1450,5,3,1,0,1,4
1451,69,29,17,8,15,54
1452,100,64,11,2,23,77
1453,53,24,16,0,13,40
1454,32,21,9,0,2,30
1455,45,15,24,2,4,41
1456,76,53,12,1,10,66
1457,6,0,6,0,0,6
1458,30,7,15,1,7,23
1459,118,47,33,20,18,100
1460,27,7,9,4,7,20
1461,29,7,11,2,9,20
1462,21,8,8,2,3,18
1463,46,18,20,0,8,38
1464,169,69,35,20,45,124
1465,60,46,1,0,13,47
1466,253,50,135,3,65,188
1467,289,195,70,3,21,268
1468,52,12,33,0,7,45
1469,22,6,12,2,2,20
1470,157,38,67,9,43,114
1471,128,41,48,14,25,103
1472,7,2,2,2,1,6
1473,65,39,12,2,12,53
1474,51,6,31,0,14,37
1475,111,63,28,1,19,92
1476,232,72,110,12,38,194
1477,58,14,28,2,14,44
1478,65,33,12,2,18,47
1479,117,58,30,6,23,94
1480,7,1,2,1,3,4
1481,72,39,17,0,16,56
1482,318,173,69,0,76,242
1483,87,36,29,8,14,73
1484,39,18,8,5,8,31
1485,159,116,9,5,29,130
1486,204,97,61,1,45,159
1487,219,117,29,32,41,178
1488,545,282,103,48,112,433
1489,55,26,21,0,8,47
1490,132,53,39,9,31,101
1491,60,2,48,0,10,50
1492,72,34,12,5,21,51
1493,89,23,42,2,22,67
1494,82,39,24,2,17,65
1495,107,68,19,2,18,89
1496,536,253,114,56,113,423
1497,24,8,10,1,5,19
1498,0,0,0,0,0,0
1499,116,40,43,7,26,90
1500,10,5,1,0,4,6
1501,63,23,14,11,15,48
1502,46,18,20,0,8,38
1503,20,1,12,1,6,14
1504,45,7,26,0,12,33
1505,48,15,23,0,10,38
1506,102,36,23,24,19,83
1507,22,11,9,1,1,21
1508,23,18,2,2,1,22
1509,98,49,34,0,15,83
1510,159,49,84,4,22,137
1511,65,14,35,7,9,56
1512,52,41,1,0,10,42
1513,59,36,10,1,12,47
1514,64,41,8,0,15,49
1515,27,19,4,1,3,24
1516,74,8,51,3,12,62
1517,25,18,0,2,5,20
1518,57,9,33,4,11,46
1519,26,14,8,0,4,22
1520,50,14,15,8,13,37
1521,88,24,45,7,12,76
1522,66,33,16,0,17,49
1523,38,19,6,8,5,33
1524,74,29,31,5,9,65
1525,32,21,9,0,2,30
1526,50,35,8,0,7,43
1527,669,391,142,18,118,551
1528,73,45,14,2,12,61
1529,63,38,14,1,10,53
1530,262,180,60,2,20,242
1531,18,11,3,2,2,16
1532,167,68,35,20,44,123
1533,474,234,120,20,100,374
1534,9,1,5,1,2,7
1535,14,0,9,0,5,9
1536,7,2,5,0,0,7
1537,135,47,29,27,32,103
1538,78,51,7,2,18,60
1539,121,53,36,3,29,92
1540,43,16,21,1,5,38
1541,370,251,38,1,80,290
1542,61,25,23,0,13,48
1543,38,13,20,1,4,34
1544,66,2,43,15,6,60
1545,30,8,12,4,6,24
1546,11,4,3,2,2,9
1547,24,8,12,1,3,21
1548,11,1,6,0,4,7
1549,46,18,20,0,8,38
1550,20,11,4,1,4,16
1551,617,362,139,18,98,519
1552,361,160,125,6,70,291
1553,623,354,147,19,103,520
1554,372,189,109,1,73,299
1555,485,235,95,49,106,379
1556,3,2,1,0,0,3
1557,37,23,5,1,8,29
1558,133,44,26,39,24,109
1559,332,166,110,0,56,276
1560,20,10,5,3,2,18
1561,46,18,20,0,8,38
1562,224,111,38,36,39,185
1563,328,173,79,20,56,272
1564,43,12,20,0,11,32
1565,35,10,18,0,7,28
1566,10,0,9,0,1,9
1567,27,1,18,2,6,21
1568,120,92,5,0,23,97
1569,8,7,0,0,1,7
1570,19,5,9,0,5,14
1571,32,21,9,0,2,30
1572,220,144,56,4,16,204
1573,23,10,11,0,2,21
1574,93,30,33,11,19,74
1575,63,38,14,1,10,53
1576,43,4,28,0,11,32
1577,159,37,16,80,26,133
1578,115,36,47,7,25,90
1579,109,47,30,12,20,89
1580,620,354,149,20,97,523
1581,28,5,12,2,9,19
1582,8,4,3,0,1,7
1583,15,12,0,0,3,12
1584,11,2,6,0,3,8
1585,233,156,31,0,46,187
1586,532,330,88,4,110,422
1587,222,131,18,26,47,175
1588,156,99,3,17,37,119
1589,8,6,2,0,0,8
1590,61,43,14,4,0,61
1591,33,1,27,0,5,28
1592,444,214,121,14,95,349
1593,97,34,18,12,33,64
1594,156,91,24,11,30,126
1595,3,1,1,0,1,2
1596,12,0,10,0,2,10
1597,116,59,28,6,23,93
1598,34,13,8,7,6,28
1599,58,7,38,0,13,45
1600,46,18,20,0,8,38
1601,74,42,17,1,14,60
1602,37,15,13,2,7,30
1603,16,0,11,0,5,11
1604,13,3,7,0,3,10
1605,48,0,36,0,12,36
1606,32,21,9,0,2,30
1607,26,16,6,0,4,22
1608,19,12,4,0,3,16
1609,500,230,119,49,102,398
1610,190,116,39,19,16,174
1611,32,21,9,0,2,30
1612,295,79,33,135,48,247
1613,22,0,17,0,5,17
1614,59,8,35,2,14,45
1615,42,17,10,8,7,35
1616,33,25,4,4,0,33
1617,104,75,5,2,22,82
1618,304,81,35,140,48,256
1619,39,23,10,0,6,33
1620,82,43,23,0,16,66
1621,111,47,36,0,28,83
1622,17,13,4,0,0,17
1623,66,39,12,4,11,55
1624,37,11,9,13,4,33
1625,379,175,121,9,74,305
1626,240,71,115,2,52,188
1627,62,23,20,1,18,44
1628,82,9,46,9,18,64
1629,152,9,93,20,30,122
1630,66,46,8,0,12,54
1631,27,11,8,4,4,23
1632,89,18,56,0,15,74
1633,36,16,10,0,10,26
1634,19,8,8,0,3,16
1635,22,11,6,0,5,17
1636,24,11,6,0,7,17
1637,169,128,7,0,34,135
1638,33,7,20,1,5,28
1639,8,0,6,0,2,6
1640,138,55,32,18,33,105
1641,10,1,8,0,1,9
1642,82,53,14,0,15,67
1643,89,34,26,9,20,69
1644,32,18,7,0,7,25
1645,60,42,7,1,10,50
1646,19,5,7,1,6,13
1647,62,26,13,8,15,47
1648,183,118,42,13,10,173
1649,98,60,8,8,22,76
1650,363,154,132,9,68,295
1651,4,1,1,0,2,2
1652,42,6,25,2,9,33
1653,16,13,0,0,3,13
1654,10,6,4,0,0,10
1655,38,23,9,4,2,36
1656,142,87,27,0,28,114
1657,405,230,92,0,83,322
1658,237,103,75,16,43,194
1659,53,27,15,0,11,42
1660,54,16,28,2,8,46
1661,44,33,3,2,6,38
1662,25,3,17,1,4,21
1663,42,26,11,0,5,37
1664,20,6,6,1,7,13
1665,37,14,14,1,8,29
1666,82,31,7,24,20,62
1667,411,291,38,1,81,330
1668,55,24,13,6,12,43
1669,32,21,9,0,2,30
1670,13,6,7,0,0,13
1671,152,59,42,23,28,124
1672,8,5,1,0,2,6
1673,27,11,8,0,8,19
1674,34,17,13,0,4,30
1675,34,5,22,0,7,27
1676,161,69,44,11,37,124
1677,85,50,17,3,15,70
1678,86,32,8,24,22,64
1679,141,57,52,3,29,112
1680,37,18,13,0,6,31
1681,231,78,88,15,50,181
1682,127,74,22,3,28,99
1683,37,4,21,6,6,31
1684,36,9,4,17,6,30
1685,14,10,2,0,2,12
1686,87,67,0,4,16,71
1687,36,27,4,1,4,32
1688,31,9,16,0,6,25
1689,67,34,17,1,15,52
1690,27,13,12,1,1,26
1691,70,41,15,0,14,56
1692,27,6,15,0,6,21
1693,49,17,21,2,9,40
1694,198,128,13,16,41,157
1695,431,121,194,14,102,329
1696,90,52,18,4,16,74
1697,183,116,34,5,28,155
1698,19,6,9,0,4,15
1699,32,21,9,0,2,30
1700,35,27,6,2,0,35
1701,49,18,25,0,6,43
1702,21,13,3,0,5,16
1703,55,33,10,0,12,43
1704,411,194,138,7,72,339
1705,31,6,16,3,6,25
1706,58,36,12,4,6,52
1707,434,207,118,14,95,339
1708,42,20,6,3,13,29
1709,218,19,158,2,39,179
1710,476,129,201,39,107,369
1711,7,4,0,1,2,5
1712,187,101,22,22,42,145
1713,65,4,45,0,16,49
1714,91,39,8,25,19,72
1715,630,421,70,2,137,493
1716,271,165,41,0,65,206
1717,179,72,80,4,23,156
1718,24,12,8,2,2,22
1719,27,4,21,0,2,25
1720,48,19,17,3,9,39
1721,82,54,13,0,15,67
1722,46,29,5,1,11,35
1723,58,35,15,0,8,50
1724,133,62,42,3,26,107
1725,88,61,5,9,13,75
1726,11,0,10,0,1,10
1727,107,39,24,25,19,88
1728,14,11,1,0,2,12
1729,22,15,2,0,5,17
1730,71,11,41,5,14,57
1731,121,52,37,3,29,92
1732,88,60,6,0,22,66
1733,148,47,75,4,22,126
1734,90,70,0,4,16,74
1735,70,19,18,18,15,55
1736,58,25,8,11,14,44
1737,88,25,41,5,17,71
1738,32,21,9,0,2,30
1739,81,30,30,7,14,67
1740,276,182,39,3,52,224
1741,61,28,19,0,14,47
1742,41,2,31,2,6,35
1743,151,54,47,16,34,117
1744,387,105,186,6,90,297
1745,19,15,0,0,4,15
1746,34,9,19,0,6,28
1747,2,0,0,1,1,1
1748,283,29,196,3,55,228
1749,55,20,25,2,8,47
1750,100,51,37,2,10,90
1751,36,23,2,0,11,25
1752,138,72,35,0,31,107
1753,158,100,3,17,38,120
1754,286,144,87,0,55,231
1755,50,19,20,1,10,40
1756,197,139,12,9,37,160
1757,29,4,21,0,4,25
1758,29,8,13,2,6,23
1759,144,61,32,17,34,110
1760,21,10,5,2,4,17
1761,41,25,6,1,9,32
1762,53,32,13,0,8,45
1763,141,59,45,8,29,112
1764,64,25,15,8,16,48
1765,46,21,13,3,9,37
1766,38,15,10,1,12,26
1767,203,111,30,23,39,164
1768,68,32,22,2,12,56
1769,86,55,16,0,15,71
1770,24,17,3,0,4,20
1771,96,64,16,0,16,80
1772,38,8,11,6,13,25
1773,83,32,22,12,17,66
1774,25,13,3,0,9,16
1775,52,23,9,8,12,40
1776,93,44,31,0,18,75
1777,223,73,86,10,54,169
1778,70,13,43,0,14,56
1779,12,7,2,0,3,9
1780,473,330,41,1,101,372
1781,208,87,87,6,28,180
1782,43,20,19,0,4,39
1783,79,46,18,6,9,70
1784,45,11,24,3,7,38
1785,39,8,24,0,7,32
1786,14,6,5,0,3,11
1787,13,3,7,0,3,10
1788,3,1,1,0,1,2
1789,88,58,11,10,9,79
1790,72,38,16,0,18,54
1791,78,41,28,1,8,70
1792,9,2,5,0,2,7
1793,173,69,41,20,43,130
1794,61,37,17,2,5,56
1795,42,7,24,2,9,33
1796,167,31,103,1,32,135
1797,18,3,10,1,4,14
1798,20,12,3,0,5,15
1799,665,389,142,17,117,548
1800,59,16,21,8,14,45
1801,222,126,26,26,44,178
1802,39,22,5,2,10,29
1803,143,109,6,0,28,115
1804,189,135,15,2,37,152
1805,458,337,26,1,94,364
1806,16,10,1,5,0,16
1807,78,36,28,0,14,64
1808,23,10,11,0,2,21
1809,37,20,9,0,8,29
1810,46,18,20,0,8,38
1811,124,37,44,17,26,98
1812,57,19,23,7,8,49
1813,41,7,26,0,8,33
1814,73,39,11,7,16,57
1815,96,51,31,7,7,89
1816,208,49,122,0,37,171
1817,215,128,15,26,46,169
1818,100,73,13,0,14,86
1819,166,98,38,1,29,137
1820,112,52,26,13,21,91
1821,320,141,119,5,55,265
1822,218,92,14,75,37,181
1823,192,136,16,2,38,154
1824,369,204,90,15,60,309
1825,132,68,30,4,30,102
1826,85,22,37,17,9,76
1827,139,79,21,2,37,102
1828,46,29,2,10,5,41
1829,118,74,16,4,24,94
1830,46,18,20,0,8,38
1831,206,82,12,74,38,168
1832,368,265,30,0,73,295
1833,134,102,12,0,20,114
1834,136,62,44,6,24,112
1835,168,85,40,0,43,125
1836,7,5,1,0,1,6
1837,19,4,4,8,3,16
1838,22,14,4,0,4,18
1839,61,11,30,4,16,45
1840,638,412,75,8,143,495
1841,1266,507,172,336,251,1015
1842,56,3,40,1,12,44
1843,86,64,3,1,18,68
1844,30,12,11,3,4,26
1845,148,65,50,13,20,128
1846,47,10,28,2,7,40
1847,32,21,9,0,2,30
1848,26,4,19,0,3,23
1849,29,11,12,0,6,23
1850,7,3,2,2,0,7
1851,167,74,55,6,32,135
1852,91,21,43,16,11,80
1853,29,7,15,3,4,25
1854,148,44,46,23,35,113
1855,512,271,92,43,106,406
1856,238,127,62,0,49,189
1857,53,19,15,7,12,41
1858,39,23,6,3,7,32
1859,7,5,0,1,1,6
1860,14,7,4,0,3,11
1861,33,7,18,4,4,29
1862,48,17,23,1,7,41
1863,37,22,6,1,8,29
1864,105,48,9,23,25,80
1865,18,12,1,0,5,13
1866,458,223,141,13,81,377
1867,611,355,128,17,111,500
1868,434,245,107,0,82,352
1869,116,61,15,13,27,89
1870,34,12,13,0,9,25
1871,90,59,11,5,15,75
1872,110,38,33,19,20,90
1873,46,18,20,0,8,38
1874,403,133,163,20,87,316
1875,89,35,31,2,21,68
1876,67,53,2,0,12,55
1877,129,56,41,10,22,107
1878,327,172,85,15,55,272
1879,74,40,15,2,17,57
1880,98,53,25,3,17,81
1881,344,82,170,5,87,257
1882,56,6,38,0,12,44
1883,8,0,6,0,2,6
1884,149,57,39,21,32,117
1885,140,59,39,15,27,113
1886,59,15,31,0,13,46
1887,80,31,29,0,20,60
1888,102,24,53,3,22,80
1889,199,100,49,0,50,149
1890,14,13,0,0,1,13
1891,3,0,2,0,1,2
1892,16,2,9,1,4,12
1893,84,38,30,0,16,68
1894,50,38,5,1,6,44
1895,77,36,4,25,12,65
1896,33,11,15,0,7,26
1897,175,134,16,1,24,151
1898,71,23,32,1,15,56
1899,7,6,0,0,1,6
1900,65,19,35,1,10,55
1901,211,115,61,0,35,176
1902,80,22,38,7,13,67
1903,42,24,12,0,6,36
1904,137,85,26,3,23,114
1905,90,55,7,12,16,74
1906,85,47,19,3,16,69
1907,41,21,15,0,5,36
1908,27,16,8,0,3,24
1909,113,62,29,0,22,91
1910,93,63,10,0,20,73
1911,95,21,31,24,19,76
1912,75,5,53,1,16,59
1913,450,174,131,47,98,352
1914,8,2,4,0,2,6
1915,56,24,10,13,9,47
1916,120,69,20,5,26,94
1917,49,20,15,4,10,39
1918,46,18,20,0,8,38
1919,82,52,16,0,14,68
1920,63,28,22,3,10,53
1921,16,6,8,0,2,14
1922,635,374,141,19,101,534
1923,56,37,12,0,7,49
1924,119,31,36,27,25,94
1925,55,32,15,2,6,49
1926,80,55,15,1,9,71
1927,165,67,35,23,40,125
1928,57,16,21,8,12,45
1929,109,56,29,5,19,90
1930,46,18,20,0,8,38
1931,54,16,30,0,8,46
1932,162,99,40,13,10,152
1933,145,61,32,18,34,111
1934,246,170,27,4,45,201
1935,44,5,29,0,10,34
1936,46,18,20,0,8,38
1937,32,21,9,0,2,30
1938,30,10,15,0,5,25
1939,57,34,9,4,10,47
1940,320,165,85,15,55,265
1941,112,84,7,14,7,105
1942,77,24,31,9,13,64
1943,161,78,24,26,33,128
1944,104,43,43,1,17,87
1945,72,49,13,0,10,62
1946,17,11,1,4,1,16
1947,78,23,38,2,15,63
1948,53,16,21,4,12,41
1949,39,21,14,0,4,35
1950,212,88,65,19,40,172
1951,56,3,40,1,12,44
1952,145,70,38,0,37,108
1953,94,51,33,2,8,86
1954,73,32,5,14,22,51
1955,46,22,10,4,10,36
1956,15,0,10,0,5,10
1957,204,48,104,3,49,155
1958,135,102,4,2,27,108
1959,89,35,31,6,17,72
1960,25,13,9,0,3,22
1961,60,22,16,7,15,45
1962,33,1,25,1,6,27
1963,361,177,113,1,70,291
1964,78,19,40,1,18,60
1965,9,2,5,0,2,7
1966,32,21,9,0,2,30
1967,164,87,40,6,31,133
1968,47,13,15,11,8,39
1969,32,21,9,0,2,30
1970,84,38,33,1,12,72
1971,67,36,9,9,13,54
1972,340,144,119,6,71,269
1973,37,6,24,1,6,31
1974,52,41,1,0,10,42
1975,62,4,48,2,8,54
1976,0,0,0,0,0,0
1977,84,32,35,3,14,70
1978,26,1,20,0,5,21
1979,64,31,25,0,8,56
1980,176,107,46,13,10,166
1981,68,52,2,0,14,54
1982,9,3,4,0,2,7
1983,73,42,15,0,16,57
1984,31,24,1,0,6,25
1985,26,9,11,2,4,22
1986,2,1,0,0,1,1
1987,226,136,40,7,43,183
1988,193,76,34,34,49,144
1989,32,21,9,0,2,30
1990,35,19,11,0,5,30
1991,71,21,3,32,15,56
1992,23,5,9,2,7,16
1993,33,18,6,1,8,25
1994,151,24,98,1,28,123
1995,394,178,134,11,71,323
1996,41,13,19,2,7,34
1997,164,5,133,0,26,138
1998,28,7,3,12,6,22
1999,177,46,55,40,36,141
2000,14,3,8,0,3,11
2001,32,21,9,0,2,30
2002,271,110,57,38,66,205
2003,92,23,51,0,18,74
2004,80,31,28,6,15,65
2005,111,44,31,11,25,86
2006,377,192,89,13,83,294
2007,73,38,15,7,13,60
2008,8,3,5,0,0,8
2009,29,7,11,4,7,22
2010,15,5,6,2,2,13
2011,17,4,6,2,5,12
2012,349,148,127,6,68,281
2013,65,37,19,0,9,56
2014,460,135,186,36,103,357
2015,210,68,83,15,44,166
2016,38,12,20,1,5,33
2017,348,178,105,3,62,286
2018,102,38,33,7,24,78
2019,38,5,23,4,6,32
2020,14,7,0,5,2,12
2021,27,10,8,3,6,21
2022,31,7,18,1,5,26
2023,82,41,16,8,17,65
2024,105,54,24,0,27,78
2025,33,7,15,4,7,26
2026,57,43,1,0,13,44
2027,16,4,6,1,5,11
2028,72,52,2,0,18,54
2029,73,25,14,24,10,63
2030,49,10,28,1,10,39
2031,217,146,30,0,41,176
2032,41,14,18,2,7,34
2033,46,18,20,0,8,38
2034,132,41,62,8,21,111
2035,10,5,1,1,3,7
2036,34,11,17,3,3,31
2037,296,138,77,14,67,229
2038,206,49,25,96,36,170
2039,88,44,25,2,17,71
2040,47,1,36,0,10,37
2041,216,80,61,30,45,171
2042,18,5,9,1,3,15
2043,77,21,36,3,17,60
2044,39,7,21,2,9,30
2045,22,13,3,0,6,16
2046,26,9,4,3,10,16
2047,46,15,18,0,13,33
2048,105,37,25,20,23,82
2049,237,58,32,108,39,198
2050,71,34,12,7,18,53
2051,187,131,22,2,32,155
2052,86,37,8,23,18,68
2053,75,9,42,5,19,56
2054,176,136,16,1,23,153
2055,5,1,3,0,1,4
2056,76,31,27,2,16,60
2057,142,57,29,25,31,111
2058,32,21,9,0,2,30
2059,126,74,21,3,28,98
2060,60,49,0,1,10,50
2061,143,95,25,0,23,120
2062,68,6,7,34,21,47
2063,89,64,6,0,19,70
2064,43,16,17,2,8,35
2065,189,107,24,23,35,154
2066,49,24,10,5,10,39
2067,210,111,51,8,40,170
2068,108,41,39,6,22,86
2069,29,13,12,0,4,25
2070,451,230,114,12,95,356
2071,30,16,7,2,5,25
2072,159,97,20,7,35,124
2073,385,158,102,42,83,302
2074,3,0,3,0,0,3
2075,35,8,10,6,11,24
2076,348,188,90,15,55,293
2077,503,260,117,18,108,395
2078,14,8,4,0,2,12
2079,26,18,3,0,5,21
2080,110,53,34,5,18,92
2081,24,17,4,0,3,21
2082,253,129,75,0,49,204
2083,71,25,33,3,10,61
2084,162,54,82,4,22,140
2085,23,9,9,0,5,18
2086,66,12,42,0,12,54
2087,20,10,8,0,2,18
2088,46,18,20,0,8,38
2089,32,21,9,0,2,30
2090,183,89,36,26,32,151
2091,24,8,11,0,5,19
2092,30,4,16,4,6,24
2093,89,36,42,1,10,79
2094,66,50,11,0,5,61
2095,34,3,24,1,6,28
2096,62,38,7,0,17,45
2097,361,160,125,6,70,291
2098,67,12,42,1,12,55
2099,29,10,11,0,8,21
2100,138,90,27,1,20,118
2101,47,18,19,0,10,37
2102,27,1,17,0,9,18
2103,30,7,13,1,9,21
2104,318,165,85,15,53,265
2105,96,43,34,3,16,80
2106,361,199,90,14,58,303
2107,191,13,140,0,38,153
2108,37,14,14,1,8,29
2109,5,2,2,0,1,4
2110,80,25,40,0,15,65
2111,138,82,28,0,28,110
2112,18,5,9,0,4,14
2113,58,27,12,3,16,42
2114,25,15,5,0,5,20
2115,21,9,10,0,2,19
2116,47,39,3,0,5,42
2117,45,23,13,4,5,40
2118,11,3,5,0,3,8
2119,174,76,49,10,39,135
2120,23,10,8,1,4,19
2121,92,55,11,12,14,78
2122,35,27,6,2,0,35
2123,38,7,10,16,5,33
2124,41,9,15,10,7,34
2125,493,263,111,13,106,387
2126,178,87,32,29,30,148
2127,28,13,2,6,7,21
2128,129,45,50,0,34,95
2129,270,146,65,0,59,211
2130,68,30,28,0,10,58
2131,27,14,6,3,4,23
2132,72,41,18,0,13,59
2133,456,336,20,0,100,356
2134,437,200,122,23,92,345
2135,15,13,0,0,2,13
2136,234,155,21,3,55,179
2137,11,3,4,0,4,7
2138,53,12,16,13,12,41
2139,14,2,8,0,4,10
2140,109,20,54,15,20,89
2141,88,40,34,4,10,78
2142,60,25,13,9,13,47
2143,24,3,12,2,7,17
2144,89,53,26,5,5,84
2145,63,46,1,0,16,47
2146,45,7,26,3,9,36
2147,669,393,139,19,118,551
2148,20,11,3,1,5,15
2149,174,70,40,21,43,131
2150,51,14,27,1,9,42
2151,34,17,6,3,8,26
2152,143,91,14,10,28,115
2153,59,47,1,0,11,48
2154,42,33,2,0,7,35
2155,63,36,16,0,11,52
2156,117,89,5,2,21,96
2157,37,24,6,1,6,31
2158,132,51,47,12,22,110
2159,32,21,9,0,2,30
2160,27,9,12,2,4,23
2161,28,6,19,0,3,25
2162,41,29,0,2,10,31
2163,40,9,23,2,6,34
2164,55,40,7,1,7,48
2165,12,2,9,0,1,11
2166,49,26,8,8,7,42
2167,126,28,40,22,36,90
2168,439,203,105,39,92,347
2169,22,3,12,3,4,18
2170,62,28,23,0,11,51
2171,53,1,18,26,8,45
2172,431,133,180,19,99,332
2173,86,9,52,7,18,68
2174,5,4,0,0,1,4
2175,55,36,12,0,7,48
2176,57,19,26,3,9,48
2177,69,27,24,0,18,51
2178,80,44,9,17,10,70
2179,91,26,44,0,21,70
2180,59,26,23,0,10,49
2181,60,27,22,0,11,49
2182,24,4,17,0,3,21
2183,575,329,120,16,110,465
2184,136,11,76,19,30,106
2185,105,87,3,3,12,93
2186,28,4,12,5,7,21
2187,85,50,18,0,17,68
2188,130,101,8,0,21,109
2189,177,11,132,0,34,143
2190,168,121,21,0,26,142
2191,129,66,12,23,28,101
2192,176,44,65,27,40,136
2193,153,91,34,0,28,125
2194,66,23,32,0,11,55
2195,81,36,22,10,13,68
2196,69,23,18,17,11,58
2197,16,8,6,0,2,14
2198,133,68,16,18,31,102
2199,56,1,39,12,4,52
2200,105,36,44,10,15,90
2201,49,23,16,4,6,43
2202,91,23,48,0,20,71
2203,63,28,7,11,17,46
2204,24,7,14,0,3,21
2205,70,17,38,1,14,56
2206,69,44,12,1,12,57
2207,489,351,37,1,100,389
2208,35,1,27,1,6,29
2209,14,2,8,0,4,10
2210,55,13,26,2,14,41
2211,23,14,4,3,2,21
2212,92,52,22,1,17,75
2213,76,37,22,0,17,59
2214,22,1,16,0,5,17
2215,37,9,24,1,3,34
2216,171,113,27,1,30,141
2217,263,56,65,89,53,210
2218,25,14,6,0,5,20
2219,31,1,23,0,7,24
2220,56,33,2,11,10,46
2221,86,42,25,2,17,69
2222,97,71,5,1,20,77
2223,8,2,4,0,2,6
2224,31,19,5,1,6,25
2225,56,30,9,2,15,41
2226,327,197,60,0,70,257
2227,113,55,20,12,26,87
2228,217,115,34,26,42,175
2229,1,0,0,0,1,0
2230,46,18,20,0,8,38
2231,68,14,29,11,14,54
2232,131,45,49,8,29,102
2233,653,386,139,17,111,542
2234,46,18,20,0,8,38
2235,187,88,56,1,42,145
2236,170,82,23,25,40,130
2237,222,52,29,103,38,184
2238,135,103,12,0,20,115
2239,60,24,21,3,12,48
2240,53,30,12,4,7,46
2241,504,272,83,46,103,401
2242,11,4,4,0,3,8
2243,53,31,7,3,12,41
2244,19,8,9,0,2,17
2245,21,6,11,0,4,17
2246,22,8,11,0,3,19
2247,21,6,10,3,2,19
2248,107,74,9,1,23,84
2249,104,32,37,13,22,82
2250,68,22,35,1,10,58
2251,88,9,51,6,22,66
2252,88,45,22,4,17,71
2253,14,5,3,3,3,11
2254,43,27,4,6,6,37
2255,59,13,23,2,21,38
2256,35,8,15,0,12,23
2257,201,102,50,0,49,152
2258,79,38,25,1,15,64
2259,34,18,7,0,9,25
2260,46,22,14,0,10,36
2261,114,60,16,15,23,91
2262,46,18,20,0,8,38
2263,43,26,7,6,4,39
2264,114,63,17,8,26,88
2265,35,14,13,0,8,27
2266,347,193,69,7,78,269
2267,147,85,40,13,9,138
2268,19,8,5,0,6,13
2269,22,9,8,1,4,18
2270,40,11,22,1,6,34
2271,71,27,24,6,14,57
2272,53,10,33,0,10,43
2273,61,13,30,0,18,43
2274,44,26,14,0,4,40
2275,33,18,4,3,8,25
2276,125,61,25,15,24,101
2277,74,22,40,1,11,63
2278,162,83,47,1,31,131
2279,32,21,9,0,2,30
2280,155,79,45,1,30,125
2281,37,18,10,1,8,29
2282,58,26,22,0,10,48
2283,206,61,19,93,33,173
2284,27,23,2,2,0,27
2285,69,39,11,7,12,57
2286,185,57,78,11,39,146
2287,17,8,6,0,3,14
2288,39,9,14,4,12,27
2289,69,44,12,1,12,57
2290,24,15,2,0,7,17
2291,38,19,12,0,7,31
2292,130,85,15,4,26,104
2293,90,36,35,3,16,74
2294,35,8,18,0,9,26
2295,30,10,12,0,8,22
2296,101,22,56,3,20,81
2297,12,5,4,0,3,9
2298,3,1,1,1,0,3
2299,101,36,26,20,19,82
2300,151,109,6,5,31,120
2301,150,51,39,32,28,122
2302,10,5,4,0,1,9
2303,109,38,26,25,20,89
2304,80,44,23,0,13,67
2305,50,10,27,4,9,41
2306,73,30,20,1,22,51
2307,335,91,155,9,80,255
2308,16,5,5,2,4,12
2309,113,62,31,0,20,93
2310,151,20,75,23,33,118
2311,27,17,4,3,3,24
2312,189,132,11,8,38,151
2313,35,13,18,0,4,31
2314,43,6,28,0,9,34
2315,9,2,3,1,3,6
2316,222,74,83,15,50,172
2317,226,75,85,15,51,175
2318,173,117,25,1,30,143
2319,189,88,62,2,37,152
2320,85,55,15,0,15,70
2321,62,17,22,7,16,46
2322,11,1,6,0,4,7
2323,62,37,12,0,13,49
2324,46,18,20,0,8,38
2325,96,55,25,1,15,81
2326,88,34,37,1,16,72
2327,37,19,5,3,10,27
2328,43,14,21,0,8,35
2329,55,37,14,4,0,55
2330,107,38,25,25,19,88
2331,225,74,85,15,51,174
2332,130,53,30,15,32,98
2333,42,15,18,2,7,35
2334,210,143,26,6,35,175
2335,325,134,131,5,55,270
2336,21,1,17,0,3,18
2337,14,3,4,4,3,11
2338,10,0,9,0,1,9
2339,384,207,102,3,72,312
2340,83,42,27,0,14,69
2341,108,30,43,10,25,83
2342,29,11,6,0,12,17
2343,54,19,17,7,11,43
2344,64,46,3,0,15,49
2345,79,19,43,2,15,64
2346,16,3,12,0,1,15
2347,37,17,12,0,8,29
2348,60,30,14,5,11,49
2349,86,41,25,2,18,68
2350,43,34,1,0,8,35
2351,396,207,112,3,74,322
2352,56,25,25,0,6,50
2353,45,33,5,0,7,38
2354,36,11,20,0,5,31
2355,45,9,20,2,14,31
2356,65,27,15,5,18,47
2357,89,23,47,3,16,73
2358,34,6,21,0,7,27
2359,131,44,47,6,34,97
2360,108,23,45,17,23,85
2361,66,21,17,21,7,59
2362,173,52,56,26,39,134
2363,77,48,13,8,8,69
2364,96,31,33,15,17,79
2365,40,0,28,0,12,28
2366,33,14,10,2,7,26
2367,25,9,4,7,5,20
2368,96,48,21,7,20,76
2369,32,21,9,0,2,30
2370,63,40,11,2,10,53
2371,97,54,18,10,15,82
2372,16,6,7,0,3,13
2373,133,43,36,29,25,108
2374,35,22,3,0,10,25
2375,9,2,2,3,2,7
2376,69,40,19,0,10,59
2377,38,13,15,0,10,28
2378,99,57,17,7,18,81
2379,13,4,4,0,5,8
2380,30,10,14,1,5,25
2381,96,29,48,7,12,84
2382,34,20,7,0,7,27
2383,99,29,52,1,17,82
2384,34,6,19,2,7,27
2385,81,28,35,0,18,63
2386,40,8,23,1,8,32
2387,357,187,103,4,63,294
2388,662,390,140,17,115,547
2389,156,62,38,18,38,118
2390,46,18,20,0,8,38
2391,350,251,19,0,80,270
2392,88,57,11,4,16,72
2393,19,5,9,1,4,15
2394,79,49,7,1,22,57
2395,24,12,8,0,4,20
2396,452,213,148,7,84,368
2397,6,2,4,0,0,6
2398,100,56,20,7,17,83
2399,99,51,25,2,21,78
2400,156,43,85,0,28,128
2401,140,49,60,6,25,115
2402,50,25,14,0,11,39
2403,8,1,5,0,2,6
2404,220,149,30,0,41,179
2405,73,42,18,0,13,60
2406,50,8,26,5,11,39
2407,37,10,17,2,8,29
2408,164,72,54,7,31,133
2409,271,23,197,2,49,222
2410,269,116,85,14,54,215
2411,326,184,64,11,67,259
2412,1062,393,427,46,196,866
2413,261,147,69,0,45,216
2414,154,85,20,19,30,124
2415,46,13,10,13,10,36
2416,5,1,3,1,0,5
2417,143,67,28,16,32,111
2418,56,3,40,1,12,44
2419,57,25,22,0,10,47
2420,29,8,18,2,1,28
2421,72,35,20,1,16,56
2422,32,21,9,0,2,30
2423,7,5,0,0,2,5
2424,32,21,9,0,2,30
2425,18,14,1,0,3,15
2426,86,28,43,3,12,74
2427,18,8,4,1,5,13
2428,32,1,22,7,2,30
2429,9,2,3,3,1,8
2430,146,58,45,9,34,112
2431,137,31,69,4,33,104
2432,215,116,34,20,45,170
2433,63,31,8,8,16,47
2434,306,187,53,0,66,240
2435,37,23,4,1,9,28
2436,11,3,5,0,3,8
2437,99,34,35,8,22,77
2438,208,138,23,0,47,161
2439,83,48,16,3,16,67
2440,46,26,7,4,9,37
2441,169,111,27,1,30,139
2442,101,65,9,5,22,79
2443,217,80,61,30,46,171
2444,15,3,10,0,2,13
2445,85,56,10,1,18,67
2446,46,18,20,0,8,38
2447,72,18,27,13,14,58
2448,5,2,2,0,1,4
2449,90,46,5,26,13,77
2450,162,110,26,0,26,136
2451,121,71,9,12,29,92
2452,103,47,13,20,23,80
2453,440,139,179,20,102,338
2454,52,32,9,0,11,41
2455,82,64,2,0,16,66
2456,84,58,7,0,19,65
2457,113,42,45,6,20,93
2458,22,12,4,0,6,16
2459,24,19,0,0,5,19
2460,64,15,27,8,14,50
2461,0,0,0,0,0,0
2462,590,339,122,19,110,480
2463,149,47,43,32,27,122
2464,687,409,138,20,120,567
2465,14,6,4,0,4,10
2466,15,2,9,0,4,11
2467,27,9,13,1,4,23
2468,11,7,1,0,3,8
2469,187,58,78,13,38,149
2470,44,23,11,0,10,34
2471,18,2,14,0,2,16
2472,41,22,10,1,8,33
2473,18,10,3,1,4,14
2474,457,163,152,42,100,357
2475,30,4,17,3,6,24
2476,10,0,5,0,5,5
2477,33,15,10,0,8,25
2478,106,25,57,3,21,85
2479,22,15,2,0,5,17
2480,111,21,54,15,21,90
2481,19,5,5,2,7,12
2482,16,2,7,1,6,10
2483,49,20,7,16,6,43
2484,121,25,64,0,32,89
2485,268,109,98,16,45,223
2486,6,1,5,0,0,6
2487,14,0,9,0,5,9
2488,19,0,10,0,9,10
2489,35,20,8,1,6,29
2490,31,6,16,3,6,25
2491,109,37,42,11,19,90
2492,112,64,19,3,26,86
2493,40,23,11,0,6,34
2494,84,33,5,33,13,71
2495,311,165,79,15,52,259
2496,91,34,14,18,25,66
2497,66,7,8,30,21,45
2498,249,191,13,0,45,204
2499,41,12,18,2,9,32
2500,129,88,9,5,27,102
2501,51,37,4,0,10,41
2502,60,9,34,2,15,45
2503,100,22,45,14,19,81
2504,56,30,7,8,11,45
2505,12,4,2,5,1,11
2506,49,10,25,11,3,46
2507,29,15,5,0,9,20
2508,45,22,14,1,8,37
2509,41,22,10,1,8,33
2510,58,24,24,1,9,49
2511,27,11,10,0,6,21
2512,54,18,15,14,7,47
2513,101,35,45,5,16,85
2514,32,8,15,0,9,23
2515,90,19,30,22,19,71
2516,108,48,31,2,27,81
2517,36,14,14,1,7,29
2518,78,9,44,8,17,61
2519,238,139,44,7,48,190
2520,234,177,11,0,46,188
2521,39,7,12,9,11,28
2522,182,140,9,3,30,152
2523,124,73,20,3,28,96
2524,22,11,6,0,5,17
2525,51,11,31,0,9,42
2526,60,41,12,5,2,58
2527,42,0,37,0,5,37
2528,21,14,5,0,2,19
2529,82,49,18,0,15,67
2530,37,4,24,0,9,28
2531,3,2,1,0,0,3
2532,16,4,7,0,5,11
2533,60,37,11,0,12,48
2534,157,75,48,1,33,124
2535,137,73,34,0,30,107
2536,39,8,18,4,9,30
2537,69,44,12,1,12,57
2538,68,36,10,9,13,55
2539,62,34,16,0,12,50
2540,82,49,19,0,14,68
2541,128,100,2,2,24,104
2542,45,25,11,1,8,37
2543,351,183,99,3,66,285
2544,129,27,41,26,35,94
2545,108,38,28,24,18,90
2546,64,44,5,5,10,54
2547,55,34,9,0,12,43
2548,21,5,8,0,8,13
2549,59,41,11,5,2,57
2550,289,169,63,0,57,232
2551,48,32,2,0,14,34
2552,17,2,11,0,4,13
2553,307,133,107,10,57,250
2554,87,32,37,2,16,71
2555,17,10,4,1,2,15
2556,26,8,12,0,6,20
2557,33,0,26,2,5,28
2558,48,19,11,3,15,33
2559,669,391,143,17,118,551
2560,165,98,37,1,29,136
2561,32,21,9,0,2,30
2562,23,8,2,7,6,17
2563,87,34,14,17,22,65
2564,32,21,9,0,2,30
2565,60,41,4,1,14,46
2566,92,47,22,6,17,75
2567,138,54,30,24,30,108
2568,522,372,43,1,106,416
2569,85,55,15,0,15,70
2570,65,34,3,17,11,54
2571,45,21,15,0,9,36
2572,25,13,6,0,6,19
2573,18,10,7,0,1,17
2574,45,9,21,0,15,30
2575,63,47,12,0,4,59
2576,71,21,27,12,11,60
2577,248,105,95,2,46,202
2578,56,37,12,0,7,49
2579,261,13,199,0,49,212
2580,119,53,29,15,22,97
2581,30,22,0,0,8,22
2582,49,23,12,3,11,38
2583,86,31,36,3,16,70
2584,17,10,0,2,5,12
2585,27,1,17,0,9,18
2586,10,6,0,0,4,6
2587,203,149,17,2,35,168
2588,59,23,20,5,11,48
2589,28,2,21,0,5,23
2590,50,27,17,0,6,44
2591,40,29,6,5,0,40
2592,124,27,40,23,34,90
2593,407,175,105,44,83,324
2594,96,22,49,0,25,71
2595,129,53,44,13,19,110
2596,106,49,33,5,19,87
2597,26,9,12,0,5,21
2598,54,12,27,0,15,39
2599,26,14,7,0,5,21
2600,62,36,16,0,10,52
2601,30,3,15,5,7,23
2602,130,102,7,0,21,109
2603,47,17,19,1,10,37
2604,167,63,71,12,21,146
2605,405,116,186,10,93,312
2606,45,32,8,0,5,40
2607,4,0,4,0,0,4
2608,437,205,143,12,77,360
2609,19,6,6,0,7,12
2610,14,3,5,1,5,9
2611,43,8,26,0,9,34
2612,54,16,19,10,9,45
2613,110,69,5,11,25,85
2614,3,1,2,0,0,3
2615,24,7,12,0,5,19
2616,50,14,25,0,11,39
2617,115,45,33,11,26,89
2618,74,20,25,12,17,57
2619,295,144,85,4,62,233
2620,16,7,9,0,0,16
2621,76,53,10,0,13,63
2622,46,33,3,0,10,36
2623,170,125,19,0,26,144
2624,46,22,17,0,7,39
2625,25,5,10,3,7,18
2626,290,131,83,24,52,238
2627,52,18,28,0,6,46
2628,17,1,12,1,3,14
2629,268,73,125,6,64,204
2630,214,116,33,23,42,172
2631,63,27,23,3,10,53
2632,529,295,115,17,102,427
2633,201,52,41,67,41,160
2634,46,18,20,0,8,38
2635,45,25,13,0,7,38
2636,49,17,21,2,9,40
2637,45,5,27,0,13,32
2638,48,12,22,4,10,38
2639,189,151,11,1,26,163
2640,29,2,21,1,5,24
2641,186,121,15,13,37,149
2642,34,12,15,0,7,27
2643,4,1,2,0,1,3
2644,61,27,21,3,10,51
2645,49,36,1,0,12,37
2646,119,48,45,0,26,93
2647,17,11,3,0,3,14
2648,64,43,6,1,14,50
2649,128,81,19,0,28,100
2650,41,18,14,0,9,32
2651,13,8,0,0,5,8
2652,7,4,1,0,2,5
2653,1,0,1,0,0,1
2654,459,133,193,34,99,360
2655,108,60,19,3,26,82
2656,632,421,71,4,136,496
2657,66,38,16,0,12,54
2658,268,120,76,25,47,221
2659,31,22,3,1,5,26
2660,33,8,11,3,11,22
2661,647,379,138,17,113,534
2662,478,226,151,12,89,389
2663,51,19,10,16,6,45
2664,82,38,19,11,14,68
2665,68,4,50,0,14,54
2666,24,5,13,0,6,18
2667,19,7,9,0,3,16
2668,141,58,30,22,31,110
2669,34,12,12,3,7,27
2670,12,10,1,0,1,11
2671,45,30,1,0,14,31
2672,571,414,40,1,116,455
2673,126,56,35,8,27,99
2674,239,77,111,12,39,200
2675,32,21,9,0,2,30
2676,97,51,13,17,16,81
2677,270,200,15,0,55,215
2678,507,276,90,39,102,405
2679,467,212,159,11,85,382
2680,8,4,2,1,1,7
2681,13,2,8,0,3,10
2682,44,11,21,5,7,37
2683,13,2,10,0,1,12
2684,156,96,34,1,25,131
2685,64,41,5,0,18,46
2686,56,13,29,8,6,50
2687,449,142,193,14,100,349
2688,50,33,4,2,11,39
2689,65,43,13,0,9,56
2690,20,8,8,0,4,16
2691,28,6,7,6,9,19
2692,28,9,12,1,6,22
2693,79,41,26,4,8,71
2694,41,22,13,0,6,35
2695,98,28,52,0,18,80
2696,121,73,27,1,20,101
2697,63,14,23,12,14,49
2698,117,48,15,17,37,80
2699,29,15,5,0,9,20
2700,32,21,9,0,2,30
2701,56,31,14,2,9,47
2702,87,37,30,4,16,71
2703,39,4,22,6,7,32
2704,100,77,2,0,21,79
2705,598,335,148,21,94,504
2706,57,47,2,0,8,49
2707,387,117,178,8,84,303
2708,48,28,7,0,13,35
2709,81,37,22,3,19,62
2710,27,8,10,0,9,18
2711,38,15,13,1,9,29
2712,38,25,4,2,7,31
2713,254,153,51,3,47,207
2714,135,54,40,15,26,109
2715,47,23,15,0,9,38
2716,456,213,142,11,90,366
2717,82,55,7,1,19,63
2718,251,191,13,0,47,204
2719,419,108,179,36,96,323
2720,8,5,2,0,1,7
2721,37,14,15,0,8,29
2722,41,22,10,1,8,33
2723,42,13,20,2,7,35
2724,39,17,3,14,5,34
2725,101,39,27,11,24,77
2726,54,38,8,3,5,49
2727,519,375,34,0,110,409
2728,90,29,42,1,18,72
2729,69,48,7,4,10,59
2730,9,4,4,0,1,8
2731,40,20,11,1,8,32
2732,51,24,9,2,16,35
2733,55,27,12,6,10,45
2734,264,14,198,0,52,212
2735,47,18,19,0,10,37
2736,40,32,4,1,3,37
2737,21,11,2,5,3,18
2738,72,27,27,4,14,58
2739,98,54,17,5,22,76
2740,8,6,0,1,1,7
2741,67,29,19,7,12,55
2742,20,0,15,2,3,17
2743,69,53,6,0,10,59
2744,147,13,101,2,31,116
2745,112,52,22,15,23,89
2746,150,50,51,18,31,119
2747,25,15,6,0,4,21
2748,469,216,147,14,92,377
2749,73,46,16,0,11,62
2750,42,15,20,1,6,36
2751,260,50,145,3,62,198
2752,29,7,15,1,6,23
2753,64,26,16,7,15,49
2754,12,6,4,1,1,11
2755,36,21,6,2,7,29
2756,69,41,13,1,14,55
2757,102,69,8,5,20,82
2758,87,35,37,1,14,73
2759,7,4,2,0,1,6
2760,71,4,50,0,17,54
2761,52,19,23,0,10,42
2762,59,37,14,0,8,51
2763,27,10,9,4,4,23
2764,81,54,10,5,12,69
2765,74,16,43,0,15,59
2766,153,67,47,9,30,123
2767,22,5,13,0,4,18
2768,24,10,10,0,4,20
2769,5,3,1,0,1,4
2770,14,2,9,0,3,11
2771,448,255,85,14,94,354
2772,14,0,9,0,5,9
2773,105,68,16,3,18,87
2774,28,2,18,5,3,25
2775,109,104,0,5,0,109
2776,26,15,0,5,6,20
2777,27,12,5,4,6,21
2778,92,52,22,0,18,74
2779,107,47,32,5,23,84
2780,14,3,8,0,3,11
2781,40,23,12,0,5,35
2782,389,222,86,0,81,308
2783,159,70,53,5,31,128
2784,52,20,9,10,13,39
2785,227,77,85,15,50,177
2786,56,40,6,1,9,47
2787,86,38,31,1,16,70
2788,155,66,32,20,37,118
2789,201,99,50,0,52,149
2790,17,8,6,0,3,14
2791,86,45,26,0,15,71
2792,59,15,32,0,12,47
2793,53,30,8,3,12,41
2794,105,38,46,3,18,87
2795,13,5,4,0,4,9
2796,451,241,113,20,77,374
2797,17,1,13,0,3,14
2798,44,16,18,0,10,34
2799,172,83,35,22,32,140
2800,47,15,19,4,9,38
2801,40,21,10,0,9,31
2802,11,5,3,0,3,8
2803,275,144,86,0,45,230
2804,46,18,20,0,8,38
2805,36,11,18,0,7,29
2806,8,6,0,1,1,7
2807,123,32,68,0,23,100
2808,144,82,13,23,26,118
2809,46,18,20,0,8,38
2810,32,21,9,0,2,30
2811,61,20,16,16,9,52
2812,19,12,4,0,3,16
2813,40,16,15,0,9,31
2814,20,0,16,1,3,17
2815,48,24,3,13,8,40
2816,34,7,23,0,4,30
2817,279,159,28,33,59,220
2818,74,47,14,1,12,62
2819,245,159,28,3,55,190
2820,43,28,7,0,8,35
2821,128,60,35,0,33,95
2822,516,269,117,18,112,404
2823,28,13,12,0,3,25
2824,92,29,33,12,18,74
2825,22,13,5,0,4,18
2826,102,68,9,3,22,80
2827,411,293,36,1,81,330
2828,58,19,24,1,14,44
2829,38,18,9,1,10,28
2830,118,93,3,0,22,96
2831,25,5,18,0,2,23
2832,63,11,39,0,13,50
2833,67,30,23,0,14,53
2834,9,6,2,0,1,8
2835,53,17,23,3,10,43
2836,50,8,33,0,9,41
2837,140,59,53,1,27,113
2838,65,26,24,1,14,51
2839,94,46,32,1,15,79
2840,108,66,25,8,9,99
2841,92,57,21,11,3,89
2842,140,54,48,14,24,116
2843,30,10,16,0,4,26
2844,62,34,18,0,10,52
2845,15,2,9,1,3,12
2846,76,50,9,0,17,59
2847,70,29,20,3,18,52
2848,41,29,7,5,0,41
2849,22,8,11,0,3,19
2850,18,1,11,4,2,16
2851,25,6,13,0,6,19
2852,35,23,6,1,5,30
2853,88,42,32,4,10,78
2854,154,11,89,24,30,124
2855,59,32,17,0,10,49
2856,220,75,80,15,50,170
2857,86,56,15,0,15,71
2858,65,42,7,1,15,50
2859,131,86,10,8,27,104
2860,95,65,11,10,9,86
2861,10,5,4,0,1,9
2862,58,11,33,4,10,48
2863,229,118,65,0,46,183
2864,147,76,46,0,25,122
2865,72,16,49,2,5,67
2866,201,145,9,10,37,164
2867,22,7,12,0,3,19
2868,28,8,13,0,7,21
2869,116,35,45,5,31,85
2870,42,37,1,0,4,38
2871,57,10,32,0,15,42
2872,44,11,17,5,11,33
2873,110,48,30,12,20,90
2874,124,66,28,7,23,101
2875,453,162,149,46,96,357
2876,24,7,12,0,5,19
2877,32,21,9,0,2,30
2878,44,6,29,0,9,35
2879,64,19,15,16,14,50
2880,253,178,54,2,19,234
2881,102,72,10,2,18,84
2882,31,8,15,0,8,23
2883,71,19,30,2,20,51
2884,46,18,20,0,8,38
2885,161,128,5,3,25,136
2886,98,61,23,0,14,84
2887,28,6,19,0,3,25
2888,43,16,15,0,12,31
2889,59,19,25,1,14,45
2890,44,30,1,1,12,32
2891,32,12,13,0,7,25
2892,52,10,28,0,14,38
2893,81,38,28,0,15,66
2894,110,67,22,0,21,89
2895,110,64,19,7,20,90
2896,60,43,12,0,5,55
2897,82,30,32,4,16,66
2898,41,6,24,0,11,30
2899,136,89,22,0,25,111
2900,53,18,22,1,12,41
2901,547,395,36,1,115,432
2902,32,21,9,0,2,30
2903,52,17,21,4,10,42
2904,377,194,100,18,65,312
2905,4,3,1,0,0,4
2906,395,225,89,0,81,314
2907,37,16,7,5,9,28
2908,69,48,9,1,11,58
2909,91,63,6,8,14,77
2910,73,52,7,3,11,62
2911,33,13,14,2,4,29
2912,29,17,5,0,7,22
2913,68,39,15,0,14,54
2914,62,29,19,5,9,53
2915,211,113,48,0,50,161
2916,25,8,11,2,4,21
2917,20,10,5,1,4,16
2918,126,75,20,3,28,98
2919,48,37,3,0,8,40
2920,18,4,8,0,6,12
2921,311,212,34,1,64,247
2922,14,9,5,0,0,14
2923,40,6,23,0,11,29
2924,38,11,19,0,8,30
2925,20,5,6,3,6,14
2926,506,250,98,56,102,404
2927,128,58,36,0,34,94
2928,156,75,24,26,31,125
2929,97,30,36,8,23,74
2930,39,24,7,0,8,31
2931,28,16,7,0,5,23
2932,46,18,20,0,8,38
2933,39,2,23,0,14,25
2934,91,29,46,0,16,75
2935,32,21,9,0,2,30
2936,70,33,22,0,15,55
2937,77,25,35,3,14,63
2938,22,11,8,1,2,20
2939,37,27,5,5,0,37
2940,47,17,18,2,10,37
2941,244,17,184,0,43,201
2942,58,36,14,0,8,50
2943,25,4,16,0,5,20
2944,31,0,10,16,5,26
2945,95,45,36,2,12,83
2946,46,13,15,11,7,39
2947,37,19,14,1,3,34
2948,13,1,9,0,3,10
2949,122,73,8,15,26,96
2950,198,99,49,0,50,148
2951,21,1,4,12,4,17
2952,34,15,9,0,10,24
2953,32,21,9,0,2,30
2954,176,96,33,16,31,145
2955,18,12,4,0,2,16
2956,14,5,7,0,2,12
2957,86,65,3,0,18,68
2958,32,21,9,0,2,30
2959,74,45,11,0,18,56
2960,34,18,10,2,4,30
2961,392,182,133,8,69,323
2962,76,58,2,0,16,60
2963,334,140,124,10,60,274
2964,103,40,38,1,24,79
2965,16,9,5,1,1,15
2966,40,30,1,2,7,33
2967,13,8,2,0,3,10
2968,216,81,48,35,52,164
2969,25,14,4,0,7,18
2970,61,42,6,0,13,48
2971,15,1,12,0,2,13
2972,52,10,18,19,5,47
2973,304,88,145,6,65,239
2974,127,87,13,1,26,101
2975,24,0,18,1,5,19
2976,70,20,38,1,11,59
2977,69,39,14,2,14,55
2978,583,393,62,4,124,459
2979,56,17,15,16,8,48
2980,38,17,12,1,8,30
2981,13,4,5,0,4,9
2982,474,217,158,12,87,387
2983,28,5,13,1,9,19
2984,34,20,5,0,9,25
2985,17,9,6,0,2,15
2986,66,50,11,0,5,61
2987,45,15,20,2,8,37
2988,18,7,6,0,5,13
2989,266,196,15,0,55,211
2990,43,26,5,6,6,37
2991,73,63,2,0,8,65
2992,36,29,2,0,5,31
2993,39,8,25,4,2,37
2994,6,1,3,0,2,4
2995,34,5,19,1,9,25
2996,147,60,56,8,23,124
2997,47,34,2,5,6,41
2998,24,10,7,0,7,17
2999,15,5,8,0,2,13
3000,7,3,2,0,2,5
3001,303,132,79,32,60,243
3002,54,27,9,8,10,44
3003,37,2,25,0,10,27
3004,27,1,18,2,6,21
3005,64,36,13,1,14,50
3006,20,5,6,4,5,15
3007,136,104,12,0,20,116
3008,248,102,18,82,46,202
3009,46,18,20,0,8,38
3010,78,55,2,2,19,59
3011,116,92,7,2,15,101
3012,472,307,64,3,98,374
3013,15,2,2,9,2,13
3014,59,19,25,3,12,47
3015,19,9,8,0,2,17
3016,28,15,6,0,7,21
3017,170,5,137,0,28,142
3018,13,6,7,0,0,13
3019,15,9,4,1,1,14
3020,216,143,24,0,49,167
3021,148,12,87,20,29,119
3022,105,54,34,6,11,94
3023,133,91,17,1,24,109
3024,64,34,17,0,13,51
3025,336,180,86,15,55,281
3026,40,3,30,1,6,34
3027,65,31,19,0,15,50
3028,64,16,26,0,22,42
3029,20,14,2,2,2,18
3030,6,0,4,0,2,4
3031,168,82,52,2,32,136
3032,39,18,11,2,8,31
3033,106,21,51,14,20,86
3034,28,21,4,2,1,27
3035,160,93,37,1,29,131
3036,112,49,37,5,21,91
3037,29,6,13,6,4,25
3038,60,31,7,9,13,47
3039,13,0,11,1,1,12
3040,71,40,15,0,16,55
3041,470,263,97,12,98,372
3042,101,67,1,12,21,80
3043,46,28,7,2,9,37
3044,34,18,9,0,7,27
3045,102,19,60,1,22,80
3046,25,0,17,3,5,20
3047,51,30,7,0,14,37
3048,7,0,3,1,3,4
3049,115,36,48,7,24,91
3050,449,227,105,16,101,348
3051,102,56,27,1,18,84
3052,34,14,18,0,2,32
3053,11,5,2,1,3,8
3054,663,389,142,17,115,548
3055,42,29,1,1,11,31
3056,91,40,32,5,14,77
3057,134,76,22,2,34,100
3058,51,31,10,0,10,41
3059,10,8,0,0,2,8
3060,76,54,4,2,16,60
3061,62,43,8,4,7,55
3062,95,41,28,1,25,70
3063,200,110,30,22,38,162
3064,184,38,63,45,38,146
3065,36,8,23,1,4,32
3066,649,383,138,18,110,539
3067,170,48,52,35,35,135
3068,571,403,46,1,121,450
3069,11,2,5,0,4,7
3070,45,32,4,2,7,38
3071,6,2,3,1,0,6
3072,181,85,55,1,40,141
3073,38,7,18,3,10,28
3074,220,149,30,0,41,179
3075,235,153,64,2,16,219
3076,47,17,21,0,9,38
3077,81,40,26,0,15,66
3078,7,0,5,0,2,5
3079,114,107,0,7,0,114
3080,102,45,8,24,25,77
3081,29,7,12,2,8,21
3082,90,70,0,4,16,74
3083,35,25,5,0,5,30
3084,144,82,47,0,15,129
3085,247,182,8,3,54,193
3086,152,66,54,1,31,121
3087,5,1,4,0,0,5
3088,93,29,22,23,19,74
3089,192,46,103,11,32,160
3090,10,4,5,0,1,9
3091,178,100,33,0,45,133
3092,183,104,21,23,35,148
3093,112,46,10,36,20,92
3094,26,6,16,0,4,22
3095,126,68,30,4,24,102
3096,19,6,8,3,2,17
3097,39,5,29,0,5,34
3098,375,99,148,47,81,294
3099,277,92,126,14,45,232
3100,58,25,20,0,13,45
3101,69,54,2,0,13,56
3102,62,37,10,5,10,52
3103,4,1,2,0,1,3
3104,512,241,111,57,103,409
3105,52,37,8,0,7,45
3106,66,14,35,7,10,56
3107,281,175,43,0,63,218
3108,70,42,15,1,12,58
3109,34,25,6,3,0,34
3110,117,41,43,7,26,91
3111,127,75,21,3,28,99
3112,74,19,30,0,25,49
3113,53,8,34,0,11,42
3114,65,40,13,0,12,53
3115,102,79,6,0,17,85
3116,63,23,13,9,18,45
3117,24,8,10,0,6,18
3118,94,47,14,2,31,63
3119,248,189,13,0,46,202
3120,109,50,41,1,17,92
3121,65,40,7,1,17,48
3122,46,30,7,0,9,37
3123,52,11,34,0,7,45
3124,64,24,19,6,15,49
3125,57,22,17,11,7,50
3126,20,1,11,2,6,14
3127,46,18,20,0,8,38
3128,72,20,28,0,24,48
3129,96,49,26,5,16,80
3130,14,5,7,0,2,12
3131,54,8,30,4,12,42
3132,79,21,32,6,20,59
3133,183,132,14,1,36,147
3134,127,64,12,23,28,99
3135,80,57,8,0,15,65
3136,13,4,6,1,2,11
3137,175,50,45,44,36,139
3138,22,15,3,1,3,19
3139,371,195,101,3,72,299
3140,62,38,13,1,10,52
3141,45,15,19,0,11,34
3142,82,20,37,3,22,60
3143,67,4,46,0,17,50
3144,18,9,8,0,1,17
3145,71,25,7,24,15,56
3146,35,20,9,1,5,30
3147,53,27,14,0,12,41
3148,75,30,32,3,10,65
3149,31,16,13,0,2,29
3150,38,11,23,0,4,34
3151,105,64,18,1,22,83
3152,62,38,13,1,10,52
3153,36,27,3,2,4,32
3154,41,28,6,0,7,34
3155,13,4,5,2,2,11
3156,201,51,38,77,35,166
3157,109,37,36,16,20,89
3158,102,39,45,0,18,84
3159,91,32,31,5,23,68
3160,118,92,4,0,22,96
3161,426,149,141,44,92,334
3162,6,0,5,0,1,5
3163,99,47,21,5,26,73
3164,28,14,9,1,4,24
3165,114,28,55,4,27,87
3166,402,229,77,15,81,321
3167,33,8,19,0,6,27
3168,134,81,26,0,27,107
3169,309,150,104,2,53,256
3170,213,54,39,83,37,176
3171,54,23,13,6,12,42
3172,219,96,53,26,44,175
3173,68,39,18,0,11,57
3174,43,19,15,0,9,34
3175,149,43,38,38,30,119
3176,75,12,48,0,15,60
3177,7,3,0,2,2,5
3178,35,1,30,0,4,31
3179,32,21,9,0,2,30
3180,446,207,141,9,89,357
3181,88,27,37,2,22,66
3182,148,21,74,22,31,117
3183,29,10,10,0,9,20
3184,49,24,10,5,10,39
3185,38,10,16,5,7,31
3186,69,29,23,0,17,52
3187,50,32,11,1,6,44
3188,64,31,16,2,15,49
3189,27,0,17,2,8,19
3190,456,222,119,20,95,361
3191,100,24,32,24,20,80
3192,198,94,60,1,43,155
3193,76,49,5,8,14,62
3194,46,34,0,0,12,34
3195,64,28,8,11,17,47
3196,63,32,17,2,12,51
3197,69,31,13,10,15,54
3198,682,398,152,20,112,570
3199,25,14,7,0,4,21
3200,44,30,10,4,0,44
3201,165,31,100,1,33,132
3202,74,53,7,3,11,63
3203,109,31,60,0,18,91
3204,41,22,14,0,5,36
3205,54,29,13,3,9,45
3206,62,15,22,6,19,43
3207,25,5,17,0,3,22
3208,97,44,33,1,19,78
3209,101,72,11,9,9,92
3210,95,42,27,1,25,70
3211,69,43,15,1,10,59
3212,21,3,8,4,6,15
3213,27,8,10,0,9,18
3214,80,46,18,2,14,66
3215,157,26,101,1,29,128
3216,71,38,17,3,13,58
3217,512,258,97,50,107,405
3218,210,109,48,0,53,157
3219,470,226,150,13,81,389
3220,17,7,7,0,3,14
3221,50,27,4,10,9,41
3222,31,13,10,1,7,24
3223,54,32,8,3,11,43
3224,32,21,9,0,2,30
3225,127,74,22,3,28,99
3226,53,29,10,0,14,39
3227,17,9,2,0,6,11
3228,18,8,5,0,5,13
3229,43,20,14,1,8,35
3230,105,36,45,9,15,90
3231,247,134,58,14,41,206
3232,77,42,17,2,16,61
3233,76,47,8,1,20,56
3234,43,16,16,0,11,32
3235,14,4,8,0,2,12
3236,82,40,23,3,16,66
3237,32,16,12,0,4,28
3238,50,35,4,3,8,42
3239,62,40,6,0,16,46
3240,50,22,13,2,13,37
3241,94,59,9,5,21,73
3242,32,21,5,1,5,27
3243,144,69,45,1,29,115
3244,74,30,25,3,16,58
3245,55,40,2,0,13,42
3246,161,102,22,4,33,128
3247,28,19,3,0,6,22
3248,18,6,5,0,7,11
3249,203,158,11,1,33,170
3250,44,11,23,2,8,36
3251,32,14,11,0,7,25
3252,96,38,19,18,21,75
3253,12,5,4,2,1,11
3254,42,11,26,0,5,37
3255,379,208,108,0,63,316
3256,124,82,29,0,13,111
3257,20,13,2,0,5,15
3258,37,8,26,0,3,34
3259,57,29,14,1,13,44
3260,102,53,28,0,21,81
3261,15,2,10,0,3,12
3262,55,33,10,0,12,43
3263,384,199,107,16,62,322
3264,319,161,90,5,63,256
3265,166,56,85,4,21,145
3266,51,25,18,0,8,43
3267,16,10,4,2,0,16
3268,46,18,20,0,8,38
3269,59,43,5,4,7,52
3270,58,14,24,10,10,48
3271,309,146,109,5,49,260
3272,110,27,31,29,23,87
3273,63,7,44,0,12,51
3274,6,6,0,0,0,6
3275,147,65,45,10,27,120
3276,87,53,16,4,14,73
3277,8,2,3,0,3,5
3278,136,61,47,1,27,109
3279,224,75,83,15,51,173
3280,389,201,109,16,63,326
3281,35,7,17,1,10,25
3282,104,44,29,8,23,81
3283,128,68,24,12,24,104
3284,91,49,20,6,16,75
3285,49,22,18,0,9,40
3286,7,4,0,0,3,4
3287,58,29,12,7,10,48
3288,2,0,2,0,0,2
3289,20,10,4,1,5,15
3290,24,9,7,5,3,21
3291,15,7,2,0,6,9
3292,148,13,102,2,31,117
3293,3,1,1,0,1,2
3294,48,21,16,2,9,39
3295,32,21,9,0,2,30
3296,338,160,85,25,68,270
3297,191,146,14,1,30,161
3298,220,85,89,4,42,178
3299,71,32,23,0,16,55
3300,61,24,27,2,8,53
3301,74,44,14,0,16,58
3302,45,26,9,4,6,39
3303,31,2,21,0,8,23
3304,74,24,25,2,23,51
3305,18,1,10,5,2,16
3306,104,59,18,2,25,79
3307,32,21,9,0,2,30
3308,92,44,5,27,16,76
3309,1,0,0,1,0,1
3310,67,29,23,4,11,56
3311,47,16,4,18,9,38
3312,33,24,5,2,2,31
3313,26,15,3,4,4,22
3314,73,46,16,10,1,72
3315,69,47,8,4,10,59
3316,3,0,3,0,0,3
3317,7,0,6,0,1,6
3318,136,85,32,3,16,120
3319,40,24,10,1,5,35
3320,75,41,9,3,22,53
3321,69,23,33,5,8,61
3322,161,79,49,6,27,134
3323,38,18,9,1,10,28
3324,380,204,117,0,59,321
3325,27,10,12,1,4,23
3326,91,55,26,5,5,86
3327,37,19,12,1,5,32
3328,33,19,6,0,8,25
3329,77,37,20,7,13,64
3330,103,22,50,13,18,85
3331,27,10,12,1,4,23
3332,395,181,127,10,77,318
3333,39,28,5,0,6,33
3334,45,19,16,0,10,35
3335,100,38,39,11,12,88
3336,106,19,55,12,20,86
3337,35,11,16,2,6,29
3338,263,175,68,2,18,245
3339,95,52,7,17,19,76
3340,21,12,2,2,5,16
3341,58,15,34,0,9,49
3342,74,67,0,7,0,74
3343,34,22,5,2,5,29
3344,46,18,20,0,8,38
3345,33,11,5,6,11,22
3346,54,18,15,9,12,42
3347,160,56,49,25,30,130
3348,75,18,41,2,14,61
3349,126,107,2,0,17,109
3350,22,6,8,2,6,16
3351,81,35,8,14,24,57
3352,79,51,7,3,18,61
3353,89,24,19,20,26,63
3354,45,7,17,11,10,35
3355,89,53,22,2,12,77
3356,106,36,47,4,19,87
3357,21,12,4,1,4,17
3358,83,37,33,0,13,70
3359,501,265,90,45,101,400
3360,30,18,9,0,3,27
3361,403,102,164,47,90,313
3362,81,39,24,0,18,63
3363,132,54,44,8,26,106
3364,71,30,28,0,13,58
3365,86,74,2,10,0,86
3366,238,181,11,0,46,192
3367,58,27,22,2,7,51
3368,106,10,59,15,22,84
3369,43,24,10,2,7,36
3370,381,169,113,11,88,293
3371,167,63,41,24,39,128
3372,35,16,9,0,10,25
3373,86,42,5,26,13,73
3374,62,28,20,3,11,51
3375,17,14,1,0,2,15
3376,225,97,14,76,38,187
3377,46,13,15,12,6,40
3378,194,109,26,21,38,156
3379,54,34,10,1,9,45
3380,3,1,1,0,1,2
3381,25,16,3,1,5,20
3382,228,153,34,0,41,187
3383,20,9,6,3,2,18
3384,16,11,3,0,2,14
3385,142,56,46,14,26,116
3386,42,17,13,6,6,36
3387,8,1,5,0,2,6
3388,94,29,46,0,19,75
3389,284,102,122,15,45,239
3390,3,0,1,0,2,1
3391,52,16,22,3,11,41
3392,17,15,0,0,2,15
3393,33,20,4,8,1,32
3394,102,28,46,0,28,74
3395,52,33,7,0,12,40
3396,597,414,52,1,130,467
3397,7,5,0,0,2,5
3398,68,28,26,0,14,54
3399,55,33,10,0,12,43
3400,46,18,20,0,8,38
3401,289,196,69,3,21,268
3402,30,19,3,0,8,22
3403,35,18,10,0,7,28
3404,225,126,28,26,45,180
3405,67,47,14,6,0,67
3406,71,44,17,0,10,61
3407,164,114,13,0,37,127
3408,21,8,11,0,2,19
3409,28,10,12,0,6,22
3410,56,25,17,2,12,44
3411,55,24,13,6,12,43
3412,8,4,0,2,2,6
3413,177,137,15,1,24,153
3414,84,25,23,18,18,66
3415,32,21,9,0,2,30
3416,52,19,16,6,11,41
3417,50,6,29,7,8,42
3418,433,137,183,16,97,336
3419,69,13,31,8,17,52
3420,24,16,3,1,4,20
3421,6,1,1,0,4,2
3422,53,19,24,2,8,45
3423,52,0,41,2,9,43
3424,479,223,155,11,90,389
3425,12,3,5,0,4,8
3426,406,193,137,7,69,337
3427,45,36,2,0,7,38
3428,32,21,9,0,2,30
3429,45,14,24,0,7,38
3430,60,17,23,10,10,50
3431,121,39,39,20,23,98
3432,14,8,1,1,4,10
3433,37,8,19,0,10,27
3434,102,67,1,12,22,80
3435,106,74,9,5,18,88
3436,56,28,6,4,18,38
3437,56,7,38,0,11,45
3438,164,54,73,0,37,127
3439,40,22,12,0,6,34
3440,101,37,42,9,13,88
3441,84,49,17,4,14,70
3442,513,254,98,54,107,406
3443,93,42,31,4,16,77
3444,23,14,4,0,5,18
3445,125,58,40,4,23,102
3446,33,14,13,2,4,29
3447,241,76,114,12,39,202
3448,71,25,26,7,13,58
3449,443,139,189,15,100,343
3450,66,9,41,2,14,52
3451,17,9,2,0,6,11
3452,28,5,15,2,6,22
3453,3,2,1,0,0,3
3454,28,9,14,0,5,23
3455,10,4,3,1,2,8
3456,11,1,4,0,6,5
3457,18,0,15,0,3,15
3458,35,15,16,0,4,31
3459,62,15,23,6,18,44
3460,108,82,7,0,19,89
3461,99,38,40,9,12,87
3462,29,5,16,0,8,21
3463,47,22,21,0,4,43
3464,6,0,3,0,3,3
3465,94,49,24,6,15,79
3466,36,5,21,0,10,26
3467,21,4,10,0,7,14
3468,32,21,9,0,2,30
3469,67,26,14,14,13,54
3470,179,79,52,10,38,141
3471,34,8,21,0,5,29
3472,22,17,3,0,2,20
3473,52,33,4,0,15,37
3474,16,9,4,1,2,14
3475,27,16,8,0,3,24
3476,34,8,17,1,8,26
3477,59,26,24,0,9,50
3478,26,0,21,0,5,21
3479,57,19,31,0,7,50
3480,111,31,40,14,26,85
3481,18,1,14,0,3,15
3482,42,28,12,0,2,40
3483,20,2,16,0,2,18
3484,22,10,4,2,6,16
3485,82,24,35,8,15,67
3486,29,10,10,0,9,20
3487,1,0,1,0,0,1
3488,132,69,29,8,26,106
3489,109,52,36,0,21,88
3490,65,37,10,8,10,55
3491,19,5,12,1,1,18
3492,329,143,117,3,66,263
3493,149,58,58,4,29,120
3494,16,5,7,0,4,12
3495,126,50,33,19,24,102
3496,76,48,8,3,17,59
3497,44,31,4,0,9,35
3498,68,44,12,0,12,56
3499,225,153,31,0,41,184
3500,32,21,9,0,2,30
3501,30,2,20,0,8,22
3502,292,35,201,2,54,238
3503,20,5,8,2,5,15
3504,30,8,17,1,4,26
3505,82,24,37,4,17,65
3506,93,52,21,7,13,80
3507,550,376,59,3,112,438
3508,41,3,29,2,7,34
3509,98,47,18,8,25,73
3510,41,5,27,0,9,32
3511,138,87,24,0,27,111
3512,72,29,28,0,15,57
3513,222,74,83,15,50,172
3514,40,1,33,0,6,34
3515,45,9,21,0,15,30
3516,22,1,16,0,5,17
3517,343,170,110,5,58,285
3518,394,111,183,9,91,303
3519,65,17,31,1,16,49
3520,5,3,0,2,0,5
3521,106,50,38,0,18,88
3522,254,118,66,24,46,208
3523,37,7,20,2,8,29
3524,318,88,145,9,76,242
3525,91,46,22,9,14,77
3526,53,35,5,0,13,40
3527,101,23,41,14,23,78
3528,14,3,8,0,3,11
3529,89,41,33,0,15,74
3530,34,8,16,1,9,25
3531,139,95,16,2,26,113
3532,52,32,9,4,7,45
3533,54,37,11,5,1,53
3534,136,47,47,18,24,112
3535,52,17,18,1,16,36
3536,111,53,37,3,18,93
3537,270,78,132,4,56,214
3538,60,19,21,11,9,51
3539,109,32,55,0,22,87
3540,302,185,49,0,68,234
3541,62,24,31,0,7,55
3542,33,17,11,0,5,28
3543,43,10,10,9,14,29
3544,114,63,29,0,22,92
3545,32,12,12,2,6,26
3546,191,62,89,0,40,151
3547,26,9,9,4,4,22
3548,270,83,130,12,45,225
3549,54,13,31,0,10,44
3550,8,2,4,0,2,6
3551,56,27,3,16,10,46
3552,30,3,19,2,6,24
3553,0,0,0,0,0,0
3554,62,23,20,1,18,44
3555,26,16,4,0,6,20
3556,37,24,7,0,6,31
3557,47,37,2,0,8,39
3558,66,38,3,13,12,54
3559,138,56,42,2,38,100
3560,172,50,52,35,35,137
3561,37,10,18,4,5,32
3562,74,9,20,32,13,61
3563,298,222,12,2,62,236
3564,282,176,43,0,63,219
3565,148,62,31,23,32,116
3566,68,45,10,1,12,56
3567,98,62,12,3,21,77
3568,193,91,58,1,43,150
3569,78,40,9,18,11,67
3570,4,4,0,0,0,4
3571,80,25,34,7,14,66
3572,94,39,28,0,27,67
3573,63,30,15,5,13,50
3574,64,17,34,1,12,52
3575,29,10,13,0,6,23
3576,54,39,8,0,7,47
3577,102,59,24,1,18,84
3578,10,2,4,1,3,7
3579,21,14,4,1,2,19
3580,160,101,3,18,38,122
3581,366,93,178,7,88,278
3582,134,61,42,4,27,107
3583,91,54,19,0,18,73
3584,25,8,9,1,7,18
3585,68,45,5,3,15,53
3586,109,41,37,0,31,78
3587,35,6,25,1,3,32
3588,481,129,206,39,107,374
3589,64,38,17,3,6,58
3590,63,35,18,1,9,54
3591,114,67,28,10,9,105
3592,38,18,3,7,10,28
3593,155,116,4,2,33,122
3594,98,42,34,4,18,80
3595,166,85,40,0,41,125
3596,12,1,9,0,2,10
3597,45,27,13,0,5,40
3598,29,19,6,1,3,26
3599,43,17,8,13,5,38
3600,86,10,59,0,17,69
3601,612,416,63,2,131,481
3602,65,29,19,2,15,50
3603,2,1,0,1,0,2
3604,36,18,5,8,5,31
3605,114,23,54,15,22,92
3606,9,5,3,1,0,9
3607,47,29,11,7,0,47
3608,24,19,1,4,0,24
3609,102,35,41,12,14,88
3610,26,0,20,1,5,21
3611,33,9,14,2,8,25
3612,347,148,109,11,79,268
3613,34,13,10,5,6,28
3614,512,289,76,41,106,406
3615,448,264,72,7,105,343
3616,22,18,1,1,2,20
3617,32,16,2,4,10,22
3618,46,14,12,9,11,35
3619,64,41,5,0,18,46
3620,56,12,27,11,6,50
3621,52,28,6,6,12,40
3622,46,18,20,0,8,38
3623,113,48,40,4,21,92
3624,85,36,8,23,18,67
3625,94,54,23,4,13,81
3626,31,18,11,0,2,29
3627,86,56,12,0,18,68
3628,59,28,17,4,10,49
3629,32,21,9,0,2,30
3630,21,13,1,3,4,17
3631,105,22,49,13,21,84
3632,157,101,4,17,35,122
3633,22,10,9,1,2,20
3634,153,83,31,6,33,120
3635,15,5,4,0,6,9
3636,102,57,27,0,18,84
3637,20,3,13,0,4,16
3638,10,1,5,0,4,6
3639,44,27,9,1,7,37
3640,79,43,16,4,16,63
3641,68,28,4,17,19,49
3642,26,9,11,2,4,22
3643,11,9,2,0,0,11
3644,81,55,15,1,10,71
3645,179,84,40,18,37,142
3646,74,27,28,3,16,58
3647,14,2,11,0,1,13
3648,53,17,22,3,11,42
3649,89,61,10,3,15,74
3650,82,37,29,0,16,66
3651,97,28,39,3,27,70
3652,150,24,97,1,28,122
3653,200,102,49,0,49,151
3654,110,49,36,3,22,88
3655,52,37,8,0,7,45
3656,279,18,207,0,54,225
3657,553,280,109,54,110,443
3658,127,57,23,18,29,98
3659,409,231,102,0,76,333
3660,140,55,45,9,31,109
3661,79,38,23,2,16,63
3662,33,6,24,0,3,30
3663,20,9,4,0,7,13
3664,40,1,33,0,6,34
3665,39,24,4,6,5,34
3666,81,37,23,3,18,63
3667,197,23,135,0,39,158
3668,103,39,33,8,23,80
3669,38,16,13,0,9,29
3670,6,1,3,0,2,4
3671,127,74,22,3,28,99
3672,19,8,8,2,1,18
3673,347,149,124,6,68,279
3674,96,44,32,4,16,80
3675,23,7,13,0,3,20
3676,55,24,16,4,11,44
3677,249,172,14,5,58,191
3678,117,39,41,14,23,94
3679,37,3,30,0,4,33
3680,46,18,20,0,8,38
3681,46,18,20,0,8,38
3682,26,13,6,0,7,19
3683,87,25,20,23,19,68
3684,15,2,9,0,4,11
3685,9,2,3,3,1,8
3686,52,18,14,3,17,35
3687,26,0,20,3,3,23
3688,17,9,0,3,5,12
3689,20,11,3,1,5,15
3690,17,10,4,0,3,14
3691,80,38,5,15,22,58
3692,70,43,11,2,14,56
3693,32,21,9,0,2,30
3694,105,88,2,0,15,90
3695,42,6,26,1,9,33
3696,23,10,9,0,4,19
3697,43,19,17,0,7,36
3698,140,50,45,20,25,115
3699,48,18,12,3,15,33
3700,63,29,6,13,15,48
3701,54,28,12,0,14,40
3702,24,17,3,0,4,20
3703,372,194,105,4,69,303
3704,80,54,15,0,11,69
3705,260,104,95,16,45,215
3706,37,19,8,2,8,29
3707,102,34,42,12,14,88
3708,53,15,25,1,12,41
3709,10,0,9,0,1,9
3710,308,164,77,16,51,257
3711,54,32,14,0,8,46
3712,48,31,1,4,12,36
3713,46,18,20,0,8,38
3714,316,165,97,0,54,262
3715,172,57,53,26,36,136
3716,5,4,0,0,1,4
3717,56,13,28,0,15,41
3718,75,35,21,2,17,58
3719,44,12,25,0,7,37
3720,111,49,28,2,32,79
3721,16,10,5,0,1,15
3722,140,33,48,30,29,111
3723,44,15,19,2,8,36
3724,91,45,5,28,13,78
3725,79,38,24,0,17,62
3726,145,90,25,3,27,118
3727,141,56,44,8,33,108
3728,32,21,9,0,2,30
3729,118,50,28,14,26,92
3730,32,21,9,0,2,30
3731,118,65,23,1,29,89
3732,46,24,12,0,10,36
3733,2,0,2,0,0,2
3734,46,18,20,0,8,38
3735,72,14,32,12,14,58
3736,99,23,40,14,22,77
3737,173,78,57,3,35,138
3738,16,2,9,1,4,12
3739,31,9,7,10,5,26
3740,33,24,5,0,4,29
3741,115,60,14,13,28,87
3742,85,34,35,2,14,71
3743,128,78,20,5,25,103
3744,24,9,11,1,3,21
3745,73,39,13,8,13,60
3746,398,132,158,22,86,312
3747,46,18,20,0,8,38
3748,23,15,3,0,5,18
3749,60,28,11,7,14,46
3750,204,96,62,1,45,159
3751,24,10,11,1,2,22
3752,671,393,137,21,120,551
3753,289,212,12,2,63,226
3754,63,20,28,3,12,51
3755,135,73,26,5,31,104
3756,195,124,32,4,35,160
3757,80,24,32,6,18,62
3758,84,49,6,10,19,65
3759,258,118,72,23,45,213
3760,76,16,15,33,12,64
3761,53,22,3,15,13,40
3762,37,17,14,1,5,32
3763,68,13,44,0,11,57
3764,568,388,53,1,126,442
3765,105,74,12,11,8,97
3766,70,50,7,3,10,60
3767,86,52,18,4,12,74
3768,55,34,9,0,12,43
3769,5,3,2,0,0,5
3770,21,1,15,2,3,18
3771,39,13,21,1,4,35
3772,61,37,12,0,12,49
3773,8,1,5,0,2,6
3774,36,16,10,0,10,26
3775,76,31,20,1,24,52
3776,60,14,29,2,15,45
3777,25,9,10,2,4,21
3778,294,144,58,33,59,235
3779,71,27,28,0,16,55
3780,111,47,46,3,15,96
3781,45,28,11,2,4,41
3782,211,46,55,72,38,173
3783,76,25,31,7,13,63
3784,55,12,26,2,15,40
3785,60,11,13,26,10,50
3786,191,102,57,0,32,159
3787,11,7,1,0,3,8
3788,98,55,19,7,17,81
3789,98,40,33,6,19,79
3790,75,33,28,0,14,61
3791,30,21,2,0,7,23
3792,38,18,9,1,10,28
3793,36,5,23,0,8,28
3794,106,48,34,5,19,87
3795,135,13,90,2,30,105
3796,34,25,4,0,5,29
3797,28,13,8,0,7,21
3798,181,114,31,5,31,150
3799,74,46,15,1,12,62
3800,27,9,13,1,4,23
3801,76,59,2,0,15,61
3802,18,4,14,0,0,18
3803,60,18,32,1,9,51
3804,286,114,111,9,52,234
3805,17,6,3,1,7,10
3806,45,11,22,0,12,33
3807,270,59,57,98,56,214
3808,22,5,15,0,2,20
3809,144,67,41,6,30,114
3810,29,8,8,10,3,26
3811,44,35,2,0,7,37
3812,36,21,5,0,10,26
3813,339,171,111,0,57,282
3814,24,13,8,0,3,21
3815,14,10,2,0,2,12
3816,16,3,11,0,2,14
3817,61,27,22,4,8,53
3818,37,17,8,0,12,25
3819,12,2,9,0,1,11
3820,54,15,28,0,11,43
3821,49,18,15,1,15,34
3822,141,86,14,10,31,110
3823,35,16,12,0,7,28
3824,78,44,3,16,15,63
3825,19,6,8,0,5,14
3826,130,96,6,0,28,102
3827,455,213,141,11,90,365
3828,37,18,16,0,3,34
3829,145,63,42,0,40,105
3830,26,12,6,1,7,19
3831,91,63,6,9,13,78
3832,16,4,10,0,2,14
3833,82,48,17,0,17,65
3834,9,0,8,0,1,8
3835,42,1,32,2,7,35
3836,108,72,23,0,13,95
3837,308,141,99,12,56,252
3838,69,34,21,0,14,55
3839,43,14,19,2,8,35
3840,45,28,8,0,9,36
3841,204,48,31,88,37,167
3842,15,3,9,0,3,12
3843,1066,394,429,46,197,869
3844,10,4,6,0,0,10
3845,22,3,14,1,4,18
3846,316,165,85,15,51,265
3847,15,5,8,0,2,13
3848,46,18,20,0,8,38
3849,40,13,20,0,7,33
3850,63,41,4,0,18,45
3851,46,15,24,0,7,39
3852,20,1,12,1,6,14
3853,80,35,23,3,19,61
3854,54,34,8,0,12,42
3855,259,123,79,5,52,207
3856,53,26,15,1,11,42
3857,153,106,23,1,23,130
3858,59,30,6,5,18,41
3859,12,4,7,0,1,11
3860,15,3,8,0,4,11
3861,39,25,2,1,11,28
3862,74,28,28,1,17,57
3863,45,15,14,4,12,33
3864,26,5,14,0,7,19
3865,41,8,26,4,3,38
3866,39,13,19,0,7,32
3867,155,99,3,17,36,119
3868,30,3,21,0,6,24
3869,115,81,22,2,10,105
3870,62,12,39,1,10,52
3871,50,34,8,0,8,42
3872,15,13,0,0,2,13
3873,164,68,35,21,40,124
3874,15,3,11,0,1,14
3875,59,25,13,9,12,47
3876,141,58,51,3,29,112
3877,27,8,14,1,4,23
3878,294,25,209,2,58,236
3879,15,0,13,0,2,13
3880,190,136,15,2,37,153
3881,16,4,8,1,3,13
3882,70,36,18,4,12,58
3883,163,114,12,0,37,126
3884,336,153,113,6,64,272
3885,60,33,8,9,10,50
3886,257,189,16,0,52,205
3887,16,8,4,1,3,13
3888,101,42,20,14,25,76
3889,97,51,28,1,17,80
3890,11,6,4,0,1,10
3891,13,2,10,0,1,12
3892,40,22,16,0,2,38
3893,27,17,6,4,0,27
3894,40,30,2,0,8,32
3895,59,27,22,0,10,49
3896,265,104,99,16,46,219
3897,127,74,22,3,28,99
3898,37,28,1,1,7,30
3899,19,2,11,3,3,16
3900,54,24,19,1,10,44
3901,49,32,6,2,9,40
3902,206,43,54,68,41,165
3903,44,38,1,0,5,39
3904,36,15,14,1,6,30
3905,32,8,12,8,4,28
3906,33,0,26,0,7,26
3907,136,73,25,10,28,108
3908,160,82,38,0,40,120
3909,28,14,7,0,7,21
3910,272,69,152,1,50,222
3911,70,18,36,1,15,55
3912,38,21,3,0,14,24
3913,12,2,5,0,5,7
3914,49,9,27,5,8,41
3915,40,10,20,2,8,32
3916,91,26,47,2,16,75
3917,23,13,5,0,5,18
3918,69,38,15,0,16,53
3919,39,19,12,1,7,32
3920,72,33,25,3,11,61
3921,129,97,4,2,26,103
3922,83,32,35,1,15,68
3923,107,70,8,5,24,83
3924,73,26,34,3,10,63
3925,69,19,3,32,15,54
3926,56,28,6,8,14,42
3927,38,27,0,0,11,27
3928,38,18,15,0,5,33
3929,42,16,16,1,9,33
3930,49,32,6,2,9,40
3931,133,37,35,33,28,105
3932,25,15,5,1,4,21
3933,29,9,17,0,3,26
3934,198,113,23,22,40,158
3935,21,9,7,2,3,18
3936,38,14,16,0,8,30
3937,176,47,55,38,36,140
3938,209,109,48,0,52,157
3939,373,168,91,34,80,293
3940,285,190,69,3,23,262
3941,122,41,36,14,31,91
3942,73,36,19,0,18,55
3943,47,31,6,0,10,37
3944,19,8,8,0,3,16
3945,124,53,24,25,22,102
3946,16,5,5,0,6,10
3947,31,10,10,4,7,24
3948,366,269,18,2,77,289
3949,34,9,17,4,4,30
3950,45,25,12,2,6,39
3951,61,20,27,1,13,48
3952,64,41,5,0,18,46
3953,37,4,29,1,3,34
3954,9,5,0,3,1,8
3955,29,4,13,4,8,21
3956,62,32,7,5,18,44
3957,29,2,21,1,5,24
3958,29,16,6,0,7,22
3959,169,117,14,0,38,131
3960,33,21,5,0,7,26
3961,34,27,2,0,5,29
3962,274,17,204,0,53,221
3963,69,22,27,2,18,51
3964,77,65,1,0,11,66
3965,23,4,14,0,5,18
3966,32,21,9,0,2,30
3967,39,10,25,0,4,35
3968,68,25,22,8,13,55
3969,27,12,9,0,6,21
3970,137,51,37,15,34,103
3971,109,78,5,2,24,85
3972,106,48,34,5,19,87
3973,125,58,41,4,22,103
3974,57,14,22,7,14,43
3975,97,72,4,1,20,77
3976,54,39,8,0,7,47
3977,468,226,147,13,82,386
3978,124,43,46,8,27,97
3979,66,37,17,0,12,54
3980,3,1,1,1,0,3
3981,84,25,18,21,20,64
3982,47,1,37,0,9,38
3983,84,42,27,1,14,70
3984,40,27,2,0,11,29
3985,58,2,47,1,8,50
3986,21,2,12,1,6,15
3987,102,46,35,1,20,82
3988,17,4,8,0,5,12
3989,55,33,14,2,6,49
3990,49,22,18,0,9,40
3991,12,8,3,0,1,11
3992,103,48,18,13,24,79
3993,20,10,6,0,4,16
3994,32,21,9,0,2,30
3995,104,61,21,5,17,87
3996,33,21,7,0,5,28
3997,123,43,46,8,26,97
3998,21,9,6,1,5,16
3999,104,55,23,7,19,85
4000,202,40,54,68,40,162
4001,36,16,9,2,9,27
4002,40,26,9,0,5,35
4003,17,8,3,4,2,15
4004,30,22,3,1,4,26
4005,163,119,18,0,26,137
4006,90,33,38,0,19,71
4007,4,1,3,0,0,4
4008,78,13,41,7,17,61
4009,62,18,32,3,9,53
4010,49,32,2,2,13,36
4011,72,23,21,15,13,59
4012,4,1,1,0,2,2
4013,35,22,6,0,7,28
4014,27,16,7,0,4,23
4015,93,33,30,10,20,73
4016,72,45,10,2,15,57
4017,57,46,0,1,10,47
4018,62,32,17,1,12,50
4019,12,4,3,1,4,8
4020,40,27,1,1,11,29
4021,16,6,5,0,5,11
4022,372,269,19,2,82,290
4023,51,14,28,0,9,42
4024,45,5,29,0,11,34
4025,179,84,44,14,37,142
4026,64,35,19,0,10,54
4027,41,31,1,0,9,32
4028,35,9,18,0,8,27
4029,342,145,120,6,71,271
4030,24,5,13,0,6,18
4031,453,116,189,44,104,349
4032,162,103,29,0,30,132
4033,20,8,12,0,0,20
4034,405,142,134,42,87,318
4035,51,29,13,0,9,42
4036,60,41,5,1,13,47
4037,242,165,17,3,57,185
4038,22,3,14,0,5,17
4039,322,178,52,28,64,258
4040,30,10,5,8,7,23
4041,81,17,32,14,18,63
4042,82,45,21,0,16,66
4043,40,1,33,0,6,34
4044,87,61,5,8,13,74
4045,36,11,21,1,3,33
4046,29,6,20,0,3,26
4047,93,39,15,19,20,73
4048,155,90,32,8,25,130
4049,99,66,8,4,21,78
4050,45,23,3,11,8,37
4051,126,66,33,0,27,99
4052,56,33,9,4,10,46
4053,54,15,20,9,10,44
4054,34,15,8,0,11,23
4055,59,17,30,0,12,47
4056,15,5,8,0,2,13
4057,63,22,26,1,14,49
4058,43,34,1,0,8,35
4059,34,17,12,0,5,29
4060,31,10,6,10,5,26
4061,86,27,44,2,13,73
4062,280,78,38,118,46,234
4063,20,14,2,0,4,16
4064,58,13,35,1,9,49
4065,80,30,24,7,19,61
4066,383,201,90,17,75,308
4067,57,23,10,7,17,40
4068,24,9,11,1,3,21
4069,26,6,15,0,5,21
4070,245,19,182,0,44,201
4071,140,66,45,5,24,116
4072,102,54,22,0,26,76
4073,75,11,43,6,15,60
4074,55,33,16,0,6,49
4075,34,6,17,3,8,26
4076,89,29,38,10,12,77
4077,232,124,35,29,44,188
4078,30,21,4,0,5,25
4079,6,5,0,1,0,6
4080,82,31,36,4,11,71
4081,42,22,10,0,10,32
4082,35,9,10,5,11,24
4083,67,46,6,0,15,52
4084,62,45,6,1,10,52
4085,97,27,21,28,21,76
4086,73,33,18,13,9,64
4087,10,0,6,0,4,6
4088,157,89,31,0,37,120
4089,18,4,11,1,2,16
4090,30,15,10,0,5,25
4091,53,14,31,0,8,45
4092,62,33,8,9,12,50
4093,62,19,19,7,17,45
4094,5,3,1,0,1,4
4095,84,30,26,10,18,66
4096,68,31,24,0,13,55
4097,87,19,51,8,9,78
4098,46,21,12,1,12,34
4099,116,79,24,0,13,103
4100,46,13,16,11,6,40
4101,59,45,6,0,8,51
4102,264,173,69,3,19,245
4103,196,39,55,62,40,156
4104,69,28,22,6,13,56
4105,89,46,22,4,17,72
4106,123,50,23,26,24,99
4107,39,20,10,1,8,31
4108,17,3,12,0,2,15
4109,82,31,31,0,20,62
4110,26,3,16,0,7,19
4111,525,242,121,45,117,408
4112,97,60,11,2,24,73
4113,154,89,26,10,29,125
4114,68,36,20,2,10,58
4115,348,183,94,4,67,281
4116,212,72,94,2,44,168
4117,116,47,16,18,35,81
4118,14,8,0,2,4,10
4119,186,121,30,5,30,156
4120,40,32,2,0,6,34
4121,82,48,16,3,15,67
4122,64,38,19,2,5,59
4123,251,184,15,0,52,199
4124,372,106,140,45,81,291
4125,131,39,65,2,25,106
4126,60,31,13,1,15,45
4127,12,2,5,0,5,7
4128,267,114,96,9,48,219
4129,45,11,20,0,14,31
4130,254,108,91,9,46,208
4131,16,3,8,0,5,11
4132,76,50,10,2,14,62
4133,12,7,2,1,2,10
4134,147,37,75,1,34,113
4135,56,3,40,1,12,44
4136,90,80,2,8,0,90
4137,64,20,28,1,15,49
4138,41,27,5,4,5,36
4139,70,15,41,0,14,56
4140,37,18,11,3,5,32
4141,453,141,189,28,95,358
4142,19,6,8,3,2,17
4143,144,62,53,1,28,116
4144,20,9,9,0,2,18
4145,67,30,19,6,12,55
4146,190,63,88,3,36,154
4147,40,14,11,2,13,27
4148,450,244,104,14,88,362
4149,44,20,10,5,9,35
4150,26,9,8,3,6,20
4151,2,0,2,0,0,2
4152,10,2,6,0,2,8
4153,30,15,6,1,8,22
4154,231,52,74,56,49,182
4155,46,1,36,0,9,37
4156,44,6,28,3,7,37
4157,53,32,11,1,9,44
4158,97,39,28,10,20,77
4159,37,19,9,0,9,28
4160,27,8,9,1,9,18
4161,79,25,20,22,12,67
4162,111,85,2,0,24,87
4163,350,149,127,6,68,282
4164,34,9,17,4,4,30
4165,28,11,11,0,6,22
4166,64,30,23,1,10,54
4167,431,318,20,0,93,338
4168,280,83,135,4,58,222
4169,32,21,9,0,2,30
4170,30,12,11,1,6,24
4171,178,100,33,0,45,133
4172,154,67,55,1,31,123
4173,311,189,54,0,68,243
4174,24,5,11,2,6,18
4175,186,83,36,21,46,140
4176,67,23,27,4,13,54
4177,36,9,19,0,8,28
4178,68,28,23,0,17,51
4179,120,58,22,17,23,97
4180,536,285,92,48,111,425
4181,73,16,45,0,12,61
4182,47,35,9,3,0,47
4183,3,1,2,0,0,3
4184,298,58,183,1,56,242
4185,47,13,18,4,12,35
4186,33,0,29,2,2,31
4187,22,16,4,0,2,20
4188,426,199,140,11,76,350
4189,74,31,26,8,9,65
4190,72,21,3,33,15,57
4191,84,48,18,0,18,66
4192,400,180,98,37,85,315
4193,369,93,147,47,82,287
4194,47,6,29,0,12,35
4195,44,8,23,0,13,31
4196,60,30,11,2,17,43
4197,39,27,3,2,7,32
4198,281,175,43,0,63,218
4199,192,133,42,2,15,177
4200,101,78,4,1,18,83
4201,25,3,17,1,4,21
4202,107,24,58,3,22,85
4203,5,0,5,0,0,5
4204,67,33,20,3,11,56
4205,60,32,7,9,12,48
4206,25,10,6,0,9,16
4207,113,58,22,10,23,90
4208,139,38,44,21,36,103
4209,41,16,15,0,10,31
4210,462,118,194,46,104,358
4211,49,45,0,4,0,49
4212,80,66,1,0,13,67
4213,168,13,96,25,34,134
4214,31,21,6,0,4,27
4215,445,143,181,20,101,344
4216,53,38,9,6,0,53
4217,30,14,10,0,6,24
4218,55,32,3,11,9,46
4219,437,143,179,17,98,339
4220,45,30,11,4,0,45
4221,32,11,15,0,6,26
4222,357,186,90,20,61,296
4223,96,37,29,8,22,74
4224,393,182,129,6,76,317
4225,30,12,2,13,3,27
4226,102,67,1,12,22,80
4227,200,117,19,26,38,162
4228,53,25,22,0,6,47
4229,80,39,20,1,20,60
4230,70,30,21,0,19,51
4231,51,23,13,1,14,37
4232,10,5,5,0,0,10
4233,32,11,16,1,4,28
4234,32,12,12,2,6,26
4235,62,31,11,0,20,42
4236,47,13,19,2,13,34
4237,78,29,15,15,19,59
4238,66,28,11,8,19,47
4239,138,57,29,24,28,110
4240,28,4,20,2,2,26
4241,26,11,2,7,6,20
4242,56,35,10,0,11,45
4243,5,4,1,0,0,5
4244,36,22,5,1,8,28
4245,36,16,14,2,4,32
4246,342,141,124,6,71,271
4247,67,50,12,0,5,62
4248,46,18,20,0,8,38
4249,96,28,52,2,14,82
4250,31,11,12,1,7,24
4251,47,13,18,7,9,38
4252,10,4,1,1,4,6
4253,132,44,68,1,19,113
4254,53,37,4,1,11,42
4255,12,5,4,3,0,12
4256,36,19,8,1,8,28
4257,235,127,31,32,45,190
4258,62,20,17,16,9,53
4259,90,37,28,7,18,72
4260,77,51,17,0,9,68
4261,474,223,154,13,84,390
4262,104,21,49,14,20,84
4263,46,18,20,0,8,38
4264,61,17,31,0,13,48
4265,127,56,49,1,21,106
4266,57,27,18,1,11,46
4267,52,28,15,0,9,43
4268,13,2,9,0,2,11
4269,0,0,0,0,0,0
4270,274,207,17,0,50,224
4271,26,12,8,0,6,20
4272,55,36,6,1,12,43
4273,116,51,22,22,21,95
4274,4,0,4,0,0,4
4275,153,107,21,0,25,128
4276,79,37,28,4,10,69
4277,76,4,54,0,18,58
4278,444,215,120,14,95,349
4279,78,40,26,0,12,66
4280,190,73,45,30,42,148
4281,42,20,12,0,10,32
4282,78,18,17,32,11,67
4283,128,49,44,8,27,101
4284,67,32,14,4,17,50
4285,11,6,3,0,2,9
4286,178,99,24,21,34,144
4287,120,57,38,4,21,99
4288,24,7,12,0,5,19
4289,8,4,4,0,0,8
4290,13,7,3,0,3,10
4291,119,51,28,14,26,93
4292,428,314,20,0,94,334
4293,35,10,15,1,9,26
4294,165,98,37,1,29,136
4295,75,42,20,0,13,62
4296,126,74,21,3,28,98
4297,170,58,83,0,29,141
4298,41,20,10,0,11,30
4299,3,0,3,0,0,3
4300,31,24,3,0,4,27
4301,32,21,9,0,2,30
4302,187,51,58,37,41,146
4303,59,34,9,0,16,43
4304,15,3,8,2,2,13
4305,210,69,82,15,44,166
4306,260,173,65,4,18,242
4307,27,15,8,0,4,23
4308,161,94,37,1,29,132
4309,85,55,11,3,16,69
4310,125,105,3,0,17,108
4311,50,21,12,6,11,39
4312,88,31,32,6,19,69
4313,71,32,27,3,9,62
4314,54,32,11,0,11,43
4315,66,37,9,11,9,57
4316,168,48,51,35,34,134
4317,28,7,15,0,6,22
4318,54,18,24,0,12,42
4319,216,73,96,2,45,171
4320,24,10,7,0,7,17
4321,270,184,17,3,66,204
4322,14,7,2,3,2,12
4323,102,44,36,0,22,80
4324,175,74,26,30,45,130
4325,95,72,6,1,16,79
4326,85,46,15,1,23,62
4327,1064,390,425,46,203,861
4328,167,130,7,0,30,137
4329,194,78,27,54,35,159
4330,182,48,18,87,29,153
4331,25,9,12,0,4,21
4332,32,12,2,14,4,28
4333,154,49,78,4,23,131
4334,186,49,98,4,35,151
4335,40,17,10,0,13,27
4336,106,36,40,5,25,81
4337,5,3,1,0,1,4
4338,36,16,6,6,8,28
4339,24,5,14,1,4,20
4340,19,5,7,3,4,15
4341,94,25,22,20,27,67
4342,32,18,6,1,7,25
4343,320,231,16,2,71,249
4344,23,6,14,2,1,22
4345,33,16,12,0,5,28
4346,89,33,38,3,15,74
4347,284,101,123,15,45,239
4348,71,47,12,1,11,60
4349,41,6,24,0,11,30
4350,25,17,0,0,8,17
4351,87,48,17,0,22,65
4352,13,2,7,1,3,10
4353,161,98,20,8,35,126
4354,46,18,20,0,8,38
4355,34,11,13,0,10,24
4356,193,111,63,4,15,178
4357,102,29,54,0,19,83
4358,265,174,35,6,50,215
4359,38,19,9,1,9,29
4360,121,88,5,1,27,94
4361,31,9,14,4,4,27
4362,110,49,30,11,20,90
4363,25,11,10,0,4,21
4364,141,109,6,0,26,115
4365,46,18,20,0,8,38
4366,68,30,24,0,14,54
4367,62,30,24,0,8,54
4368,31,16,6,0,9,22
4369,91,50,26,11,4,87
4370,152,100,28,0,24,128
4371,148,60,57,8,23,125
4372,83,48,19,0,16,67
4373,22,12,2,3,5,17
4374,95,57,15,4,19,76
4375,561,318,135,18,90,471
4376,28,6,19,0,3,25
4377,16,9,2,0,5,11
4378,30,21,3,0,6,24
4379,157,43,74,4,36,121
4380,361,259,18,2,82,279
4381,4,2,1,0,1,3
4382,5,0,3,0,2,3
4383,67,35,20,2,10,57
4384,17,5,10,0,2,15
4385,641,376,139,15,111,530
4386,59,10,35,0,14,45
4387,31,22,1,0,8,23
4388,117,25,61,0,31,86
4389,21,0,17,0,4,17
4390,32,22,3,0,7,25
4391,44,32,5,0,7,37
4392,32,21,9,0,2,30
4393,61,27,17,3,14,47
4394,30,12,13,0,5,25
4395,102,34,38,12,18,84
4396,53,34,7,0,12,41
4397,5,0,3,0,2,3
4398,336,246,17,2,71,265
4399,135,103,9,0,23,112
4400,97,44,21,9,23,74
4401,117,27,53,15,22,95
4402,16,6,7,0,3,13
4403,108,54,33,0,21,87
4404,29,12,14,0,3,26
4405,39,21,12,0,6,33
4406,15,4,9,0,2,13
4407,77,21,41,2,13,64
4408,44,24,5,6,9,35
4409,45,28,1,6,10,35
4410,73,25,32,0,16,57
4411,274,22,195,2,55,219
4412,28,11,7,0,10,18
4413,58,18,15,13,12,46
4414,108,45,18,21,24,84
4415,97,52,23,4,18,79
4416,160,93,37,1,29,131
4417,102,36,47,0,19,83
4418,18,5,10,0,3,15
4419,42,6,18,12,6,36
4420,22,3,16,0,3,19
4421,43,22,12,0,9,34
4422,65,23,26,0,16,49
4423,80,37,25,0,18,62
4424,50,21,7,9,13,37
4425,75,36,21,6,12,63
4426,147,74,47,0,26,121
4427,121,26,43,30,22,99
4428,59,36,14,0,9,50
4429,70,50,2,0,18,52
4430,163,121,6,1,35,128
4431,8,5,1,0,2,6
4432,114,32,32,27,23,91
4433,46,18,20,0,8,38
4434,554,330,111,11,102,452
4435,426,239,99,0,88,338
4436,42,13,17,3,9,33
4437,6,2,4,0,0,6
4438,650,361,158,24,107,543
4439,12,6,2,1,3,9
4440,66,41,9,3,13,53
4441,20,0,13,0,7,13
4442,42,18,14,3,7,35
4443,32,21,9,0,2,30
4444,61,53,2,0,6,55
4445,179,78,29,28,44,135
4446,66,40,16,4,6,60
4447,24,19,3,0,2,22
4448,136,80,30,0,26,110
4449,51,11,29,4,7,44
4450,71,4,51,1,15,56
4451,52,22,14,6,10,42
4452,354,161,118,6,69,285
4453,126,67,24,12,23,103
4454,37,10,17,1,9,28
4455,56,16,12,18,10,46
4456,15,6,2,3,4,11
4457,2,1,0,1,0,2
4458,474,270,92,11,101,373
4459,28,11,6,6,5,23
4460,52,30,14,0,8,44
4461,173,67,43,24,39,134
4462,68,11,44,1,12,56
4463,121,82,18,3,18,103
4464,68,47,5,5,11,57
4465,30,19,6,0,5,25
4466,130,31,71,1,27,103
4467,38,18,9,1,10,28
4468,11,0,9,0,2,9
4469,32,11,13,0,8,24
4470,20,9,4,0,7,13
4471,8,1,5,0,2,6
4472,14,9,3,1,1,13
4473,50,0,32,3,15,35
4474,26,16,2,0,8,18
4475,69,32,27,0,10,59
4476,65,22,27,3,13,52
4477,19,8,6,0,5,14
4478,202,104,34,28,36,166
4479,366,272,18,2,74,292
4480,27,16,7,0,4,23
4481,48,10,26,0,12,36
4482,46,9,29,0,8,38
4483,98,82,3,0,13,85
4484,43,19,12,6,6,37
4485,14,1,9,0,4,10
4486,99,56,8,17,18,81
4487,16,6,9,0,1,15
4488,122,42,56,4,20,102
4489,110,31,59,0,20,90
4490,17,4,11,0,2,15
4491,61,16,30,0,15,46
4492,204,129,26,11,38,166
4493,127,74,22,3,28,99
4494,37,18,16,0,3,34
4495,95,29,37,5,24,71
4496,12,6,4,0,2,10
4497,12,9,1,0,2,10
4498,99,28,47,7,17,82
4499,184,71,59,7,47,137
4500,46,36,1,0,9,37
4501,58,23,16,4,15,43
4502,2,1,0,1,0,2
4503,28,8,8,5,7,21
4504,69,50,7,3,9,60
4505,26,2,19,0,5,21
4506,94,46,34,2,12,82
4507,65,37,12,1,15,50
4508,30,2,21,1,6,24
4509,92,48,28,1,15,77
4510,56,37,12,0,7,49
4511,10,2,8,0,0,10
4512,8,1,4,0,3,5
4513,88,27,31,12,18,70
4514,178,100,33,0,45,133
4515,26,19,3,1,3,23
4516,36,14,16,0,6,30
4517,39,19,9,3,8,31
4518,70,13,43,0,14,56
4519,58,41,6,1,10,48
4520,170,112,27,1,30,140
4521,280,195,18,4,63,217
4522,204,112,42,14,36,168
4523,28,15,5,0,8,20
4524,55,25,17,1,12,43
4525,28,8,14,2,4,24
4526,47,27,10,2,8,39
4527,45,7,29,5,4,41
4528,75,48,8,4,15,60
4529,224,95,46,25,58,166
4530,88,44,25,2,17,71
4531,257,110,87,16,44,213
4532,214,120,50,0,44,170
4533,46,18,20,0,8,38
4534,9,4,5,0,0,9
4535,33,24,5,0,4,29
4536,87,53,18,1,15,72
4537,120,58,39,0,23,97
4538,654,390,125,21,118,536
4539,46,27,9,4,6,40
4540,224,133,19,25,47,177
4541,28,2,11,8,7,21
4542,172,114,27,1,30,142
4543,3,2,1,0,0,3
4544,81,35,32,0,14,67
4545,9,2,3,1,3,6
4546,46,18,20,0,8,38
4547,193,102,35,20,36,157
4548,90,42,21,12,15,75
4549,32,14,9,0,9,23
4550,137,64,45,4,24,113
4551,18,8,9,0,1,17
4552,112,48,39,4,21,91
4553,231,149,64,4,14,217
4554,193,88,47,20,38,155
4555,170,123,4,2,41,129
4556,210,79,58,28,45,165
4557,8,1,4,1,2,6
4558,8,2,4,0,2,6
4559,52,16,22,2,12,40
4560,210,53,119,2,36,174
4561,333,168,94,5,66,267
4562,155,25,100,1,29,126
4563,32,21,9,0,2,30
4564,32,21,9,0,2,30
4565,115,24,56,15,20,95
4566,107,43,37,5,22,85
4567,71,38,2,17,14,57
4568,150,4,123,0,23,127
4569,142,59,55,1,27,115
4570,46,34,0,0,12,34
4571,59,35,15,0,9,50
4572,30,4,23,0,3,27
4573,63,12,40,6,5,58
4574,71,35,24,1,11,60
4575,51,27,10,2,12,39
4576,3,1,1,0,1,2
4577,75,37,15,7,16,59
4578,63,17,26,4,16,47
4579,29,11,12,0,6,23
4580,59,43,5,4,7,52
4581,105,35,25,25,20,85
4582,5,2,2,0,1,4
4583,17,12,1,0,4,13
4584,51,11,15,10,15,36
4585,44,12,20,2,10,34
4586,120,45,35,14,26,94
4587,23,17,4,2,0,23
4588,298,183,49,6,60,238
4589,43,0,31,2,10,33
4590,119,45,38,12,24,95
4591,32,21,9,0,2,30
4592,39,14,14,0,11,28
4593,581,404,52,1,124,457
4594,75,32,28,1,14,61
4595,163,84,45,3,31,132
4596,73,40,21,0,12,61
4597,326,205,48,13,60,266
4598,46,27,3,9,7,39
4599,362,272,20,0,70,292
4600,59,31,12,3,13,46
4601,91,25,47,7,12,79
4602,64,22,13,18,11,53
4603,21,11,5,0,5,16
4604,67,33,6,11,17,50
4605,0,0,0,0,0,0
4606,12,8,2,0,2,10
4607,19,13,2,0,4,15
4608,217,91,13,76,37,180
4609,50,26,12,1,11,39
4610,62,33,10,2,17,45
4611,439,145,154,48,92,347
4612,140,54,44,18,24,116
4613,62,19,32,1,10,52
4614,429,200,118,19,92,337
4615,201,135,20,0,46,155
4616,80,20,33,0,27,53
4617,21,10,4,0,7,14
4618,1282,518,169,337,258,1024
4619,465,218,146,13,88,377
4620,18,9,5,0,4,14
4621,64,37,16,0,11,53
4622,61,14,30,2,15,46
4623,28,2,21,1,4,24
4624,136,82,21,4,29,107
4625,60,2,33,18,7,53
4626,77,41,20,4,12,65
4627,171,119,11,10,31,140
4628,24,7,13,3,1,23
4629,5,1,2,0,2,3
4630,252,186,13,1,52,200
4631,81,31,33,2,15,66
4632,46,13,10,13,10,36
4633,93,62,14,0,17,76
4634,29,21,2,2,4,25
4635,41,11,25,0,5,36
4636,32,21,9,0,2,30
4637,16,0,11,0,5,11
4638,162,19,80,26,37,125
4639,9,5,4,0,0,9
4640,196,137,43,3,13,183
4641,218,147,30,0,41,177
4642,33,9,16,0,8,25
4643,27,10,12,1,4,23
4644,182,110,6,22,44,138
4645,39,21,12,0,6,33
4646,124,39,51,7,27,97
4647,77,28,26,8,15,62
4648,19,1,15,0,3,16
4649,75,30,32,2,11,64
4650,25,3,12,4,6,19
4651,156,45,12,70,29,127
4652,194,88,48,20,38,156
4653,36,8,19,0,9,27
4654,22,13,3,0,6,16
4655,34,24,8,2,0,34
4656,16,10,3,3,0,16
4657,11,3,4,0,4,7
4658,130,40,59,3,28,102
4659,70,19,33,1,17,53
4660,18,1,13,0,4,14
4661,37,13,13,2,9,28
4662,24,23,0,0,1,23
4663,49,32,6,2,9,40
4664,66,21,26,2,17,49
4665,12,4,4,1,3,9
4666,44,3,33,0,8,36
4667,128,96,4,2,26,102
4668,41,2,26,0,13,28
4669,32,21,9,0,2,30
4670,58,28,21,0,9,49
4671,149,94,30,1,24,125
4672,55,18,23,6,8,47
4673,394,193,113,14,74,320
4674,303,225,19,1,58,245
4675,25,4,13,0,8,17
4676,46,8,30,0,8,38
4677,577,333,118,17,109,468
4678,102,57,14,10,21,81
4679,34,14,11,2,7,27
4680,89,59,13,9,8,81
4681,85,32,36,3,14,71
4682,26,8,8,0,10,16
4683,49,32,6,2,9,40
4684,83,60,2,1,20,63
4685,118,75,24,0,19,99
4686,663,368,165,22,108,555
4687,110,77,17,0,16,94
4688,516,278,85,48,105,411
4689,50,27,19,0,4,46
4690,69,47,8,4,10,59
4691,31,8,10,6,7,24
4692,513,368,34,1,110,403
4693,162,50,83,0,29,133
4694,103,36,44,0,23,80
4695,41,10,13,9,9,32
4696,38,6,4,19,9,29
4697,15,8,1,5,1,14
4698,465,219,146,13,87,378
4699,18,3,9,1,5,13
4700,43,24,14,0,5,38
4701,9,4,5,0,0,9
4702,27,8,13,0,6,21
4703,145,15,99,2,29,116
4704,10,6,1,0,3,7
4705,86,40,26,2,18,68
4706,19,2,13,1,3,16
4707,18,13,3,0,2,16
4708,47,16,16,8,7,40
4709,25,11,8,1,5,20
4710,272,137,72,0,63,209
4711,71,45,15,0,11,60
4712,130,37,42,18,33,97
4713,14,7,3,1,3,11
4714,21,14,5,0,2,19
4715,73,31,34,1,7,66
4716,63,42,12,0,9,54
4717,114,66,9,11,28,86
4718,75,39,7,3,26,49
4719,138,77,37,1,23,115
4720,11,5,2,2,2,9
4721,125,27,61,5,32,93
4722,50,23,13,3,11,39
4723,458,225,90,50,93,365
4724,105,61,19,7,18,87
4725,36,18,9,2,7,29
4726,123,40,32,28,23,100
4727,58,44,6,0,8,50
4728,91,60,20,0,11,80
4729,59,34,15,0,10,49
4730,171,113,27,1,30,141
4731,118,47,27,16,28,90
4732,39,20,8,3,8,31
4733,198,56,35,74,33,165
4734,27,16,7,0,4,23
4735,267,59,144,7,57,210
4736,58,12,33,0,13,45
4737,69,33,18,3,15,54
4738,180,104,19,22,35,145
4739,8,5,3,0,0,8
4740,48,23,9,5,11,37
4741,25,15,6,0,4,21
4742,401,184,134,11,72,329
4743,33,25,4,0,4,29
4744,37,10,17,2,8,29
4745,35,22,7,1,5,30
4746,67,46,9,0,12,55
4747,107,64,17,2,24,83
4748,89,35,30,1,23,66
4749,80,55,9,3,13,67
4750,49,22,18,0,9,40
4751,234,86,96,4,48,186
4752,68,46,2,2,18,50
4753,111,49,29,13,20,91
4754,669,387,143,20,119,550
4755,85,55,18,2,10,75
4756,14,5,4,0,5,9
4757,62,47,6,3,6,56
4758,110,61,15,11,23,87
4759,285,158,62,11,54,231
4760,32,21,9,0,2,30
4761,44,31,4,0,9,35
4762,68,39,3,14,12,56
4763,41,21,10,1,9,32
4764,135,104,11,0,20,115
4765,154,25,100,1,28,126
4766,62,23,24,4,11,51
4767,62,29,17,4,12,50
4768,46,18,20,0,8,38
4769,154,115,9,4,26,128
4770,38,12,20,1,5,33
4771,73,16,34,3,20,53
4772,35,3,20,0,12,23
4773,69,19,35,0,15,54
4774,51,21,22,0,8,43
4775,40,21,8,2,9,31
4776,57,41,6,0,10,47
4777,180,128,13,1,38,142
4778,56,20,18,4,14,42
4779,160,70,54,7,29,131
4780,178,100,33,0,45,133
4781,467,221,147,13,86,381
4782,195,88,49,20,38,157
4783,55,40,4,1,10,45
4784,86,62,8,0,16,70
4785,510,237,112,58,103,407
4786,37,7,19,4,7,30
4787,96,44,12,21,19,77
4788,32,21,3,0,8,24
4789,50,22,12,1,15,35
4790,39,12,18,0,9,30
4791,55,32,15,2,6,49
4792,26,14,8,0,4,22
4793,190,78,43,22,47,143
4794,153,39,73,4,37,116
4795,54,2,43,0,9,45
4796,52,31,11,0,10,42
4797,645,378,141,15,111,534
4798,102,68,1,11,22,80
4799,35,10,18,4,3,32
4800,233,93,14,82,44,189
4801,46,18,20,0,8,38
4802,47,17,21,0,9,38
4803,4,0,2,0,2,2
4804,117,38,56,2,21,96
4805,54,32,11,0,11,43
4806,76,5,54,1,16,60
4807,100,46,15,24,15,85
4808,137,85,29,6,17,120
4809,125,59,33,0,33,92
4810,66,27,22,2,15,51
4811,434,208,118,20,88,346
4812,213,115,62,0,36,177
4813,80,38,32,1,9,71
4814,36,12,16,0,8,28
4815,17,7,6,1,3,14
4816,49,27,12,3,7,42
4817,55,33,10,0,12,43
4818,54,32,9,1,12,42
4819,32,17,5,3,7,25
4820,366,94,146,40,86,280
4821,41,12,22,1,6,35
4822,132,89,18,1,24,108
4823,47,23,3,13,8,39
4824,81,39,16,11,15,66
4825,30,22,3,1,4,26
4826,156,90,27,10,29,127
4827,92,26,49,0,17,75
4828,34,12,9,6,7,27
4829,171,58,51,24,38,133
4830,93,88,0,5,0,93
4831,113,80,14,9,10,103
4832,152,74,41,5,32,120
4833,57,19,31,0,7,50
4834,61,31,16,3,11,50
4835,88,59,11,0,18,70
4836,100,74,6,0,20,80
4837,54,27,16,1,10,44
4838,75,29,21,8,17,58
4839,69,44,11,0,14,55
4840,448,330,21,0,97,351
4841,32,6,15,4,7,25
4842,44,11,26,0,7,37
4843,28,10,11,1,6,22
4844,33,23,0,0,10,23
4845,7,1,4,2,0,7
4846,28,12,8,4,4,24
4847,76,45,11,4,16,60
4848,83,29,30,11,13,70
4849,100,56,20,7,17,83
4850,75,29,33,3,10,65
4851,46,18,20,0,8,38
4852,20,9,5,0,6,14
4853,37,16,8,5,8,29
4854,23,14,2,0,7,16
4855,32,13,8,3,8,24
4856,10,5,4,0,1,9
4857,48,21,16,2,9,39
4858,52,9,26,5,12,40
4859,67,12,43,0,12,55
4860,362,160,126,6,70,292
4861,81,30,23,17,11,70
4862,451,332,20,0,99,352
4863,83,25,42,2,14,69
4864,36,8,19,0,9,27
4865,12,1,8,0,3,9
4866,40,29,5,1,5,35
4867,73,49,7,2,15,58
4868,38,19,9,1,9,29
4869,32,14,9,0,9,23
4870,30,17,6,1,6,24
4871,4,1,2,0,1,3
4872,43,9,24,0,10,33
4873,24,2,18,1,3,21
4874,229,139,41,6,43,186
4875,219,111,36,35,37,182
4876,28,1,19,0,8,20
4877,27,11,9,5,2,25
4878,34,13,13,1,7,27
4879,483,247,90,47,99,384
4880,27,14,6,3,4,23
4881,46,33,4,2,7,39
4882,114,53,26,2,33,81
4883,193,80,39,30,44,149
4884,83,66,0,4,13,70
4885,38,12,18,1,7,31
4886,36,16,13,1,6,30
4887,91,67,4,1,19,72
4888,30,8,16,0,6,24
4889,30,2,20,0,8,22
4890,45,16,11,3,15,30
4891,52,15,26,0,11,41
4892,39,6,21,4,8,31
4893,125,38,47,19,21,104
4894,116,66,29,0,21,95
4895,89,55,16,3,15,74
4896,52,32,9,3,8,44
4897,32,21,9,0,2,30
4898,45,13,23,0,9,36
4899,5,0,3,0,2,3
4900,16,9,1,0,6,10
4901,64,41,5,0,18,46
4902,102,26,44,17,15,87
4903,23,14,2,0,7,16
4904,31,13,9,1,8,23
4905,160,108,26,0,26,134
4906,451,208,153,9,81,370
4907,29,16,4,4,5,24
4908,47,22,20,0,5,42
4909,157,54,38,30,35,122
4910,130,42,50,13,25,105
4911,16,7,6,0,3,13
4912,135,54,40,15,26,109
4913,77,26,35,0,16,61
4914,82,28,38,3,13,69
4915,9,0,4,2,3,6
4916,10,3,5,0,2,8
4917,113,47,16,17,33,80
4918,110,76,18,0,16,94
4919,123,36,61,0,26,97
4920,30,12,15,0,3,27
4921,30,6,19,0,5,25
4922,168,83,51,3,31,137
4923,53,18,24,1,10,43
4924,49,9,29,1,10,39
4925,102,52,16,2,32,70
4926,488,248,91,49,100,388
4927,20,5,10,2,3,17
4928,33,13,9,1,10,23
4929,60,30,11,2,17,43
4930,127,42,47,14,24,103
4931,29,16,9,0,4,25
4932,202,133,23,0,46,156
4933,109,58,25,4,22,87
4934,191,133,11,8,39,152
4935,28,17,6,0,5,23
4936,134,95,9,0,30,104
4937,29,20,2,0,7,22
4938,95,25,51,0,19,76
4939,100,56,20,7,17,83
4940,8,2,5,0,1,7
4941,143,61,40,19,23,120
4942,46,21,12,7,6,40
4943,42,24,12,0,6,36
4944,66,1,52,0,13,53
4945,144,62,53,1,28,116
4946,47,27,10,1,9,38
4947,209,115,66,7,21,188
4948,14,4,1,6,3,11
4949,432,202,96,42,92,340
4950,118,54,25,16,23,95
4951,264,132,53,29,50,214
4952,32,21,9,0,2,30
4953,69,30,29,0,10,59
4954,19,13,1,1,4,15
4955,22,11,8,0,3,19
4956,37,8,25,1,3,34
4957,13,11,1,0,1,12
4958,65,20,26,10,9,56
4959,19,15,0,0,4,15
4960,38,12,13,6,7,31
4961,20,9,7,1,3,17
4962,46,18,20,0,8,38
4963,55,16,31,1,7,48
4964,74,31,14,7,22,52
4965,53,27,10,5,11,42
4966,88,39,33,1,15,73
4967,203,81,78,13,31,172
4968,34,6,12,4,12,22
4969,171,86,46,4,35,136
4970,32,12,7,7,6,26
4971,127,47,45,8,27,100
4972,219,72,83,15,49,170
4973,62,28,20,0,14,48
4974,86,47,19,0,20,66
4975,29,23,4,0,2,27
4976,31,4,9,10,8,23
4977,382,173,129,11,69,313
4978,158,83,39,0,36,122
4979,160,114,11,0,35,125
4980,15,0,11,0,4,11
4981,57,23,19,5,10,47
4982,54,30,14,2,8,46
4983,161,82,33,18,28,133
4984,29,11,3,8,7,22
4985,138,54,54,3,27,111
4986,159,112,19,2,26,133
4987,180,128,14,1,37,143
4988,24,19,3,0,2,22
4989,93,11,58,5,19,74
4990,138,81,30,0,27,111
4991,106,61,17,4,24,82
4992,13,0,9,0,4,9
4993,101,41,43,3,14,87
4994,9,6,1,0,2,7
4995,182,145,9,0,28,154
4996,182,95,46,0,41,141
4997,17,12,1,2,2,15
4998,108,54,33,0,21,87
4999,136,44,53,8,31,105
5000,29,6,13,2,8,21
5001,338,167,106,5,60,278
5002,83,54,9,3,17,66
5003,53,22,4,17,10,43
5004,86,55,16,0,15,71
5005,72,26,22,7,17,55
5006,38,14,10,3,11,27
5007,11,8,0,2,1,10
5008,270,199,16,0,55,215
5009,38,17,16,0,5,33
5010,28,13,6,2,7,21
5011,36,26,0,2,8,28
5012,220,149,30,0,41,179
5013,36,9,21,0,6,30
5014,40,12,23,0,5,35
5015,154,123,5,3,23,131
5016,69,32,24,2,11,58
5017,23,11,2,7,3,20
5018,50,30,12,0,8,42
5019,18,7,8,0,3,15
5020,118,33,42,14,29,89
5021,10,1,3,0,6,4
5022,16,1,12,1,2,14
5023,444,233,96,13,102,342
5024,31,2,21,0,8,23
5025,223,61,119,3,40,183
5026,44,15,9,8,12,32
5027,44,31,9,4,0,44
5028,91,23,48,0,20,71
5029,116,32,46,10,28,88
5030,123,69,28,0,26,97
5031,6,3,0,0,3,3
5032,135,76,22,3,34,101
5033,133,72,24,4,33,100
5034,288,152,70,18,48,240
5035,18,0,14,1,3,15
5036,32,13,11,0,8,24
5037,34,6,23,0,5,29
5038,63,36,12,2,13,50
5039,60,35,7,7,11,49
5040,102,50,15,14,23,79
5041,86,39,31,0,16,70
5042,29,7,10,5,7,22
5043,37,4,26,5,2,35
5044,22,17,5,0,0,22
5045,103,46,15,20,22,81
5046,31,11,14,0,6,25
5047,41,17,19,0,5,36
5048,50,24,21,0,5,45
5049,53,6,34,0,13,40
5050,35,19,9,0,7,28
5051,34,25,2,0,7,27
5052,55,41,4,3,7,48
5053,154,55,47,17,35,119
5054,168,126,16,1,25,143
5055,50,34,2,1,13,37
5056,55,18,14,7,16,39
5057,38,9,17,2,10,28
5058,440,141,188,12,99,341
5059,0,0,0,0,0,0
5060,85,38,29,4,14,71
5061,13,13,0,0,0,13
5062,81,49,17,3,12,69
5063,6,2,2,0,2,4
5064,102,70,8,2,22,80
5065,19,14,3,0,2,17
5066,90,57,12,1,20,70
5067,79,40,26,4,9,70
5068,323,74,161,7,81,242
5069,93,43,13,12,25,68
5070,70,45,9,2,14,56
5071,288,204,16,4,64,224
5072,78,31,21,12,14,64
5073,36,7,21,0,8,28
5074,63,41,4,0,18,45
5075,58,30,8,6,14,44
5076,52,26,13,0,13,39
5077,389,224,86,0,79,310
5078,41,16,16,2,7,34
5079,51,30,11,0,10,41
5080,107,36,41,11,19,88
5081,49,28,16,0,5,44
5082,50,21,12,1,16,34
5083,10,7,3,0,0,10
5084,12,0,7,2,3,9
5085,85,56,14,0,15,70
5086,127,74,22,3,28,99
5087,84,39,27,4,14,70
5088,83,22,49,0,12,71
5089,102,79,3,0,20,82
5090,52,43,1,1,7,45
5091,32,21,9,0,2,30
5092,96,42,12,15,27,69
5093,14,2,9,0,3,11
5094,123,46,4,53,20,103
5095,36,26,8,2,0,36
5096,25,5,14,0,6,19
5097,65,20,25,4,16,49
5098,26,21,2,3,0,26
5099,192,75,63,19,35,157
5100,96,55,27,10,4,92
5101,38,15,14,0,9,29
5102,57,6,38,0,13,44
5103,8,2,5,0,1,7
5104,30,8,7,5,10,20
5105,42,30,2,0,10,32
5106,171,72,56,3,40,131
5107,64,21,26,4,13,51
5108,40,29,3,2,6,34
5109,17,2,14,0,1,16
5110,36,25,4,1,6,30
5111,31,9,10,6,6,25
5112,54,28,21,0,5,49
5113,240,163,31,3,43,197
5114,10,6,4,0,0,10
5115,59,35,14,0,10,49
5116,214,106,38,34,36,178
5117,6,3,0,3,0,6
5118,52,32,10,2,8,44
5119,418,302,23,0,93,325
5120,74,29,31,5,9,65
5121,38,4,22,0,12,26
5122,53,26,15,0,12,41
5123,241,103,80,16,42,199
5124,284,136,71,19,58,226
5125,19,8,9,0,2,17
5126,124,47,47,0,30,94
5127,653,376,143,17,117,536
5128,36,14,17,1,4,32
5129,21,4,14,0,3,18
5130,64,9,33,5,17,47
5131,532,384,33,1,114,418
5132,54,19,15,7,13,41
5133,159,78,25,25,31,128
5134,43,14,0,19,10,33
5135,231,78,88,15,50,181
5136,46,18,20,0,8,38
5137,435,206,140,12,77,358
5138,24,14,3,0,7,17
5139,10,1,6,0,3,7
5140,40,7,19,1,13,27
5141,514,252,100,56,106,408
5142,65,42,3,8,12,53
5143,39,26,3,3,7,32
5144,28,9,6,5,8,20
5145,59,2,32,18,7,52
5146,16,5,8,1,2,14
5147,246,102,15,82,47,199
5148,65,30,21,1,13,52
5149,81,29,37,5,10,71
5150,72,43,15,0,14,58
5151,32,21,9,0,2,30
5152,36,5,23,0,8,28
5153,16,2,9,1,4,12
5154,228,172,9,0,47,181
5155,40,13,16,0,11,29
5156,200,138,46,2,14,186
5157,50,20,16,0,14,36
5158,90,36,22,21,11,79
5159,40,26,6,2,6,34
5160,54,25,18,0,11,43
5161,324,136,113,6,69,255
5162,131,85,26,3,17,114
5163,30,20,6,4,0,30
5164,168,86,39,0,43,125
5165,16,6,7,0,3,13
5166,161,49,50,24,38,123
5167,158,117,10,2,29,129
5168,64,30,13,9,12,52
5169,112,37,43,0,32,80
5170,24,10,6,2,6,18
5171,5,3,1,0,1,4
5172,43,33,5,3,2,41
5173,239,157,22,3,57,182
5174,20,10,2,3,5,15
5175,161,83,36,7,35,126
5176,196,88,50,20,38,158
5177,190,105,27,23,35,155
5178,21,0,19,0,2,19
5179,36,15,14,1,6,30
5180,50,16,19,0,15,35
5181,35,16,5,5,9,26
5182,132,47,29,26,30,102
5183,25,13,3,0,9,16
5184,28,12,13,0,3,25
5185,666,390,142,17,117,549
5186,47,23,9,2,13,34
5187,46,25,10,0,11,35
5188,61,11,32,6,12,49
5189,123,47,29,21,26,97
5190,104,58,25,4,17,87
5191,60,37,11,0,12,48
5192,586,330,143,19,94,492
5193,7,1,3,0,3,4
5194,35,7,21,0,7,28
5195,56,37,12,0,7,49
5196,22,14,3,2,3,19
5197,32,21,9,0,2,30
5198,10,2,6,0,2,8
5199,98,32,45,1,20,78
5200,97,65,9,3,20,77
5201,15,13,0,0,2,13
5202,26,12,9,2,3,23
5203,38,16,8,5,9,29
5204,55,27,15,0,13,42
5205,34,12,13,0,9,25
5206,73,26,26,7,14,59
5207,9,5,0,3,1,8
5208,160,67,33,21,39,121
5209,17,11,3,0,3,14
5210,101,28,53,4,16,85
5211,91,61,2,10,18,73
5212,466,175,148,44,99,367
5213,41,21,5,5,10,31
5214,23,4,16,0,3,20
5215,38,2,27,1,8,30
5216,121,49,16,19,37,84
5217,32,13,11,2,6,26
5218,64,25,26,4,9,55
5219,76,42,17,3,14,62
5220,52,9,33,6,4,48
5221,154,89,32,0,33,121
5222,32,21,2,0,9,23
5223,95,58,17,0,20,75
5224,138,21,71,16,30,108
5225,20,13,4,0,3,17
5226,31,14,10,0,7,24
5227,86,37,11,20,18,68
5228,177,69,28,51,29,148
5229,19,2,12,0,5,14
5230,143,83,21,2,37,106
5231,8,2,4,0,2,6
5232,64,41,5,0,18,46
5233,155,116,3,1,35,120
5234,50,25,18,0,7,43
5235,46,18,20,0,8,38
5236,178,100,33,0,45,133
5237,70,18,28,10,14,56
5238,55,37,8,1,9,46
5239,277,113,117,4,43,234
5240,25,6,10,5,4,21
5241,272,136,54,29,53,219
5242,71,15,39,2,15,56
5243,32,21,9,0,2,30
5244,34,18,9,0,7,27
5245,432,314,27,0,91,341
5246,34,9,19,0,6,28
5247,26,8,8,2,8,18
5248,23,4,3,10,6,17
5249,23,5,9,1,8,15
5250,579,415,46,1,117,462
5251,116,44,41,8,23,93
5252,25,5,14,0,6,19
5253,3,0,0,0,3,0
5254,21,12,3,0,6,15
5255,156,71,50,5,30,126
5256,87,45,12,2,28,59
5257,17,9,7,0,1,16
5258,32,21,9,0,2,30
5259,459,220,139,13,87,372
5260,264,170,37,7,50,214
5261,38,0,31,0,7,31
5262,128,76,27,0,25,103
5263,34,12,10,3,9,25
5264,35,10,16,1,8,27
5265,39,11,23,0,5,34
5266,17,9,0,3,5,12
5267,225,73,102,2,48,177
5268,27,10,13,0,4,23
5269,234,118,69,0,47,187
5270,69,37,22,1,9,60
5271,6,2,1,0,3,3
5272,30,8,7,6,9,21
5273,228,57,33,100,38,190
5274,87,46,23,0,18,69
5275,105,45,31,3,26,79
5276,99,55,19,6,19,80
5277,8,2,3,0,3,5
5278,44,18,14,2,10,34
5279,107,48,35,5,19,88
5280,46,18,20,0,8,38
5281,56,2,45,0,9,47
5282,71,19,40,1,11,60
5283,169,121,11,6,31,138
5284,342,175,82,13,72,270
5285,19,3,12,0,4,15
5286,40,9,11,9,11,29
5287,210,120,63,7,20,190
5288,583,388,71,4,120,463
5289,231,79,89,14,49,182
5290,32,21,9,0,2,30
5291,190,55,97,2,36,154
5292,28,6,13,3,6,22
5293,128,49,30,22,27,101
5294,46,18,20,0,8,38
5295,5,1,3,0,1,4
5296,18,12,5,1,0,18
5297,37,26,6,1,4,33
5298,54,29,14,2,9,45
5299,225,82,94,4,45,180
5300,15,5,4,0,6,9
5301,35,5,14,9,7,28
5302,45,28,5,6,6,39
5303,32,21,9,0,2,30
5304,36,8,22,1,5,31
5305,186,105,43,9,29,157
5306,22,14,4,1,3,19
5307,247,103,15,82,47,200
5308,281,97,124,16,44,237
5309,349,182,93,15,59,290
5310,16,13,2,0,1,15
5311,211,44,56,71,40,171
5312,271,144,78,0,49,222
5313,107,54,31,0,22,85
5314,32,13,8,5,6,26
5315,55,40,8,0,7,48
5316,69,26,31,4,8,61
5317,47,20,19,0,8,39
5318,48,33,4,0,11,37
5319,92,41,17,10,24,68
5320,35,11,14,0,10,25
5321,27,18,6,3,0,27
5322,586,421,46,1,118,468
5323,237,134,30,26,47,190
5324,92,58,12,2,20,72
5325,13,7,4,0,2,11
5326,28,18,3,0,7,21
5327,37,12,20,1,4,33
5328,34,19,5,2,8,26
5329,33,12,13,0,8,25
5330,58,34,6,7,11,47
5331,32,16,6,0,10,22
5332,105,51,23,7,24,81
5333,51,17,28,1,5,46
5334,18,7,6,1,4,14
5335,81,50,16,4,11,70
5336,31,4,11,5,11,20
5337,8,2,3,0,3,5
5338,178,73,29,28,48,130
5339,99,62,15,1,21,78
5340,50,14,21,0,15,35
5341,157,114,10,5,28,129
5342,16,13,0,0,3,13
5343,75,27,30,4,14,61
5344,64,17,28,7,12,52
5345,17,9,2,1,5,12
5346,124,82,29,0,13,111
5347,13,8,2,0,3,10
5348,306,150,87,10,59,247
5349,144,67,48,5,24,120
5350,8,1,5,0,2,6
5351,19,5,10,1,3,16
5352,11,2,9,0,0,11
5353,96,73,4,1,18,78
5354,221,169,8,0,44,177
5355,54,8,34,0,12,42
5356,32,15,7,0,10,22
5357,8,0,7,1,0,8
5358,28,11,15,0,2,26
5359,66,13,34,5,14,52
5360,38,9,22,4,3,35
5361,81,41,16,7,17,64
5362,50,4,33,1,12,38
5363,46,18,20,0,8,38
5364,77,42,15,4,16,61
5365,56,18,29,1,8,48
5366,79,60,11,7,1,78
5367,28,13,9,0,6,22
5368,79,48,15,0,16,63
5369,141,85,29,0,27,114
5370,31,6,14,4,7,24
5371,89,42,28,0,19,70
5372,124,44,42,9,29,95
5373,104,43,36,5,20,84
5374,288,156,68,0,64,224
5375,236,153,66,1,16,220
5376,32,3,21,2,6,26
5377,45,21,17,0,7,38
5378,46,10,30,0,6,40
5379,34,20,9,2,3,31
5380,27,12,14,0,1,26
5381,23,14,3,0,6,17
5382,88,24,39,8,17,71
5383,86,44,20,3,19,67
5384,77,18,41,2,16,61
5385,72,42,14,2,14,58
5386,75,33,19,14,9,66
5387,66,23,33,1,9,57
5388,50,13,25,3,9,41
5389,43,5,29,0,9,34
5390,44,19,15,0,10,34
5391,58,19,31,0,8,50
5392,129,99,9,2,19,110
5393,82,23,22,19,18,64
5394,42,21,5,7,9,33
5395,202,108,61,0,33,169
5396,19,7,7,0,5,14
5397,67,35,15,4,13,54
5398,80,32,22,12,14,66
5399,2,0,1,0,1,1
5400,59,31,11,0,17,42
5401,132,47,29,25,31,101
5402,42,25,5,6,6,36
5403,61,21,27,1,12,49
5404,82,63,6,1,12,70
5405,312,162,84,15,51,261
5406,40,9,23,0,8,32
5407,29,10,14,1,4,25
5408,424,200,93,42,89,335
5409,33,25,3,5,0,33
5410,55,16,11,18,10,45
5411,30,4,20,1,5,25
5412,153,37,80,1,35,118
5413,113,84,7,16,6,107
5414,32,21,9,0,2,30
5415,383,221,83,0,79,304
5416,103,29,56,0,18,85
5417,33,8,17,0,8,25
5418,202,80,14,68,40,162
5419,57,30,13,3,11,46
5420,32,21,9,0,2,30
5421,16,12,2,0,2,14
5422,198,65,61,26,46,152
5423,79,41,9,8,21,58
5424,45,0,32,0,13,32
5425,75,25,30,4,16,59
5426,40,24,12,0,4,36
5427,21,8,6,0,7,14
5428,8,1,5,0,2,6
5429,453,139,188,26,100,353
5430,33,17,14,0,2,31
5431,118,49,29,18,22,96
5432,7,4,0,2,1,6
5433,242,172,18,4,48,194
5434,55,21,15,9,10,45
5435,181,75,69,15,22,159
5436,671,391,145,17,118,553
5437,159,61,37,22,39,120
5438,52,9,5,29,9,43
5439,211,114,62,0,35,176
5440,149,78,17,24,30,119
5441,9,7,1,0,1,8
5442,85,34,28,4,19,66
5443,12,3,3,5,1,11
5444,24,11,7,0,6,18
5445,52,36,5,0,11,41
5446,31,0,10,16,5,26
5447,242,127,76,0,39,203
5448,217,118,32,23,44,173
5449,49,33,5,1,10,39
5450,53,0,33,3,17,36
5451,661,387,142,17,115,546
5452,49,40,2,0,7,42
5453,58,15,32,1,10,48
5454,32,8,21,0,3,29
5455,50,21,17,1,11,39
5456,1,1,0,0,0,1
5457,44,11,22,0,11,33
5458,4,1,3,0,0,4
5459,428,135,169,30,94,334
5460,253,52,131,4,66,187
5461,111,30,58,0,23,88
5462,66,36,23,2,5,61
5463,52,20,16,3,13,39
5464,18,10,6,0,2,16
5465,43,28,9,1,5,38
5466,94,52,18,10,14,80
5467,5,1,3,0,1,4
5468,305,158,73,17,57,248
5469,379,279,19,0,81,298
5470,260,197,12,0,51,209
5471,246,96,22,82,46,200
5472,11,8,0,0,3,8
5473,62,35,12,4,11,51
5474,76,34,27,0,15,61
5475,173,132,7,0,34,139
5476,29,5,20,2,2,27
5477,27,14,8,0,5,22
5478,43,10,23,0,10,33
5479,65,23,11,19,12,53
5480,57,22,12,8,15,42
5481,100,36,32,12,20,80
5482,26,11,7,2,6,20
5483,26,14,7,0,5,21
5484,21,18,2,0,1,20
5485,6,2,1,0,3,3
5486,105,30,57,0,18,87
5487,245,102,15,82,46,199
5488,58,31,7,9,11,47
5489,163,111,26,0,26,137
5490,206,87,43,27,49,157
5491,40,6,26,1,7,33
5492,80,55,11,5,9,71
5493,43,32,2,3,6,37
5494,207,52,118,2,35,172
5495,27,6,18,0,3,24
5496,66,36,3,12,15,51
5497,83,41,26,4,12,71
5498,461,222,97,44,98,363
5499,33,5,16,1,11,22
5500,292,25,209,2,56,236
5501,121,60,31,6,24,97
5502,33,4,24,1,4,29
5503,136,91,18,1,26,110
5504,46,26,7,2,11,35
5505,55,13,31,0,11,44
5506,14,8,3,0,3,11
5507,23,6,13,0,4,19
5508,39,14,14,4,7,32
5509,20,8,6,0,6,14
5510,42,10,23,4,5,37
5511,27,2,11,7,7,20
5512,342,172,105,3,62,280
5513,138,44,52,10,32,106
5514,35,26,0,2,7,28
5515,431,199,136,11,85,346
5516,45,20,19,1,5,40
5517,2,0,1,0,1,1
5518,32,25,3,4,0,32
5519,36,15,16,1,4,32
5520,52,16,12,17,7,45
5521,50,23,12,3,12,38
5522,83,32,34,3,14,69
5523,8,3,2,1,2,6
5524,178,121,41,2,14,164
5525,60,35,15,5,5,55
5526,164,122,4,1,37,127
5527,228,74,103,2,49,179
5528,21,4,7,4,6,15
5529,20,9,8,0,3,17
5530,17,8,4,0,5,12
5531,126,73,20,3,30,96
5532,38,23,10,0,5,33
5533,41,26,4,2,9,32
5534,66,16,35,1,14,52
5535,95,25,55,1,14,81
5536,343,180,83,20,60,283
5537,194,14,144,0,36,158
5538,35,22,9,0,4,31
5539,12,5,4,3,0,12
5540,114,46,33,10,25,89
5541,38,27,8,3,0,38
5542,153,9,90,24,30,123
5543,411,234,93,0,84,327
5544,25,7,13,0,5,20
5545,148,46,64,3,35,113
5546,76,35,15,7,19,57
5547,72,42,14,2,14,58
5548,45,25,8,4,8,37
5549,13,9,2,0,2,11
5550,68,51,0,0,17,51
5551,38,6,4,19,9,29
5552,113,40,40,6,27,86
5553,104,37,46,0,21,83
5554,36,13,13,0,10,26
5555,91,60,9,5,17,74
5556,27,11,10,0,6,21
5557,422,210,80,44,88,334
5558,118,80,11,3,24,94
5559,109,92,2,0,15,94
5560,75,36,21,3,15,60
5561,46,8,30,0,8,38
5562,69,35,12,7,15,54
5563,46,18,20,0,8,38
5564,156,49,81,4,22,134
5565,87,45,21,9,12,75
5566,144,82,30,0,32,112
5567,97,35,37,10,15,82
5568,2,2,0,0,0,2
5569,67,39,3,12,13,54
5570,85,39,32,1,13,72
5571,30,14,14,0,2,28
5572,46,18,20,0,8,38
5573,77,21,36,7,13,64
5574,72,49,2,2,19,53
5575,53,35,6,5,7,46
5576,150,24,97,1,28,122
5577,209,148,11,7,43,166
5578,256,21,186,2,47,209
5579,39,2,18,13,6,33
5580,1273,511,173,336,253,1020
5581,669,369,165,24,111,558
5582,54,42,2,0,10,44
5583,11,3,7,0,1,10
5584,209,52,107,14,36,173
5585,113,40,49,6,18,95
5586,33,3,6,16,8,25
5587,32,21,9,0,2,30
5588,17,11,3,1,2,15
5589,94,21,40,11,22,72
5590,101,37,37,5,22,79
5591,200,102,49,0,49,151
5592,38,27,0,1,10,28
5593,14,3,8,0,3,11
5594,24,7,13,0,4,20
5595,34,15,13,0,6,28
5596,673,399,136,20,118,555
5597,92,29,47,0,16,76
5598,70,49,7,0,14,56
5599,31,24,3,0,4,27
5600,47,22,14,0,11,36
5601,178,101,32,0,45,133
5602,82,53,9,5,15,67
5603,220,149,30,0,41,179
5604,27,8,11,2,6,21
5605,45,10,22,4,9,36
5606,39,13,19,0,7,32
5607,239,102,91,2,44,195
5608,16,7,4,3,2,14
5609,23,6,12,2,3,20
5610,76,57,0,0,19,57
5611,80,41,17,4,18,62
5612,21,10,4,1,6,15
5613,55,15,22,10,8,47
5614,14,5,4,0,5,9
5615,335,137,123,6,69,266
5616,136,76,23,3,34,102
5617,12,6,3,3,0,12
5618,98,51,13,18,16,82
5619,72,32,25,4,11,61
5620,10,7,1,0,2,8
5621,31,19,3,0,9,22
5622,45,18,10,6,11,34
5623,44,21,17,1,5,39
5624,57,27,13,6,11,46
5625,15,0,11,0,4,11
5626,29,8,15,1,5,24
5627,113,57,25,11,20,93
5628,57,19,26,0,12,45
5629,91,65,6,0,20,71
5630,279,98,125,13,43,236
5631,110,34,39,14,23,87
5632,161,94,37,1,29,132
5633,196,98,36,28,34,162
5634,293,40,200,2,51,242
5635,39,24,7,0,8,31
5636,111,31,49,7,24,87
5637,84,33,10,18,23,61
5638,36,19,9,0,8,28
5639,34,18,11,0,5,29
5640,75,32,25,3,15,60
5641,75,46,18,0,11,64
5642,9,5,2,0,2,7
5643,10,4,4,0,2,8
5644,74,36,22,0,16,58
5645,75,43,19,0,13,62
5646,30,10,15,0,5,25
5647,101,55,19,7,20,81
5648,75,40,19,4,12,63
5649,32,9,20,0,3,29
5650,448,238,116,17,77,371
5651,90,56,15,1,18,72
5652,431,109,182,44,96,335
5653,107,46,20,21,20,87
5654,139,36,71,1,31,108
5655,62,18,33,1,10,52
5656,67,16,34,1,16,51
5657,31,1,22,0,8,23
5658,0,0,0,0,0,0
5659,46,18,20,0,8,38
5660,75,53,2,0,20,55
5661,56,44,2,0,10,46
5662,90,54,26,5,5,85
5663,17,5,3,3,6,11
5664,65,37,16,0,12,53
5665,184,75,38,28,43,141
5666,85,56,8,3,18,67
5667,499,199,140,51,109,390
5668,131,80,20,6,25,106
5669,82,30,29,8,15,67
5670,40,23,10,0,7,33
5671,52,27,8,8,9,43
5672,79,45,10,9,15,64
5673,63,19,15,16,13,50
5674,66,5,42,5,14,52
5675,28,11,7,7,3,25
5676,387,168,135,11,73,314
5677,26,13,7,0,6,20
5678,90,36,25,12,17,73
5679,34,14,11,0,9,25
5680,52,20,23,0,9,43
5681,82,38,5,16,23,59
5682,30,2,23,1,4,26
5683,69,47,8,4,10,59
5684,101,54,20,10,17,84
5685,52,22,18,0,12,40
5686,122,43,47,13,19,103
5687,32,21,9,0,2,30
5688,6,0,4,0,2,4
5689,86,40,22,1,23,63
5690,46,6,28,0,12,34
5691,52,10,30,2,10,42
5692,97,31,40,8,18,79
5693,114,23,56,0,35,79
5694,35,9,14,4,8,27
5695,87,41,22,1,23,64
5696,418,193,140,11,74,344
5697,132,46,29,26,31,101
5698,13,3,6,0,4,9
5699,37,18,14,0,5,32
5700,8,1,5,0,2,6
5701,273,84,128,17,44,229
5702,17,7,6,1,3,14
5703,64,34,17,5,8,56
5704,32,21,9,0,2,30
5705,55,26,16,2,11,44
5706,25,5,0,16,4,21
5707,23,12,5,0,6,17
5708,8,2,4,1,1,7
5709,141,84,30,0,27,114
5710,46,18,20,0,8,38
5711,3,0,3,0,0,3
5712,56,18,16,5,17,39
5713,48,21,15,3,9,39
5714,31,10,15,0,6,25
5715,220,149,30,0,41,179
5716,404,97,168,46,93,311
5717,43,29,1,1,12,31
5718,123,90,6,0,27,96
5719,38,4,29,0,5,33
5720,168,70,48,6,44,124
5721,574,338,97,9,130,444
5722,2,0,1,0,1,1
5723,6,3,0,0,3,3
5724,41,9,21,0,11,30
5725,51,22,6,15,8,43
5726,358,186,107,5,60,298
5727,55,38,6,1,10,45
5728,10,4,5,0,1,9
5729,677,394,143,19,121,556
5730,58,28,11,2,17,41
5731,47,15,10,17,5,42
5732,22,10,6,2,4,18
5733,82,17,36,11,18,64
5734,42,22,13,0,7,35
5735,36,15,8,0,13,23
5736,132,103,8,0,21,111
5737,344,155,115,6,68,276
5738,52,41,1,0,10,42
5739,61,20,17,13,11,50
5740,101,68,11,0,22,79
5741,137,30,44,26,37,100
5742,15,4,6,0,5,10
5743,6,4,1,0,1,5
5744,77,5,55,1,16,61
5745,46,18,20,0,8,38
5746,47,12,24,0,11,36
5747,62,27,22,1,12,50
5748,14,5,6,0,3,11
5749,54,8,34,0,12,42
5750,75,20,18,26,11,64
5751,119,100,2,2,15,104
5752,212,114,34,20,44,168
5753,34,10,15,0,9,25
5754,59,42,6,1,10,49
5755,193,88,47,20,38,155
5756,466,140,196,30,100,366
5757,33,12,9,5,7,26
5758,539,295,115,13,116,423
5759,418,316,20,0,82,336
5760,295,136,93,12,54,241
5761,148,61,56,8,23,125
5762,13,13,0,0,0,13
5763,187,71,47,29,40,147
5764,31,4,21,0,6,25
5765,7,4,0,2,1,6
5766,553,362,76,4,111,442
5767,32,2,0,20,10,22
5768,111,63,25,2,21,90
5769,245,185,15,0,45,200
5770,44,9,27,1,7,37
5771,28,15,8,0,5,23
5772,386,178,133,7,68,318
5773,109,30,58,0,21,88
5774,13,6,4,1,2,11
5775,76,4,53,1,18,58
5776,46,10,5,23,8,38
5777,96,26,37,12,21,75
5778,18,12,3,0,3,15
5779,44,15,19,0,10,34
5780,40,36,0,0,4,36
5781,23,0,16,0,7,16
5782,30,16,7,2,5,25
5783,7,1,4,2,0,7
5784,10,4,5,0,1,9
5785,8,3,2,1,2,6
5786,78,39,22,0,17,61
5787,10,2,6,0,2,8
5788,7,2,2,2,1,6
5789,46,18,20,0,8,38
5790,455,210,148,10,87,368
5791,28,5,20,0,3,25
5792,101,66,11,2,22,79
5793,117,67,28,0,22,95
5794,229,125,35,25,44,185
5795,94,23,43,4,24,70
5796,21,2,16,0,3,18
5797,315,163,84,15,53,262
5798,67,39,13,2,13,54
5799,26,7,6,7,6,20
5800,32,16,8,3,5,27
5801,90,43,26,5,16,74
5802,17,10,4,0,3,14
5803,25,5,14,0,6,19
5804,99,23,40,14,22,77
5805,160,27,102,1,30,130
5806,133,98,8,2,25,108
5807,73,20,24,12,17,56
5808,194,87,61,14,32,162
5809,22,15,2,0,5,17
5810,73,26,34,3,10,63
5811,21,6,10,3,2,19
5812,33,4,26,0,3,30
5813,66,29,15,5,17,49
5814,131,94,18,0,19,112
5815,62,23,20,7,12,50
5816,53,24,3,16,10,43
5817,55,16,19,8,12,43
5818,83,44,10,10,19,64
5819,232,153,61,2,16,216
5820,96,48,23,5,20,76
5821,17,0,13,0,4,13
5822,145,60,48,8,29,116
5823,57,16,19,9,13,44
5824,12,4,5,0,3,9
5825,37,3,25,0,9,28
5826,27,15,8,0,4,23
5827,155,45,56,18,36,119
5828,12,5,4,0,3,9
5829,85,17,42,9,17,68
5830,54,23,19,1,11,43
5831,112,65,18,3,26,86
5832,183,122,18,0,43,140
5833,515,356,48,1,110,405
5834,148,86,36,1,25,123
5835,44,24,10,0,10,34
5836,79,17,44,7,11,68
5837,137,55,55,2,25,112
5838,44,30,1,1,12,32
5839,64,19,33,0,12,52
5840,138,72,17,20,29,109
5841,109,46,22,21,20,89
5842,429,131,192,12,94,335
5843,377,199,103,3,72,305
5844,18,3,14,0,1,17
5845,29,2,19,2,6,23
5846,159,90,21,20,28,131
5847,22,1,12,1,8,14
5848,50,25,11,1,13,37
5849,27,14,2,4,7,20
5850,119,48,36,8,27,92
5851,22,1,12,1,8,14
5852,9,0,8,0,1,8
5853,63,35,7,8,13,50
5854,14,6,2,1,5,9
5855,59,22,12,16,9,50
5856,33,18,8,0,7,26
5857,3,0,3,0,0,3
5858,37,19,8,1,9,28
5859,69,32,24,2,11,58
5860,204,87,44,24,49,155
5861,32,21,9,0,2,30
5862,84,38,29,4,13,71
5863,8,5,3,0,0,8
5864,75,33,26,2,14,61
5865,19,5,12,1,1,18
5866,21,8,7,2,4,17
5867,101,43,41,4,13,88
5868,43,8,20,0,15,28
5869,35,1,6,21,7,28
5870,28,16,7,0,5,23
5871,76,52,8,0,16,60
5872,121,58,23,17,23,98
5873,65,24,25,0,16,49
5874,86,28,23,14,21,65
5875,32,21,9,0,2,30
5876,52,37,7,1,7,45
5877,382,220,83,0,79,303
5878,39,15,13,0,11,28
5879,62,44,8,3,7,55
5880,73,45,8,1,19,54
5881,53,39,8,6,0,53
5882,10,5,5,0,0,10
5883,47,26,12,0,9,38
5884,170,125,19,0,26,144
5885,139,52,38,20,29,110
5886,350,191,99,0,60,290
5887,18,9,8,0,1,17
5888,84,28,24,9,23,61
5889,482,268,75,41,98,384
5890,72,33,23,0,16,56
5891,218,124,43,12,39,179
5892,652,383,139,17,113,539
5893,303,67,154,4,78,225
5894,79,37,29,0,13,66
5895,205,106,33,32,34,171
5896,50,29,13,0,8,42
5897,37,18,15,1,3,34
5898,61,36,9,3,13,48
5899,94,30,24,21,19,75
5900,505,265,93,46,101,404
5901,54,37,4,1,12,42
5902,55,39,2,1,13,42
5903,10,3,4,0,3,7
5904,24,9,7,3,5,19
5905,20,10,4,1,5,15
5906,67,33,20,0,14,53
5907,121,74,24,0,23,98
5908,17,7,4,1,5,12
5909,53,18,12,16,7,46
5910,21,9,7,0,5,16
5911,259,171,31,4,53,206
5912,48,21,12,0,15,33
5913,38,10,18,2,8,30
5914,40,20,11,1,8,32
5915,40,18,6,7,9,31
5916,49,27,12,1,9,40
5917,7,3,3,0,1,6
5918,166,83,33,20,30,136
5919,193,88,47,20,38,155
5920,56,27,21,0,8,48
5921,30,8,11,2,9,21
5922,7,5,0,0,2,5
5923,121,56,32,9,24,97
5924,19,15,0,0,4,15
5925,78,49,17,1,11,67
5926,137,73,34,0,30,107
5927,33,11,8,6,8,25
5928,84,23,42,1,18,66
5929,8,6,2,0,0,8
5930,46,13,20,0,13,33
5931,16,4,9,2,1,15
5932,23,17,2,0,4,19
5933,40,27,1,1,11,29
5934,29,13,13,0,3,26
5935,57,22,17,11,7,50
5936,35,15,15,0,5,30
5937,530,368,49,1,112,418
5938,112,47,25,15,25,87
5939,26,11,11,0,4,22
5940,24,15,4,1,4,20
5941,88,42,27,7,12,76
5942,51,22,22,1,6,45
5943,20,11,4,1,4,16
5944,32,8,11,5,8,24
5945,429,317,20,0,92,337
5946,27,12,5,6,4,23
5947,35,7,19,4,5,30
5948,69,40,16,0,13,56
5949,36,19,8,3,6,30
5950,674,392,153,17,112,562
5951,23,14,2,0,7,16
5952,48,26,12,1,9,39
5953,59,38,7,0,14,45
5954,29,14,10,1,4,25
5955,131,49,39,15,28,103
5956,72,38,3,16,15,57
5957,79,61,1,0,17,62
5958,90,29,46,1,14,76
5959,19,2,10,0,7,12
5960,73,32,24,2,15,58
5961,139,54,30,25,30,109
5962,37,0,30,0,7,30
5963,46,18,20,0,8,38
5964,14,8,4,0,2,12
5965,38,19,11,2,6,32
5966,57,21,24,0,12,45
5967,212,75,78,10,49,163
5968,7,1,4,1,1,6
5969,252,193,13,0,46,206
5970,220,99,87,4,30,190
5971,208,121,45,6,36,172
5972,47,12,16,5,14,33
5973,141,79,40,13,9,132
5974,619,365,134,15,105,514
5975,16,4,6,1,5,11
5976,32,21,9,0,2,30
5977,133,46,51,8,28,105
5978,135,77,21,3,34,101
5979,124,46,31,19,28,96
5980,62,19,32,1,10,52
5981,79,37,28,4,10,69
5982,65,33,16,3,13,52
5983,116,92,7,2,15,101
5984,38,14,14,1,9,29
5985,72,19,42,1,10,62
5986,26,2,18,0,6,20
5987,94,42,27,4,21,73
5988,101,39,30,9,23,78
5989,56,33,15,2,6,50
5990,43,7,27,5,4,39
5991,73,42,13,2,16,57
5992,15,10,3,0,2,13
5993,665,386,142,21,116,549
5994,68,47,9,1,11,57
5995,63,34,19,1,9,54
5996,20,9,9,0,2,18
5997,1,0,1,0,0,1
5998,70,20,24,9,17,53
5999,102,31,50,3,18,84
6000,26,8,13,1,4,22
6001,81,47,18,1,15,66
6002,32,6,21,0,5,27
6003,19,0,14,0,5,14
6004,103,67,1,13,22,81
6005,48,21,22,1,4,44
6006,112,83,8,14,7,105
6007,7,0,6,0,1,6
6008,75,36,25,1,13,62
6009,550,330,97,9,114,436
6010,44,15,16,2,11,33
6011,103,53,24,4,22,81
6012,46,18,20,0,8,38
6013,41,1,34,0,6,35
6014,38,9,22,1,6,32
6015,37,8,22,1,6,31
6016,48,25,11,0,12,36
6017,4,2,0,1,1,3
6018,420,128,188,10,94,326
6019,56,37,11,4,4,52
6020,296,224,18,0,54,242
6021,61,48,0,0,13,48
6022,123,63,40,9,11,112
6023,11,8,1,1,1,10
6024,37,19,11,0,7,30
6025,46,27,9,4,6,40
6026,35,18,12,0,5,30
6027,31,10,7,9,5,26
6028,6,3,0,2,1,5
6029,55,19,21,6,9,46
6030,121,58,32,0,31,90
6031,6,4,1,0,1,5
6032,86,45,27,3,11,75
6033,232,153,65,1,13,219
6034,12,10,1,0,1,11
6035,531,250,120,49,112,419
6036,114,50,37,4,23,91
6037,209,86,63,20,40,169
6038,43,5,29,0,9,34
6039,183,104,21,23,35,148
6040,28,11,8,0,9,19
6041,206,92,57,13,44,162
6042,248,77,120,12,39,209
6043,477,221,154,11,91,386
6044,59,33,3,10,13,46
6045,232,92,14,82,44,188
6046,87,10,48,10,19,68
6047,45,26,8,0,11,34
6048,7,4,1,0,2,5
6049,146,88,20,2,36,110
6050,53,21,17,5,10,43
6051,56,35,8,3,10,46
6052,82,52,10,2,18,64
6053,39,9,16,5,9,30
6054,149,98,30,0,21,128
6055,14,1,9,0,4,10
6056,26,15,5,1,5,21
6057,51,17,22,2,10,41
6058,34,13,12,0,9,25
6059,100,25,51,3,21,79
6060,58,23,20,3,12,46
6061,120,50,15,19,36,84
6062,53,17,25,4,7,46
6063,55,30,9,4,12,43
6064,41,7,22,5,7,34
6065,54,19,17,7,11,43
6066,34,14,11,0,9,25
6067,56,13,32,0,11,45
6068,335,171,91,5,68,267
6069,37,7,20,1,9,28
6070,113,54,24,14,21,92
6071,34,13,15,0,6,28
6072,109,54,29,6,20,89
6073,65,36,18,2,9,56
6074,55,5,35,1,14,41
6075,29,10,10,0,9,20
6076,14,9,0,1,4,10
6077,30,6,13,1,10,20
6078,155,54,49,26,26,129
6079,32,21,9,0,2,30
6080,77,16,46,1,14,63
6081,18,2,12,0,4,14
6082,427,114,170,47,96,331
6083,32,21,9,0,2,30
6084,98,65,17,0,16,82
6085,95,31,5,45,14,81
6086,126,36,64,0,26,100
6087,495,342,52,2,99,396
6088,159,117,9,5,28,131
6089,19,5,9,3,2,17
6090,74,26,20,11,17,57
6091,50,31,10,2,7,43
6092,36,7,17,3,9,27
6093,55,37,11,0,7,48
6094,4,0,2,1,1,3
6095,47,20,13,4,10,37
6096,29,8,13,0,8,21
6097,239,103,76,17,43,196
6098,42,21,5,7,9,33
6099,29,20,2,0,7,22
6100,385,220,86,0,79,306
6101,91,62,7,4,18,73
6102,32,21,9,0,2,30
6103,72,56,1,0,15,57
6104,39,14,13,3,9,30
6105,152,48,72,0,32,120
6106,25,21,2,0,2,23
6107,40,5,28,1,6,34
6108,54,43,1,0,10,44
6109,247,56,25,124,42,205
6110,74,32,26,2,14,60
6111,22,13,4,1,4,18
6112,49,30,11,0,8,41
6113,45,16,20,1,8,37
6114,25,9,10,1,5,20
6115,139,50,35,19,35,104
6116,38,6,22,0,10,28
6117,13,2,9,0,2,11
6118,223,90,40,38,55,168
6119,69,30,11,15,13,56
6120,21,18,2,0,1,20
6121,46,18,20,0,8,38
6122,135,63,39,0,33,102
6123,295,79,33,136,47,248
6124,344,143,127,6,68,276
6125,28,6,17,0,5,23
6126,50,29,5,6,10,40
6127,16,3,10,0,3,13
6128,360,197,90,15,58,302
6129,201,50,28,87,36,165
6130,69,30,25,0,14,55
6131,61,18,34,0,9,52
6132,35,27,5,0,3,32
6133,332,159,112,2,59,273
6134,4,0,4,0,0,4
6135,99,22,55,2,20,79
6136,8,2,5,0,1,7
6137,95,44,20,7,24,71
6138,61,26,15,5,15,46
6139,72,18,36,0,18,54
6140,105,56,28,0,21,84
6141,15,0,11,0,4,11
6142,116,47,26,24,19,97
6143,462,238,111,12,101,361
6144,89,28,45,2,14,75
6145,220,150,29,0,41,179
6146,142,85,28,0,29,113
6147,70,32,25,4,9,61
6148,30,14,7,3,6,24
6149,37,4,24,0,9,28
6150,32,21,9,0,2,30
6151,12,5,7,0,0,12
6152,100,35,39,11,15,85
6153,153,52,37,31,33,120
6154,89,52,16,6,15,74
6155,37,9,24,1,3,34
6156,68,43,12,0,13,55
6157,50,30,5,5,10,40
6158,169,72,54,3,40,129
6159,109,21,64,1,23,86
6160,159,101,3,17,38,121
6161,86,44,18,9,15,71
6162,62,34,8,5,15,47
6163,32,21,9,0,2,30
6164,21,13,4,1,3,18
6165,120,81,12,3,24,96
6166,35,24,5,2,4,31
6167,75,16,15,32,12,63
6168,61,33,8,0,20,41
6169,76,10,42,5,19,57
6170,92,57,20,0,15,77
6171,38,17,12,0,9,29
6172,129,29,59,18,23,106
6173,59,27,20,1,11,48
6174,25,20,2,2,1,24
6175,54,32,14,0,8,46
6176,154,92,31,8,23,131
6177,85,30,35,7,13,72
6178,69,48,12,0,9,60
6179,280,185,68,4,23,257
6180,21,4,12,0,5,16
6181,63,35,14,0,14,49
6182,37,19,12,0,6,31
6183,52,35,5,3,9,43
6184,441,252,84,12,93,348
6185,119,26,45,21,27,92
6186,41,10,23,1,7,34
6187,51,25,10,7,9,42
6188,36,27,0,0,9,27
6189,342,145,120,6,71,271
6190,50,35,2,0,13,37
6191,40,7,18,0,15,25
6192,22,12,8,0,2,20
6193,377,193,100,19,65,312
6194,38,7,10,16,5,33
6195,61,31,17,0,13,48
6196,6,3,0,3,0,6
6197,20,8,5,0,7,13
6198,53,38,4,3,8,45
6199,97,29,49,0,19,78
6200,43,24,12,0,7,36
6201,16,5,11,0,0,16
6202,297,219,12,2,64,233
6203,434,127,167,47,93,341
6204,546,310,108,10,118,428
6205,58,44,6,0,8,50
6206,19,4,7,0,8,11
6207,59,22,15,7,15,44
6208,10,6,1,0,3,7
6209,38,12,17,0,9,29
6210,18,10,7,0,1,17
6211,52,26,13,3,10,42
6212,395,226,88,0,81,314
6213,12,7,2,0,3,9
6214,10,1,7,0,2,8
6215,174,52,88,0,34,140
6216,43,22,11,4,6,37
6217,221,53,24,108,36,185
6218,46,18,20,0,8,38
6219,96,39,18,13,26,70
6220,25,16,3,1,5,20
6221,95,27,53,2,13,82
6222,58,20,18,9,11,47
6223,26,15,4,0,7,19
6224,38,6,4,19,9,29
6225,73,40,6,10,17,56
6226,83,13,49,6,15,68
6227,103,67,1,13,22,81
6228,124,75,26,0,23,101
6229,173,75,53,6,39,134
6230,93,29,24,21,19,74
6231,85,38,28,1,18,67
6232,194,77,34,33,50,144
6233,139,80,21,3,35,104
6234,11,2,6,0,3,8
6235,105,42,44,3,16,89
6236,84,42,21,1,20,64
6237,78,35,5,16,22,56
6238,8,3,2,0,3,5
6239,20,17,1,0,2,18
6240,31,8,15,2,6,25
6241,78,34,16,9,19,59
6242,28,10,10,0,8,20
6243,520,233,124,45,118,402
6244,100,41,35,4,20,80
6245,17,6,7,0,4,13
6246,209,140,52,1,16,193
6247,286,68,45,124,49,237
6248,20,10,4,1,5,15
6249,30,8,16,1,5,25
6250,34,16,9,1,8,26
6251,63,43,3,6,11,52
6252,166,98,38,1,29,137
6253,37,9,20,0,8,29
6254,25,5,16,0,4,21
6255,14,6,4,0,4,10
6256,171,113,27,1,30,141
6257,99,61,18,0,20,79
6258,16,7,6,0,3,13
6259,45,24,9,3,9,36
6260,113,43,26,24,20,93
6261,43,2,8,26,7,36
6262,26,12,8,0,6,20
6263,36,16,8,5,7,29
6264,47,17,11,6,13,34
6265,24,6,11,0,7,17
6266,26,5,13,1,7,19
6267,61,15,29,2,15,46
6268,60,18,29,3,10,50
6269,156,63,32,29,32,124
6270,160,29,64,24,43,117
6271,169,82,24,22,41,128
6272,19,14,0,0,5,14
6273,95,20,47,11,17,78
6274,11,8,1,0,2,9
6275,63,51,1,0,11,52
6276,53,19,24,1,9,44
6277,30,10,15,0,5,25
6278,32,21,9,0,2,30
6279,131,42,51,13,25,106
6280,77,41,16,0,20,57
6281,17,5,7,0,5,12
6282,105,76,11,9,9,96
6283,631,417,72,5,137,494
6284,247,184,12,1,50,197
6285,17,11,1,4,1,16
6286,55,32,15,2,6,49
6287,239,180,13,0,46,193
6288,23,7,14,0,2,21
6289,115,25,43,22,25,90
6290,28,12,8,3,5,23
6291,514,244,125,34,111,403
6292,216,103,61,12,40,176
6293,26,11,12,1,2,24
6294,46,18,23,0,5,41
6295,78,39,25,1,13,65
6296,64,41,5,0,18,46
6297,48,21,9,6,12,36
6298,444,252,84,15,93,351
6299,220,149,30,0,41,179
6300,279,150,80,0,49,230
6301,57,13,31,4,9,48
6302,19,11,4,1,3,16
6303,93,23,52,0,18,75
6304,84,37,18,13,16,68
6305,59,12,21,14,12,47
6306,21,10,6,1,4,17
6307,46,18,20,0,8,38
6308,76,47,15,0,14,62
6309,396,270,40,1,85,311
6310,77,42,15,4,16,61
6311,486,209,123,46,108,378
6312,151,79,33,7,32,119
6313,48,9,30,0,9,39
6314,34,6,23,0,5,29
6315,437,309,37,1,90,347
6316,360,156,125,11,68,292
6317,14,2,10,0,2,12
6318,9,0,8,0,1,8
6319,59,43,5,4,7,52
6320,22,14,2,0,6,16
6321,71,16,39,1,15,56
6322,60,31,17,0,12,48
6323,196,135,44,2,15,181
6324,251,189,11,0,51,200
6325,84,26,22,17,19,65
6326,31,9,19,0,3,28
6327,55,12,25,1,17,38
6328,75,37,8,16,14,61
6329,360,164,122,6,68,292
6330,32,21,9,0,2,30
6331,14,1,9,0,4,10
6332,43,14,18,4,7,36
6333,15,5,5,0,5,10
6334,16,3,9,0,4,12
6335,7,1,3,0,3,4
6336,15,6,2,3,4,11
6337,73,4,51,0,18,55
6338,129,67,12,22,28,101
6339,147,85,35,0,27,120
6340,14,7,1,4,2,12
6341,18,9,8,0,1,17
6342,68,33,19,0,16,52
6343,157,41,81,0,35,122
6344,80,46,18,2,14,66
6345,484,263,80,42,99,385
6346,19,8,7,0,4,15
6347,79,47,20,0,12,67
6348,36,13,16,2,5,31
6349,33,14,10,0,9,24
6350,15,3,4,4,4,11
6351,615,341,155,22,97,518
6352,103,39,37,5,22,81
6353,32,21,9,0,2,30
6354,17,1,13,0,3,14
6355,39,7,25,1,6,33
6356,64,41,5,0,18,46
6357,127,88,21,0,18,109
6358,540,297,116,13,114,426
6359,78,13,41,7,17,61
6360,121,60,21,17,23,98
6361,182,110,6,22,44,138
6362,40,30,1,2,7,33
6363,310,191,49,10,60,250
6364,83,67,2,0,14,69
6365,18,8,3,0,7,11
6366,282,176,43,0,63,219
6367,56,40,2,1,13,43
6368,68,34,24,2,8,60
6369,144,47,45,17,35,109
6370,21,14,0,3,4,17
6371,15,4,9,0,2,13
6372,154,110,17,0,27,127
6373,45,12,18,0,15,30
6374,46,18,20,0,8,38
6375,101,31,41,10,19,82
6376,435,201,144,9,81,354
6377,65,33,16,3,13,52
6378,49,15,26,0,8,41
6379,15,2,1,10,2,13
6380,454,210,141,13,90,364
6381,119,10,57,25,27,92
6382,62,43,8,4,7,55
6383,35,14,17,0,4,31
6384,21,11,8,1,1,20
6385,204,52,103,14,35,169
6386,69,49,10,0,10,59
6387,28,9,16,0,3,25
6388,354,156,123,11,64,290
6389,36,16,11,0,9,27
6390,86,27,36,10,13,73
6391,62,57,0,5,0,62
6392,26,11,7,4,4,22
6393,37,13,6,4,14,23
6394,13,8,3,1,1,12
6395,50,10,29,1,10,40
6396,41,9,22,0,10,31
6397,66,36,23,2,5,61
6398,1062,393,427,46,196,866
6399,41,21,5,6,9,32
6400,28,11,9,2,6,22
6401,12,2,9,0,1,11
6402,72,35,12,7,18,54
6403,3,1,0,1,1,2
6404,25,11,7,0,7,18
6405,63,25,15,9,14,49
6406,154,65,62,4,23,131
6407,63,43,5,1,14,49
6408,266,52,160,2,52,214
6409,77,23,36,4,14,63
6410,452,229,117,12,94,358
6411,61,32,14,3,12,49
6412,27,12,12,1,2,25
6413,39,13,21,1,4,35
6414,191,78,40,29,44,147
6415,36,2,30,0,4,32
6416,105,50,31,4,20,85
6417,40,28,5,2,5,35
6418,47,26,10,0,11,36
6419,62,25,28,1,8,54
6420,249,19,184,1,45,204
6421,33,20,4,4,5,28
6422,93,21,49,3,20,73
6423,24,11,9,1,3,21
6424,72,56,5,1,10,62
6425,59,18,15,14,12,47
6426,8,3,2,1,2,6
6427,163,110,27,0,26,137
6428,75,40,5,10,20,55
6429,46,18,20,0,8,38
6430,346,187,88,15,56,290
6431,168,116,14,0,38,130
6432,46,18,20,0,8,38
6433,19,4,5,7,3,16
6434,46,18,20,0,8,38
6435,41,3,29,2,7,34
6436,94,39,38,2,15,79
6437,65,40,7,2,16,49
6438,46,22,15,0,9,37
6439,65,44,12,0,9,56
6440,30,4,17,3,6,24
6441,54,8,34,0,12,42
6442,165,127,13,1,24,141
6443,235,102,94,6,33,202
6444,72,38,4,14,16,56
6445,138,50,6,60,22,116
6446,55,11,38,0,6,49
6447,118,63,21,11,23,95
6448,112,31,51,4,26,86
6449,455,250,96,11,98,357
6450,12,2,9,0,1,11
6451,86,53,17,4,12,74
6452,378,168,115,11,84,294
6453,36,6,21,0,9,27
6454,30,12,14,0,4,26
6455,16,11,3,0,2,14
6456,36,16,7,0,13,23
6457,27,13,7,0,7,20
6458,117,91,6,0,20,97
6459,500,264,86,46,104,396
6460,142,53,40,22,27,115
6461,45,6,28,3,8,37
6462,67,40,12,0,15,52
6463,59,36,14,0,9,50
6464,32,21,9,0,2,30
6465,16,12,0,0,4,12
6466,27,7,11,5,4,23
6467,150,76,38,6,30,120
6468,215,88,43,28,56,159
6469,43,5,29,0,9,34
6470,74,28,22,1,23,51
6471,191,108,25,23,35,156
6472,195,93,62,0,40,155
6473,36,16,13,0,7,29
6474,12,6,5,0,1,11
6475,16,2,13,0,1,15
6476,26,15,4,0,7,19
6477,24,5,11,1,7,17
6478,32,7,18,1,6,26
6479,39,9,26,0,4,35
6480,240,156,67,1,16,224
6481,42,19,12,3,8,34
6482,14,10,4,0,0,14
6483,80,38,28,4,10,70
6484,186,93,54,0,39,147
6485,79,41,16,6,16,63
6486,157,62,38,22,35,122
6487,60,25,17,6,12,48
6488,23,10,8,0,5,18
6489,105,51,43,1,10,95
6490,133,98,5,2,28,105
6491,60,14,35,1,10,50
6492,64,26,23,3,12,52
6493,263,138,75,0,50,213
6494,70,47,14,0,9,61
6495,90,37,35,0,18,72
6496,87,53,12,2,20,67
6497,52,29,13,0,10,42
6498,46,18,20,0,8,38
6499,49,25,14,0,10,39
6500,67,22,6,22,17,50
6501,101,48,33,0,20,81
6502,151,83,49,1,18,133
6503,49,33,5,2,9,40
6504,82,26,41,2,13,69
6505,39,17,15,0,7,32
6506,108,46,30,12,20,88
6507,539,388,35,1,115,424
6508,31,17,10,2,2,29
6509,99,58,21,0,20,79
6510,91,36,20,10,25,66
6511,52,6,38,1,7,45
6512,95,69,6,0,20,75
6513,33,3,22,0,8,25
6514,63,36,12,2,13,50
6515,49,28,12,3,6,43
6516,88,25,36,9,18,70
6517,147,58,48,16,25,122
6518,49,27,10,3,9,40
6519,125,95,3,0,27,98
6520,263,191,14,1,57,206
6521,122,56,32,10,24,98
6522,28,11,12,0,5,23
6523,48,32,5,2,9,39
6524,53,24,22,0,7,46
6525,141,66,44,11,20,121
6526,129,43,46,8,32,97
6527,421,217,101,13,90,331
6528,32,21,9,0,2,30
6529,23,0,20,0,3,20
6530,502,281,78,41,102,400
6531,52,21,13,9,9,43
6532,161,29,102,1,29,132
6533,40,19,6,2,13,27
6534,57,8,37,0,12,45
6535,46,18,20,0,8,38
6536,28,14,8,2,4,24
6537,98,66,8,6,18,80
6538,197,65,61,26,45,152
6539,99,58,19,6,16,83
6540,218,147,30,0,41,177
6541,61,22,31,0,8,53
6542,4,1,2,0,1,3
6543,50,29,13,0,8,42
6544,59,13,35,1,10,49
6545,67,27,26,1,13,54
6546,28,8,7,4,9,19
6547,451,210,142,10,89,362
6548,246,188,13,0,45,201
6549,227,171,13,2,41,186
6550,54,43,1,0,10,44
6551,97,19,48,12,18,79
6552,39,18,10,0,11,28
6553,5,2,0,0,3,2
6554,71,59,1,0,11,60
6555,55,38,6,1,10,45
6556,55,32,15,2,6,49
6557,72,29,29,5,9,63
6558,35,26,4,0,5,30
6559,87,71,2,0,14,73
6560,47,28,11,0,8,39
6561,173,97,23,21,32,141
6562,157,75,48,1,33,124
6563,50,31,1,5,13,37
6564,42,22,10,0,10,32
6565,46,24,13,2,7,39
6566,66,24,31,0,11,55
6567,14,2,6,2,4,10
6568,89,39,33,1,16,73
6569,68,51,6,0,11,57
6570,113,62,31,1,19,94
6571,24,4,17,0,3,21
6572,15,5,8,1,1,14
6573,42,28,1,2,11,31
6574,14,3,5,0,6,8
6575,20,7,10,0,3,17
6576,167,111,25,1,30,137
6577,74,35,19,3,17,57
6578,30,13,8,0,9,21
6579,50,30,10,0,10,40
6580,20,4,14,0,2,18
6581,231,126,65,0,40,191
6582,29,12,8,0,9,20
6583,0,0,0,0,0,0
6584,7,1,4,0,2,5
6585,21,1,15,2,3,18
6586,35,10,16,1,8,27
6587,126,43,44,7,32,94
6588,32,21,9,0,2,30
6589,41,11,26,0,4,37
6590,57,9,33,5,10,47
6591,58,29,6,3,20,38
6592,64,36,18,0,10,54
6593,24,15,3,0,6,18
6594,46,28,9,1,8,38
6595,65,26,24,4,11,54
6596,49,0,36,0,13,36
6597,145,36,77,1,31,114
6598,170,115,11,10,34,136
6599,76,51,8,3,14,62
6600,26,17,5,1,3,23
6601,92,18,44,11,19,73
6602,49,17,17,4,11,38
6603,35,8,15,1,11,24
6604,65,14,35,7,9,56
6605,36,17,11,0,8,28
6606,318,165,85,15,53,265
6607,15,6,2,1,6,9
6608,209,89,61,20,39,170
6609,46,14,14,9,9,37
6610,497,360,32,0,105,392
6611,46,18,20,0,8,38
6612,670,401,130,20,119,551
6613,64,19,24,11,10,54
6614,25,5,13,2,5,20
6615,19,2,14,0,3,16
6616,61,35,14,0,12,49
6617,90,53,19,4,14,76
6618,4,4,0,0,0,4
6619,157,102,25,6,24,133
6620,66,44,12,0,10,56
6621,259,178,59,3,19,240
6622,18,9,8,0,1,17
6623,15,4,9,0,2,13
6624,98,57,20,0,21,77
6625,93,28,26,20,19,74
6626,73,34,28,0,11,62
6627,44,11,23,0,10,34
6628,43,8,14,7,14,29
6629,62,31,9,9,13,49
6630,73,14,39,0,20,53
6631,5,2,2,0,1,4
6632,59,44,12,0,3,56
6633,31,4,21,0,6,25
6634,85,55,15,0,15,70
6635,3,0,1,1,1,2
6636,41,15,13,5,8,33
6637,17,5,7,0,5,12
6638,76,4,54,0,18,58
6639,19,8,6,1,4,15
6640,510,233,115,56,106,404
6641,159,71,52,5,31,128
6642,60,25,24,1,10,50
6643,47,23,13,3,8,39
6644,53,26,16,0,11,42
6645,270,184,64,2,20,250
6646,55,15,18,6,16,39
6647,411,129,183,11,88,323
6648,233,181,11,0,41,192
6649,691,407,141,20,123,568
6650,42,12,19,0,11,31
6651,7,5,1,0,1,6
6652,32,21,9,0,2,30
6653,37,11,9,12,5,32
6654,22,10,6,4,2,20
6655,26,12,12,1,1,25
6656,163,63,47,24,29,134
6657,28,24,0,0,4,24
6658,89,64,6,0,19,70
6659,5,0,5,0,0,5
6660,77,58,6,0,13,64
6661,33,16,10,1,6,27
6662,514,266,95,49,104,410
6663,198,96,58,1,43,155
6664,40,23,5,6,6,34
6665,42,18,17,0,7,35
6666,638,357,155,23,103,535
6667,17,9,4,1,3,14
6668,53,16,24,0,13,40
6669,445,231,73,43,98,347
6670,214,85,88,4,37,177
6671,59,8,37,0,14,45
6672,32,21,9,0,2,30
6673,232,92,14,82,44,188
6674,176,67,45,25,39,137
6675,40,7,23,2,8,32
6676,498,342,47,1,108,390
6677,18,11,2,1,4,14
6678,17,15,0,0,2,15
6679,47,34,0,0,13,34
6680,305,172,79,0,54,251
6681,137,58,50,3,26,111
6682,31,15,3,4,9,22
6683,85,57,8,0,20,65
6684,52,17,16,7,12,40
6685,91,48,6,15,22,69
6686,27,13,7,2,5,22
6687,5,3,1,0,1,4
6688,359,158,125,6,70,289
6689,36,19,7,4,6,30
6690,514,266,94,47,107,407
6691,187,76,39,28,44,143
6692,92,20,56,0,16,76
6693,53,23,18,1,11,42
6694,10,5,3,1,1,9
6695,46,27,13,5,1,45
6696,228,54,24,112,38,190
6697,37,10,19,0,8,29
6698,104,42,14,25,23,81
6699,63,41,7,1,14,49
6700,139,64,46,5,24,115
6701,186,128,23,0,35,151
6702,21,3,15,0,3,18
6703,156,54,49,23,30,126
6704,277,19,202,2,54,223
6705,26,3,16,0,7,19
6706,7,6,1,0,0,7
6707,47,18,22,0,7,40
6708,421,222,106,21,72,349
6709,32,22,4,0,6,26
6710,41,12,19,2,8,33
6711,22,9,9,0,4,18
6712,239,99,14,82,44,195
6713,46,20,14,2,10,36
6714,137,62,50,4,21,116
6715,179,142,11,1,25,154
6716,147,63,54,1,29,118
6717,146,65,27,21,33,113
6718,39,17,6,7,9,30
6719,31,0,10,16,5,26
6720,15,3,8,0,4,11
6721,72,59,2,2,9,63
6722,40,3,31,3,3,37
6723,46,23,2,9,12,34
6724,16,13,0,0,3,13
6725,92,52,24,3,13,79
6726,150,45,64,3,38,112
6727,46,19,10,8,9,37
6728,12,4,5,1,2,10
6729,57,19,15,5,18,39
6730,56,15,29,0,12,44
6731,19,16,1,0,2,17
6732,365,162,127,6,70,295
6733,102,21,64,0,17,85
6734,65,34,5,9,17,48
6735,72,43,14,3,12,60
6736,44,19,14,2,9,35
6737,19,9,5,0,5,14
6738,65,37,15,0,13,52
6739,33,3,6,16,8,25
6740,124,41,45,7,31,93
6741,32,21,9,0,2,30
6742,30,7,16,0,7,23
6743,26,0,21,0,5,21
6744,24,9,9,1,5,19
6745,28,4,19,2,3,25
6746,35,1,26,1,7,28
6747,192,37,71,39,45,147
6748,13,5,7,0,1,12
6749,169,49,56,26,38,131
6750,255,68,133,7,47,208
6751,339,140,122,6,71,268
6752,40,14,18,3,5,35
6753,47,20,13,3,11,36
6754,28,15,8,1,4,24
6755,34,16,12,0,6,28
6756,444,254,84,12,94,350
6757,20,11,5,2,2,18
6758,161,76,31,26,28,133
6759,198,130,49,3,16,182
6760,116,46,39,9,22,94
6761,14,4,5,1,4,10
6762,103,73,8,1,21,82
6763,15,5,8,0,2,13
6764,144,61,31,18,34,110
6765,35,15,13,0,7,28
6766,267,120,101,5,41,226
6767,356,191,92,15,58,298
6768,47,25,10,3,9,38
6769,63,33,15,0,15,48
6770,15,5,7,0,3,12
6771,87,19,43,14,11,76
6772,32,2,24,0,6,26
6773,122,52,25,20,25,97
6774,69,44,7,3,15,54
6775,77,21,37,5,14,63
6776,46,18,20,0,8,38
6777,33,8,17,4,4,29
6778,133,103,11,0,19,114
6779,25,11,7,0,7,18
6780,98,8,66,5,19,79
6781,27,6,10,4,7,20
6782,2,0,0,0,2,0
6783,32,11,11,2,8,24
6784,87,44,24,2,17,70
6785,21,8,8,0,5,16
6786,106,43,32,11,20,86
6787,21,10,7,0,4,17
6788,213,63,20,97,33,180
6789,82,24,44,1,13,69
6790,51,25,3,13,10,41
6791,58,43,2,0,13,45
6792,54,25,18,0,11,43
6793,151,37,78,1,35,116
6794,28,11,9,2,6,22
6795,340,172,106,2,60,280
6796,39,2,19,12,6,33
6797,4,1,2,0,1,3
6798,79,39,21,3,16,63
6799,122,58,29,14,21,101
6800,71,46,4,10,11,60
6801,38,7,16,8,7,31
6802,67,24,32,1,10,57
6803,191,126,25,5,35,156
6804,83,32,38,0,13,70
6805,27,7,10,2,8,19
6806,181,47,90,4,40,141
6807,90,33,35,8,14,76
6808,47,20,15,0,12,35
6809,67,44,14,5,4,63
6810,103,81,2,0,20,83
6811,53,31,6,3,13,40
6812,164,10,90,30,34,130
6813,46,18,20,0,8,38
6814,141,84,30,0,27,114
6815,19,10,3,1,5,14
6816,55,12,28,10,5,50
6817,7,5,2,0,0,7
6818,153,104,22,0,27,126
6819,206,31,93,34,48,158
6820,111,50,37,4,20,91
6821,43,29,1,2,11,32
6822,53,30,8,3,12,41
6823,67,10,49,0,8,59
6824,106,34,43,10,19,87
6825,51,8,31,1,11,40
6826,6,0,5,0,1,5
6827,165,124,2,1,38,127
6828,117,66,31,11,9,108
6829,2,1,0,0,1,1
6830,220,149,30,0,41,179
6831,14,2,6,0,6,8
6832,114,49,35,8,22,92
6833,107,62,19,7,19,88
6834,23,6,11,0,6,17
6835,12,4,3,1,4,8
6836,17,1,14,0,2,15
6837,57,15,23,1,18,39
6838,51,30,11,0,10,41
6839,28,7,15,0,6,22
6840,55,39,6,1,9,46
6841,46,18,20,0,8,38
6842,49,0,43,0,6,43
6843,51,30,13,0,8,43
6844,20,8,9,0,3,17
6845,126,46,27,21,32,94
6846,21,14,3,0,4,17
6847,450,255,89,12,94,356
6848,12,5,5,2,0,12
6849,183,123,14,9,37,146
6850,11,6,2,0,3,8
6851,396,225,89,0,82,314
6852,262,20,192,2,48,214
6853,32,11,13,0,8,24
6854,99,35,27,17,20,79
6855,49,18,25,0,6,43
6856,54,43,1,0,10,44
6857,27,3,15,4,5,22
6858,35,11,15,0,9,26
6859,67,25,28,1,13,54
6860,17,1,15,0,1,16
6861,32,21,9,0,2,30
6862,119,88,7,0,24,95
6863,44,19,9,7,9,35
6864,172,73,49,10,40,132
6865,73,42,17,0,14,59
6866,147,94,30,0,23,124
6867,194,74,50,29,41,153
6868,43,31,0,0,12,31
6869,32,2,23,0,7,25
6870,142,45,73,3,21,121
6871,135,54,40,15,26,109
6872,43,17,22,0,4,39
6873,73,17,25,14,17,56
6874,21,8,7,0,6,15
6875,34,14,12,1,7,27
6876,24,10,7,2,5,19
6877,30,22,3,1,4,26
6878,76,53,12,1,10,66
6879,76,28,28,4,16,60
6880,63,18,19,11,15,48
6881,20,12,2,0,6,14
6882,82,49,17,3,13,69
6883,319,242,19,0,58,261
6884,169,121,16,2,30,139
6885,96,36,26,15,19,77
6886,392,293,20,0,79,313
6887,83,20,44,7,12,71
6888,68,44,12,0,12,56
6889,50,16,26,0,8,42
6890,70,37,15,0,18,52
6891,32,21,9,0,2,30
6892,29,16,7,1,5,24
6893,21,9,6,2,4,17
6894,46,18,20,0,8,38
6895,20,9,6,2,3,17
6896,57,29,18,0,10,47
6897,26,7,13,0,6,20
6898,32,13,11,0,8,24
6899,2,2,0,0,0,2
6900,35,12,11,2,10,25
6901,49,26,11,1,11,38
6902,49,11,29,0,9,40
6903,163,29,102,1,31,132
6904,56,37,12,0,7,49
6905,128,63,15,19,31,97
6906,91,22,41,6,22,69
6907,53,22,16,3,12,41
6908,46,18,20,0,8,38
6909,67,25,22,4,16,51
6910,75,36,14,7,18,57
6911,55,21,20,1,13,42
6912,33,1,25,1,6,27
6913,38,19,12,0,7,31
6914,114,83,12,9,10,104
6915,101,37,37,5,22,79
6916,41,0,30,0,11,30
6917,67,23,23,5,16,51
6918,42,5,28,0,9,33
6919,23,5,12,0,6,17
6920,46,18,20,0,8,38
6921,66,21,33,0,12,54
6922,54,5,34,1,14,40
6923,18,2,10,0,6,12
6924,32,6,14,5,7,25
6925,36,6,28,0,2,34
6926,70,17,44,2,7,63
6927,130,48,26,26,30,100
6928,43,31,3,2,7,36
6929,53,11,27,3,12,41
6930,18,0,11,0,7,11
6931,32,21,9,0,2,30
6932,94,90,0,4,0,94
6933,63,41,13,0,9,54
6934,58,11,37,1,9,49
6935,286,18,210,2,56,230
6936,89,56,16,2,15,74
6937,11,3,4,2,2,9
6938,179,82,57,5,35,144
6939,21,4,14,0,3,18
6940,337,144,122,11,60,277
6941,102,65,1,13,23,79
6942,44,22,7,4,11,33
6943,19,4,8,0,7,12
6944,97,43,28,5,21,76
6945,185,52,22,81,30,155
6946,81,18,41,6,16,65
6947,104,26,40,15,23,81
6948,32,21,9,0,2,30
6949,79,52,6,5,16,63
6950,92,40,34,1,17,75
6951,13,6,2,3,2,11
6952,155,93,40,13,9,146
6953,98,50,26,4,18,80
6954,60,41,5,1,13,47
6955,20,11,4,1,4,16
6956,41,15,19,0,7,34
6957,58,19,24,1,14,44
6958,28,7,15,0,6,22
6959,416,159,121,45,91,325
6960,218,82,87,4,45,173
6961,568,391,54,1,122,446
6962,86,32,36,0,18,68
6963,61,17,33,1,10,51
6964,4,1,2,0,1,3
6965,235,172,10,1,52,183
6966,113,39,41,6,27,86
6967,2,0,2,0,0,2
6968,141,10,80,19,32,109
6969,40,30,1,2,7,33
6970,47,21,13,5,8,39
6971,36,12,12,0,12,24
6972,108,70,20,0,18,90
6973,47,18,21,0,8,39
6974,193,43,22,96,32,161
6975,212,116,32,23,41,171
6976,122,67,35,1,19,103
6977,33,5,23,1,4,29
6978,73,49,7,0,17,56
6979,192,105,28,23,36,156
6980,29,12,9,1,7,22
6981,32,24,4,0,4,28
6982,133,73,22,4,34,99
6983,36,7,23,1,5,31
6984,25,13,7,0,5,20
6985,15,5,8,0,2,13
6986,90,27,45,4,14,76
6987,62,27,9,8,18,44
6988,185,86,46,15,38,147
6989,33,26,2,0,5,28
6990,50,11,30,0,9,41
6991,5,3,1,0,1,4
6992,34,15,10,0,9,25
6993,23,4,11,0,8,15
6994,88,51,21,4,12,76
6995,54,34,10,0,10,44
6996,353,240,36,1,76,277
6997,175,94,34,17,30,145
6998,104,38,26,13,27,77
6999,33,9,8,7,9,24
7000,227,55,123,7,42,185
7001,275,150,75,0,50,225
7002,44,11,21,0,12,32
7003,119,45,33,15,26,93
7004,92,57,21,11,3,89
7005,167,116,13,0,38,129
7006,82,48,17,4,13,69
7007,2,0,0,0,2,0
7008,341,76,147,35,83,258
7009,401,232,85,16,68,333
7010,148,91,30,1,26,122
7011,13,4,5,2,2,11
7012,19,3,10,0,6,13
7013,84,7,58,0,19,65
7014,55,10,30,0,15,40
7015,54,24,21,2,7,47
7016,69,28,24,4,13,56
7017,38,20,10,3,5,33
7018,51,17,21,1,12,39
7019,42,23,12,1,6,36
7020,78,31,9,18,20,58
7021,342,144,121,6,71,271
7022,32,12,11,3,6,26
7023,36,6,28,0,2,34
7024,92,10,60,5,17,75
7025,478,241,88,45,104,374
7026,165,64,39,23,39,126
7027,83,28,30,12,13,70
7028,76,55,7,3,11,65
7029,86,60,5,0,21,65
7030,216,74,95,2,45,171
7031,14,1,10,0,3,11
7032,115,33,50,7,25,90
7033,84,38,26,0,20,64
7034,37,8,25,1,3,34
7035,2,0,1,0,1,1
7036,134,104,7,0,23,111
7037,15,8,5,0,2,13
7038,165,122,17,0,26,139
7039,195,142,14,1,38,157
7040,45,25,14,0,6,39
7041,9,3,4,1,1,8
7042,182,87,58,1,36,146
7043,56,28,17,0,11,45
7044,155,74,49,1,31,124
7045,50,29,8,1,12,38
7046,303,129,108,6,60,243
7047,51,38,0,0,13,38
7048,20,4,11,0,5,15
7049,489,336,47,1,105,384
7050,32,21,9,0,2,30
7051,236,85,100,4,47,189
7052,195,140,16,2,37,158
7053,37,9,18,0,10,27
7054,98,29,46,7,16,82
7055,35,16,13,0,6,29
7056,198,50,111,2,35,163
7057,59,20,11,17,11,48
7058,53,15,25,0,13,40
7059,64,12,39,3,10,54
7060,140,48,36,30,26,114
7061,20,1,15,0,4,16
7062,55,36,8,1,10,45
7063,138,13,96,1,28,110
7064,41,6,26,0,9,32
7065,4,1,2,0,1,3
7066,59,22,27,1,9,50
7067,61,28,21,0,12,49
7068,36,20,9,1,6,30
7069,54,23,18,3,10,44
7070,31,0,11,15,5,26
7071,25,18,3,0,4,21
7072,70,46,7,2,15,55
7073,400,127,141,46,86,314
7074,23,2,14,0,7,16
7075,8,3,2,0,3,5
7076,45,29,4,1,11,34
7077,68,49,2,0,17,51
7078,14,3,5,0,6,8
7079,80,41,16,8,15,65
7080,39,20,11,0,8,31
7081,57,35,15,0,7,50
7082,32,21,9,0,2,30
7083,12,10,2,0,0,12
7084,20,3,12,0,5,15
7085,45,29,7,3,6,39
7086,79,41,13,9,16,63
7087,57,24,18,3,12,45
7088,199,85,31,37,46,153
7089,336,101,154,6,75,261
7090,79,13,52,0,14,65
7091,73,55,6,1,11,62
7092,120,48,41,7,24,96
7093,43,27,8,1,7,36
7094,58,5,49,0,4,54
7095,15,4,6,0,5,10
7096,153,96,31,1,25,128
7097,70,32,27,2,9,61
7098,36,21,9,1,5,31
7099,4,0,4,0,0,4
7100,178,47,89,3,39,139
7101,132,99,4,2,27,105
7102,29,5,20,0,4,25
7103,48,18,21,0,9,39
7104,285,180,43,0,62,223
7105,34,23,2,0,9,25
7106,57,19,26,0,12,45
7107,59,28,21,2,8,51
7108,384,174,130,11,69,315
7109,44,20,16,0,8,36
7110,105,49,39,1,16,89
7111,32,21,9,0,2,30
7112,8,0,5,0,3,5
7113,364,210,80,17,57,307
7114,220,118,50,14,38,182
7115,54,23,12,9,10,44
7116,4,0,3,0,1,3
7117,197,77,37,32,51,146
7118,84,52,18,0,14,70
7119,31,9,12,3,7,24
7120,671,397,136,20,118,553
7121,168,70,37,26,35,133
7122,624,423,65,2,134,490
7123,73,63,2,0,8,65
7124,120,57,23,17,23,97
7125,22,3,11,1,7,15
7126,22,5,15,0,2,20
7127,542,389,35,1,117,425
7128,39,18,15,0,6,33
7129,92,45,28,0,19,73
7130,58,13,28,2,15,43
7131,29,5,19,0,5,24
7132,32,4,18,2,8,24
7133,35,9,15,4,7,28
7134,13,4,4,0,5,8
7135,124,46,44,9,25,99
7136,57,31,9,8,9,48
7137,285,25,203,2,55,230
7138,71,34,12,7,18,53
7139,93,57,12,2,22,71
7140,7,2,3,1,1,6
7141,39,20,13,0,6,33
7142,59,26,20,2,11,48
7143,81,40,15,11,15,66
7144,61,36,9,3,13,48
7145,40,7,24,1,8,32
7146,38,22,6,2,8,30
7147,50,3,33,3,11,39
7148,1,0,1,0,0,1
7149,16,5,7,2,2,14
7150,107,54,24,7,22,85
7151,76,47,15,0,14,62
7152,158,80,46,1,31,127
7153,380,203,118,0,59,321
7154,13,2,7,1,3,10
7155,59,11,33,1,14,45
7156,478,327,48,1,102,376
7157,418,192,127,12,87,331
7158,170,125,19,0,26,144
7159,30,8,15,0,7,23
7160,145,60,32,19,34,111
7161,26,10,8,4,4,22
7162,138,79,22,3,34,104
7163,21,18,0,0,3,18
7164,37,7,10,15,5,32
7165,448,186,113,46,103,345
7166,35,17,9,3,6,29
7167,64,20,19,9,16,48
7168,38,7,23,1,7,31
7169,30,4,23,0,3,27
7170,26,14,4,4,4,22
7171,99,36,41,0,22,77
7172,134,105,6,0,23,111
7173,68,37,17,1,13,55
7174,220,149,30,0,41,179
7175,50,22,9,6,13,37
7176,57,22,22,0,13,44
7177,37,9,22,1,5,32
7178,14,4,2,5,3,11
7179,46,25,14,0,7,39
7180,13,3,9,0,1,12
7181,41,21,10,1,9,32
7182,62,42,9,1,10,52
7183,124,46,42,12,24,100
7184,112,33,51,2,26,86
7185,271,17,202,0,52,219
7186,88,47,18,2,21,67
7187,327,198,59,0,70,257
7188,41,15,13,5,8,33
7189,24,9,7,1,7,17
7190,122,91,7,0,24,98
7191,36,7,18,0,11,25
7192,144,88,29,0,27,117
7193,5,4,1,0,0,5
7194,38,2,30,1,5,33
7195,22,9,5,2,6,16
7196,55,17,24,0,14,41
7197,282,137,81,4,60,222
7198,56,37,12,0,7,49
7199,37,19,9,2,7,30
7200,17,6,6,0,5,12
7201,3,1,2,0,0,3
7202,67,45,9,2,11,56
7203,41,15,14,0,12,29
7204,46,18,20,0,8,38
7205,32,21,9,0,2,30
7206,57,2,47,0,8,49
7207,23,5,12,0,6,17
7208,41,21,10,4,6,35
7209,83,49,21,0,13,70
7210,83,13,50,6,14,69
7211,639,371,146,16,106,533
7212,26,19,3,1,3,23
7213,57,34,7,7,9,48
7214,12,0,10,0,2,10
7215,23,2,13,1,7,16
7216,26,7,8,3,8,18
7217,81,64,4,2,11,70
7218,90,24,41,6,19,71
7219,285,35,197,2,51,234
7220,56,25,16,3,12,44
7221,28,10,12,0,6,22
7222,45,11,26,1,7,38
7223,223,144,27,0,52,171
7224,111,50,36,3,22,89
7225,42,5,28,0,9,33
7226,27,11,6,3,7,20
7227,39,23,6,3,7,32
7228,15,4,7,2,2,13
7229,142,58,32,23,29,113
7230,109,58,25,4,22,87
7231,49,30,5,0,14,35
7232,15,4,5,4,2,13
7233,19,2,15,0,2,17
7234,12,5,4,1,2,10
7235,67,15,39,1,12,55
7236,47,29,11,1,6,41
7237,212,93,53,23,43,169
7238,24,9,11,1,3,21
7239,70,42,7,7,14,56
7240,200,128,25,9,38,162
7241,500,329,69,3,99,401
7242,127,41,47,7,32,95
7243,39,23,8,0,8,31
7244,122,74,6,16,26,96
7245,140,56,44,8,32,108
7246,65,34,11,6,14,51
7247,166,56,85,4,21,145
7248,69,22,26,6,15,54
7249,113,42,42,10,19,94
7250,123,73,19,3,28,95
7251,9,2,5,0,2,7
7252,31,1,24,1,5,26
7253,118,47,28,17,26,92
7254,77,45,18,6,8,69
7255,33,3,5,17,8,25
7256,1,0,1,0,0,1
7257,84,25,38,9,12,72
7258,43,27,2,9,5,38
7259,67,46,6,0,15,52
7260,92,74,3,0,15,77
7261,24,6,9,0,9,15
7262,547,302,116,13,116,431
7263,169,122,4,2,41,128
7264,105,49,33,4,19,86
7265,74,43,17,0,14,60
7266,23,8,11,1,3,20
7267,24,8,10,0,6,18
7268,148,62,32,19,35,113
7269,56,3,40,1,12,44
7270,8,1,2,4,1,7
7271,78,30,31,9,8,70
7272,111,78,18,0,15,96
7273,76,36,19,8,13,63
7274,122,23,43,22,34,88
7275,48,19,17,0,12,36
7276,55,33,14,2,6,49
7277,65,49,6,0,10,55
7278,293,195,73,3,22,271
7279,19,10,6,2,1,18
7280,80,39,29,1,11,69
7281,18,9,7,0,2,16
7282,10,1,5,0,4,6
7283,75,36,11,8,20,55
7284,18,10,6,0,2,16
7285,116,59,28,6,23,93
7286,12,4,8,0,0,12
7287,246,179,16,0,51,195
7288,58,47,0,1,10,48
7289,77,39,26,4,8,69
7290,22,10,9,1,2,20
7291,29,13,13,0,3,26
7292,108,38,19,28,23,85
7293,120,58,37,4,21,99
7294,63,26,20,5,12,51
7295,61,17,32,3,9,52
7296,9,8,0,0,1,8
7297,77,45,13,4,15,62
7298,41,20,13,3,5,36
7299,112,49,33,0,30,82
7300,35,12,12,0,11,24
7301,103,65,10,5,23,80
7302,60,28,19,0,13,47
7303,94,26,46,7,15,79
7304,145,36,77,1,31,114
7305,201,50,39,77,35,166
7306,67,35,16,4,12,55
7307,38,5,25,0,8,30
7308,7,2,4,0,1,6
7309,465,217,105,43,100,365
7310,46,25,15,1,5,41
7311,264,103,100,16,45,219
7312,32,18,8,0,6,26
7313,57,36,7,0,14,43
7314,13,6,4,2,1,12
7315,32,21,9,0,2,30
7316,51,12,25,6,8,43
7317,39,10,17,1,11,28
7318,17,0,12,0,5,12
7319,21,2,16,0,3,18
7320,191,138,18,0,35,156
7321,12,5,4,0,3,9
7322,6,5,1,0,0,6
7323,10,5,0,0,5,5
7324,13,6,5,1,1,12
7325,46,18,20,0,8,38
7326,41,13,14,3,11,30
7327,23,6,7,3,7,16
7328,0,0,0,0,0,0
7329,55,24,22,0,9,46
7330,60,20,15,16,9,51
7331,62,38,13,1,10,52
7332,15,8,6,0,1,14
7333,34,16,11,0,7,27
7334,90,39,37,0,14,76
7335,59,43,5,4,7,52
7336,31,10,10,4,7,24
7337,63,42,12,0,9,54
7338,45,25,10,1,9,36
7339,165,77,50,6,32,133
7340,138,98,15,0,25,113
7341,9,0,6,0,3,6
7342,64,29,19,4,12,52
7343,86,17,60,2,7,79
7344,35,6,20,0,9,26
7345,46,18,20,0,8,38
7346,18,5,10,0,3,15
7347,60,28,7,10,15,45
7348,7,2,3,0,2,5
7349,503,264,91,45,103,400
7350,36,1,9,18,8,28
7351,19,7,8,0,4,15
7352,30,10,5,8,7,23
7353,45,12,20,4,9,36
7354,70,36,8,16,10,60
7355,63,42,4,2,15,48
7356,188,128,25,5,30,158
7357,16,2,13,0,1,15
7358,34,7,21,0,6,28
7359,19,6,1,7,5,14
7360,55,13,37,0,5,50
7361,86,39,31,0,16,70
7362,12,10,1,0,1,11
7363,82,33,25,9,15,67
7364,220,149,30,0,41,179
7365,125,99,3,0,23,102
7366,132,99,4,2,27,105
7367,61,19,30,2,10,51
7368,155,99,3,17,36,119
7369,11,4,7,0,0,11
7370,16,4,7,0,5,11
7371,50,12,26,1,11,39
7372,37,7,11,8,11,26
7373,77,10,43,5,19,58
7374,102,14,58,0,30,72
7375,76,35,20,3,18,58
7376,71,12,46,0,13,58
7377,104,75,12,9,8,96
7378,84,43,20,1,20,64
7379,189,133,41,3,12,177
7380,197,95,58,1,43,154
7381,116,62,10,21,23,93
7382,37,28,3,2,4,33
7383,7,2,3,0,2,5
7384,49,32,6,2,9,40
7385,125,52,54,1,18,107
7386,123,37,53,6,27,96
7387,158,84,32,7,35,123
7388,49,22,11,1,15,34
7389,677,392,144,21,120,557
7390,50,29,13,0,8,42
7391,27,4,20,0,3,24
7392,124,50,32,18,24,100
7393,27,6,10,3,8,19
7394,109,85,4,0,20,89
7395,54,15,28,0,11,43
7396,643,379,133,19,112,531
7397,126,51,41,13,21,105
7398,72,32,23,0,17,55
7399,67,30,20,0,17,50
7400,135,71,26,11,27,108
7401,153,9,86,27,31,122
7402,88,28,31,8,21,67
7403,111,48,34,2,27,84
7404,42,15,22,0,5,37
7405,557,391,47,1,118,439
7406,115,45,34,10,26,89
7407,20,9,6,3,2,18
7408,57,19,26,0,12,45
7409,128,26,42,24,36,92
7410,389,224,86,0,79,310
7411,71,23,36,0,12,59
7412,40,10,23,1,6,34
7413,56,3,40,1,12,44
7414,247,16,185,0,46,201
7415,213,52,47,75,39,174
7416,49,25,10,1,13,36
7417,658,388,138,17,115,543
7418,42,12,23,1,6,36
7419,112,106,0,6,0,112
7420,45,8,17,8,12,33
7421,38,14,11,4,9,29
7422,38,9,17,4,8,30
7423,57,5,36,1,15,42
7424,185,113,38,19,15,170
7425,247,103,15,82,47,200
7426,141,79,40,13,9,132
7427,103,24,56,3,20,83
7428,82,44,16,0,22,60
7429,163,67,55,16,25,138
7430,347,150,123,6,68,279
7431,253,122,74,5,52,201
7432,11,5,3,1,2,9
7433,90,64,17,0,9,81
7434,93,55,16,6,16,77
7435,47,18,14,3,12,35
7436,64,32,14,7,11,53
7437,7,2,4,0,1,6
7438,35,5,25,1,4,31
7439,20,9,4,0,7,13
7440,64,9,38,3,14,50
7441,60,4,42,4,10,50
7442,358,168,103,14,73,285
7443,123,32,50,10,31,92
7444,73,50,15,5,3,70
7445,56,3,40,1,12,44
7446,98,45,28,5,20,78
7447,43,2,34,0,7,36
7448,109,58,25,4,22,87
7449,222,73,99,2,48,174
7450,139,73,32,9,25,114
7451,56,2,38,0,16,40
7452,19,2,12,0,5,14
7453,55,24,13,6,12,43
7454,175,76,49,10,40,135
7455,153,69,44,0,40,113
7456,59,2,40,12,5,54
7457,71,29,7,20,15,56
7458,3,2,0,0,1,2
7459,0,0,0,0,0,0
7460,46,31,5,0,10,36
7461,36,12,16,0,8,28
7462,51,14,28,3,6,45
7463,32,23,0,0,9,23
7464,50,11,30,0,9,41
7465,46,18,20,0,8,38
7466,9,4,3,0,2,7
7467,12,4,6,2,0,12
7468,88,47,26,4,11,77
7469,21,10,5,0,6,15
7470,71,42,15,0,14,57
7471,5,4,0,0,1,4
7472,42,16,9,3,14,28
7473,153,66,55,1,31,122
7474,27,14,2,4,7,20
7475,219,148,30,0,41,178
7476,27,0,18,0,9,18
7477,48,23,13,0,12,36
7478,157,50,46,33,28,129
7479,79,47,15,4,13,66
7480,105,53,32,0,20,85
7481,8,0,5,0,3,5
7482,53,24,20,2,7,46
7483,65,47,1,0,17,48
7484,138,54,44,9,31,107
7485,34,14,15,0,5,29
7486,360,173,99,11,77,283
7487,69,41,7,7,14,55
7488,397,207,100,20,70,327
7489,17,2,12,0,3,14
7490,126,86,9,5,26,100
7491,57,27,14,3,13,44
7492,75,34,18,14,9,66
7493,69,43,9,2,15,54
7494,105,74,12,11,8,97
7495,151,24,98,1,28,123
7496,50,29,13,0,8,42
7497,126,75,20,3,28,98
7498,58,14,5,27,12,46
7499,90,62,5,10,13,77
7500,112,48,30,13,21,91
7501,127,37,65,0,25,102
7502,28,15,8,1,4,24
7503,29,11,12,0,6,23
7504,32,21,9,0,2,30
7505,91,29,32,11,19,72
7506,351,185,92,15,59,292
7507,51,23,18,2,8,43
7508,44,16,4,17,7,37
7509,88,40,32,1,15,73
7510,79,26,22,9,22,57
7511,77,54,2,0,21,56
7512,124,91,6,0,27,97
7513,25,11,8,2,4,21
7514,37,18,14,0,5,32
7515,28,12,6,0,10,18
7516,439,199,150,9,81,358
7517,60,35,18,0,7,53
7518,69,17,34,0,18,51
7519,699,405,160,20,114,585
7520,73,40,18,0,15,58
7521,36,13,11,3,9,27
7522,22,7,6,2,7,15
7523,46,18,20,0,8,38
7524,37,3,26,0,8,29
7525,46,18,20,0,8,38
7526,230,157,31,0,42,188
7527,58,34,16,0,8,50
7528,342,145,120,6,71,271
7529,120,83,8,5,24,96
7530,252,137,52,0,63,189
7531,112,49,30,13,20,92
7532,273,185,18,4,66,207
7533,208,59,109,4,36,172
7534,56,39,11,5,1,55
7535,390,105,150,45,90,300
7536,173,76,27,28,42,131
7537,154,108,21,0,25,129
7538,84,40,27,4,13,71
7539,49,18,21,0,10,39
7540,15,1,13,0,1,14
7541,286,153,77,10,46,240
7542,210,114,62,0,34,176
7543,205,135,50,4,16,189
7544,78,40,13,6,19,59
7545,648,359,162,21,106,542
7546,489,248,89,47,105,384
7547,33,9,13,3,8,25
7548,13,1,8,1,3,10
7549,76,41,21,0,14,62
7550,30,9,17,0,4,26
7551,10,6,3,0,1,9
7552,47,27,10,4,6,41
7553,39,6,5,19,9,30
7554,75,24,24,14,13,62
7555,498,296,104,9,89,409
7556,628,371,134,15,108,520
7557,109,39,46,9,15,94
7558,46,18,20,0,8,38
7559,13,5,5,1,2,11
7560,17,7,3,0,7,10
7561,16,3,10,0,3,13
7562,70,39,15,3,13,57
7563,142,52,32,22,36,106
7564,71,35,19,2,15,56
7565,136,61,42,11,22,114
7566,51,26,8,8,9,42
7567,46,33,9,4,0,46
7568,17,8,8,0,1,16
7569,139,65,42,10,22,117
7570,10,7,2,0,1,9
7571,48,12,23,5,8,40
7572,23,8,9,0,6,17
7573,67,34,11,6,16,51
7574,40,8,11,10,11,29
7575,134,98,5,2,29,105
7576,101,51,24,0,26,75
7577,49,26,6,7,10,39
7578,32,21,9,0,2,30
7579,68,34,7,10,17,51
7580,92,31,18,10,33,59
7581,32,21,9,0,2,30
7582,211,89,77,4,41,170
7583,43,21,15,0,7,36
7584,1,0,0,0,1,0
7585,67,20,20,9,18,49
7586,12,6,1,2,3,9
7587,129,78,18,4,29,100
7588,46,18,20,0,8,38
7589,14,10,3,0,1,13
7590,85,30,38,6,11,74
7591,56,40,8,0,8,48
7592,17,9,6,0,2,15
7593,27,13,13,0,1,26
7594,44,5,21,12,6,38
7595,78,45,17,8,8,70
7596,29,10,13,0,6,23
7597,19,3,13,0,3,16
7598,11,7,1,0,3,8
7599,175,77,58,4,36,139
7600,25,13,5,0,7,18
7601,170,87,40,0,43,127
7602,75,24,40,0,11,64
7603,96,28,38,3,27,69
7604,136,47,47,18,24,112
7605,32,9,14,0,9,23
7606,16,9,5,0,2,14
7607,112,45,25,16,26,86
7608,33,13,9,6,5,28
7609,19,11,5,1,2,17
7610,18,8,4,1,5,13
7611,53,30,14,0,9,44
7612,57,19,26,0,12,45
7613,27,14,7,1,5,22
7614,43,6,28,2,7,36
7615,177,62,66,18,31,146
7616,26,15,8,0,3,23
7617,22,9,7,2,4,18
7618,114,64,11,13,26,88
7619,73,63,2,0,8,65
7620,43,7,26,2,8,35
7621,37,1,9,19,8,29
7622,66,16,18,15,17,49
7623,47,7,26,5,9,38
7624,33,7,19,1,6,27
7625,60,14,29,2,15,45
7626,122,73,10,19,20,102
7627,19,0,10,0,9,10
7628,136,71,42,12,11,125
7629,57,30,19,0,8,49
7630,160,117,14,1,28,132
7631,77,27,24,6,20,57
7632,36,21,10,0,5,31
7633,74,40,15,2,17,57
7634,17,11,2,0,4,13
7635,69,26,12,20,11,58
7636,45,15,20,2,8,37
7637,15,7,7,0,1,14
7638,105,74,12,11,8,97
7639,50,16,22,4,8,42
7640,163,125,7,0,31,132
7641,360,212,75,0,73,287
7642,86,17,60,2,7,79
7643,46,18,20,0,8,38
7644,76,5,42,8,21,55
7645,42,17,13,0,12,30
7646,67,29,19,7,12,55
7647,37,11,14,1,11,26
7648,9,3,2,0,4,5
7649,416,103,179,44,90,326
7650,90,34,18,9,29,61
7651,151,115,9,3,24,127
7652,93,35,38,1,19,74
7653,192,122,24,9,37,155
7654,79,45,11,5,18,61
7655,11,7,3,0,1,10
7656,19,5,9,3,2,17
7657,70,13,43,0,14,56
7658,55,24,13,6,12,43
7659,51,36,8,0,7,44
7660,23,7,12,0,4,19
7661,46,18,20,0,8,38
7662,66,23,31,1,11,55
7663,75,21,43,1,10,65
7664,285,196,66,3,20,265
7665,56,22,19,6,9,47
7666,90,39,36,0,15,75
7667,70,37,23,0,10,60
7668,111,45,35,6,25,86
7669,33,5,22,0,6,27
7670,185,89,67,8,21,164
7671,120,59,36,4,21,99
7672,11,2,4,1,4,7
7673,65,36,9,8,12,53
7674,65,13,34,0,18,47
7675,20,11,3,0,6,14
7676,80,23,43,0,14,66
7677,29,18,4,0,7,22
7678,170,112,27,1,30,140
7679,44,37,3,0,4,40
7680,12,3,4,1,4,8
7681,81,40,16,8,17,64
7682,29,7,19,0,3,26
7683,115,88,3,0,24,91
7684,62,41,9,2,10,52
7685,191,76,33,34,48,143
7686,50,30,11,0,9,41
7687,70,47,9,4,10,60
7688,15,7,3,3,2,13
7689,42,18,11,0,13,29
7690,128,59,36,0,33,95
7691,46,13,10,13,10,36
7692,77,54,12,1,10,67
7693,29,23,5,1,0,29
7694,58,19,22,3,14,44
7695,98,48,33,1,16,82
7696,105,37,25,20,23,82
7697,510,299,113,14,84,426
7698,29,20,2,0,7,22
7699,458,247,115,21,75,383
7700,123,44,34,20,25,98
7701,8,1,0,5,2,6
7702,9,5,0,1,3,6
7703,91,43,22,5,21,70
7704,247,187,18,2,40,207
7705,30,19,3,0,8,22
7706,161,29,103,1,28,133
7707,20,10,6,0,4,16
7708,67,10,39,3,15,52
7709,46,18,20,0,8,38
7710,65,20,25,4,16,49
7711,79,35,35,1,8,71
7712,330,145,112,11,62,268
7713,9,3,3,0,3,6
7714,150,104,21,0,25,125
7715,46,18,20,0,8,38
7716,21,12,5,0,4,17
7717,4,0,2,0,2,2
7718,95,53,17,10,15,80
7719,156,34,51,37,34,122
7720,45,7,26,4,8,37
7721,226,14,169,0,43,183
7722,48,18,20,2,8,40
7723,42,6,26,3,7,35
7724,54,13,19,4,18,36
7725,145,51,69,0,25,120
7726,99,64,17,0,18,81
7727,138,83,31,3,21,117
7728,38,19,9,1,9,29
7729,70,45,10,1,14,56
7730,18,5,9,0,4,14
7731,11,6,2,0,3,8
7732,36,14,14,1,7,29
7733,152,58,39,21,34,118
7734,95,49,18,3,25,70
7735,2,2,0,0,0,2
7736,109,40,34,8,27,82
7737,148,84,18,22,24,124
7738,13,1,10,1,1,12
7739,18,3,9,3,3,15
7740,12,2,7,0,3,9
7741,65,19,29,1,16,49
7742,33,22,6,1,4,29
7743,53,37,9,0,7,46
7744,66,38,12,0,16,50
7745,35,13,13,0,9,26
7746,52,22,4,15,11,41
7747,664,387,143,17,117,547
7748,14,4,5,0,5,9
7749,9,5,2,0,2,7
7750,115,53,32,6,24,91
7751,32,21,9,0,2,30
7752,32,11,3,14,4,28
7753,46,7,29,0,10,36
7754,106,88,3,3,12,94
7755,69,39,3,14,13,56
7756,671,391,144,17,119,552
7757,41,26,4,2,9,32
7758,44,10,22,0,12,32
7759,13,8,4,0,1,12
7760,53,29,12,0,12,41
7761,12,0,9,0,3,9
7762,494,255,91,46,102,392
7763,53,20,18,5,10,43
7764,45,15,24,0,6,39
7765,324,135,121,10,58,266
7766,32,21,9,0,2,30
7767,78,38,16,0,24,54
7768,12,5,4,2,1,11
7769,46,14,19,0,13,33
7770,39,23,8,0,8,31
7771,91,73,0,4,14,77
7772,18,6,8,0,4,14
7773,185,59,58,25,43,142
7774,96,54,20,7,15,81
7775,174,104,46,13,11,163
7776,141,79,22,3,37,104
7777,464,135,193,35,101,363
7778,62,23,21,0,18,44
7779,444,138,183,24,99,345
7780,2,1,0,0,1,1
7781,126,72,21,5,28,98
7782,41,14,18,3,6,35
7783,113,43,34,7,29,84
7784,74,25,35,1,13,61
7785,9,8,0,0,1,8
7786,24,12,4,2,6,18
7787,30,18,5,1,6,24
7788,14,6,7,0,1,13
7789,75,18,39,4,14,61
7790,26,13,6,2,5,21
7791,59,11,34,4,10,49
7792,28,8,14,1,5,23
7793,102,50,31,4,17,85
7794,15,4,5,0,6,9
7795,64,44,5,1,14,50
7796,53,3,36,3,11,42
7797,49,27,10,3,9,40
7798,21,6,10,1,4,17
7799,94,42,31,3,18,76
7800,41,6,6,19,10,31
7801,262,126,85,4,47,215
7802,24,7,12,0,5,19
7803,32,15,3,6,8,24
7804,20,1,13,0,6,14
7805,74,5,52,1,16,58
7806,125,84,28,0,13,112
7807,39,4,27,0,8,31
7808,160,77,50,1,32,128
7809,15,7,2,6,0,15
7810,240,156,34,4,46,194
7811,32,17,7,0,8,24
7812,77,38,22,0,17,60
7813,111,59,31,0,21,90
7814,139,57,51,3,28,111
7815,213,114,48,0,51,162
7816,21,1,17,0,3,18
7817,31,9,16,0,6,25
7818,83,39,30,4,10,73
7819,631,352,155,23,101,530
7820,77,24,37,3,13,64
7821,8,0,8,0,0,8
7822,28,5,19,0,4,24
7823,94,30,24,21,19,75
7824,225,151,33,0,41,184
7825,33,24,5,0,4,29
7826,390,190,112,14,74,316
7827,10,3,7,0,0,10
7828,207,50,31,91,35,172
7829,166,102,51,1,12,154
7830,432,207,119,14,92,340
7831,27,9,13,0,5,22
7832,137,63,45,5,24,113
7833,52,13,17,10,12,40
7834,16,3,12,0,1,15
7835,69,37,15,1,16,53
7836,25,8,7,3,7,18
7837,10,2,8,0,0,10
7838,49,33,6,1,9,40
7839,3,1,1,0,1,2
7840,30,8,19,0,3,27
7841,303,105,141,5,52,251
7842,273,60,145,6,62,211
7843,44,21,11,1,11,33
7844,32,21,9,0,2,30
7845,72,32,27,0,13,59
7846,3,1,1,0,1,2
7847,61,21,32,0,8,53
7848,52,15,29,1,7,45
7849,365,164,103,23,75,290
7850,60,28,23,1,8,52
7851,124,72,26,0,26,98
7852,13,8,2,2,1,12
7853,63,15,35,3,10,53
7854,158,68,32,23,35,123
7855,85,51,12,3,19,66
7856,19,6,8,0,5,14
7857,27,12,9,1,5,22
7858,114,73,28,0,13,101
7859,17,3,13,0,1,16
7860,137,36,47,19,35,102
7861,17,5,4,5,3,14
7862,145,62,32,16,35,110
7863,58,33,12,0,13,45
7864,56,37,5,0,14,42
7865,220,91,65,21,43,177
7866,99,44,33,4,18,81
7867,34,4,22,4,4,30
7868,14,5,5,0,4,10
7869,62,43,8,4,7,55
7870,62,25,26,1,10,52
7871,68,15,36,6,11,57
7872,82,44,22,4,12,70
7873,57,19,26,0,12,45
7874,14,5,3,3,3,11
7875,70,49,1,2,18,52
7876,584,409,50,1,124,460
7877,443,114,186,44,99,344
7878,169,91,42,0,36,133
7879,18,15,1,0,2,16
7880,38,9,18,3,8,30
7881,63,22,27,0,14,49
7882,71,41,8,8,14,57
7883,150,24,97,1,28,122
7884,121,29,55,17,20,101
7885,109,52,24,4,29,80
7886,18,8,5,2,3,15
7887,15,3,4,4,4,11
7888,18,5,6,0,7,11
7889,368,213,79,0,76,292
7890,38,1,31,0,6,32
7891,45,38,1,0,6,39
7892,126,74,21,3,28,98
7893,64,15,39,0,10,54
7894,45,13,19,0,13,32
7895,29,11,14,0,4,25
7896,16,12,3,0,1,15
7897,53,22,22,0,9,44
7898,131,71,40,9,11,120
7899,36,25,8,0,3,33
7900,2,0,1,0,1,1
7901,318,229,17,0,72,246
7902,220,149,30,0,41,179
7903,198,66,61,26,45,153
7904,160,122,7,0,31,129
7905,7,4,2,1,0,7
7906,40,21,12,2,5,35
7907,46,18,20,0,8,38
7908,46,18,20,0,8,38
7909,61,25,24,0,12,49
7910,343,145,121,6,71,272
7911,15,1,12,0,2,13
7912,16,8,6,0,2,14
7913,121,67,30,2,22,99
7914,177,90,43,0,44,133
7915,65,19,29,1,16,49
7916,100,23,62,0,15,85
7917,220,149,30,0,41,179
7918,99,36,27,16,20,79
7919,69,38,14,3,14,55
7920,83,55,13,0,15,68
7921,56,3,44,1,8,48
7922,17,0,15,1,1,16
7923,62,43,4,1,14,48
7924,19,14,3,0,2,17
7925,11,10,0,0,1,10
7926,32,16,7,2,7,25
7927,10,1,7,0,2,8
7928,29,2,21,1,5,24
7929,54,32,10,0,12,42
7930,104,47,27,12,18,86
7931,59,32,11,3,13,46
7932,66,2,39,18,7,59
7933,144,47,6,66,25,119
7934,35,16,10,0,9,26
7935,63,35,15,0,13,50
7936,24,3,15,1,5,19
7937,15,3,5,3,4,11
7938,25,4,1,16,4,21
7939,393,226,87,0,80,313
7940,84,35,32,2,15,69
7941,18,7,8,0,3,15
7942,9,7,0,0,2,7
7943,220,154,49,3,14,206
7944,48,16,22,1,9,39
7945,673,392,151,16,114,559
7946,65,18,34,0,13,52
7947,97,37,41,3,16,81
7948,95,32,25,19,19,76
7949,54,8,32,3,11,43
7950,113,43,46,0,24,89
7951,276,142,94,0,40,236
7952,46,18,20,0,8,38
7953,188,107,23,23,35,153
7954,28,11,2,8,7,21
7955,103,29,56,0,18,85
7956,15,4,7,2,2,13
7957,72,39,17,3,13,59
7958,45,9,21,0,15,30
7959,115,70,22,0,23,92
7960,5,0,1,0,4,1
7961,44,0,29,3,12,32
7962,301,147,87,3,64,237
7963,14,6,3,2,3,11
7964,106,52,34,3,17,89
7965,32,13,13,2,4,28
7966,46,18,20,0,8,38
7967,74,20,33,5,16,58
7968,106,53,36,1,16,90
7969,62,37,14,0,11,51
7970,617,353,135,17,112,505
7971,38,23,9,0,6,32
7972,67,37,10,6,14,53
7973,7,0,6,0,1,6
7974,26,13,11,1,1,25
7975,40,11,20,0,9,31
7976,112,34,39,15,24,88
7977,139,64,46,5,24,115
7978,23,13,3,0,7,16
7979,36,22,8,0,6,30
7980,50,20,19,1,10,40
7981,24,9,8,0,7,17
7982,32,21,9,0,2,30
7983,9,5,0,0,4,5
7984,42,31,2,0,9,33
7985,150,62,35,20,33,117
7986,23,7,12,0,4,19
7987,418,132,174,22,90,328
7988,39,19,6,2,12,27
7989,22,11,6,0,5,17
7990,16,11,3,1,1,15
7991,41,32,5,0,4,37
7992,56,10,24,6,16,40
7993,33,8,17,0,8,25
7994,64,41,5,0,18,46
7995,21,8,9,0,4,17
7996,23,12,8,1,2,21
7997,65,24,20,1,20,45
7998,3,0,3,0,0,3
7999,196,109,28,23,36,160
8000,118,60,40,7,11,107
8001,18,7,3,1,7,11
8002,14,10,0,0,4,10
8003,29,11,9,0,9,20
8004,166,98,38,1,29,137
8005,78,35,5,16,22,56
8006,136,57,44,8,27,109
8007,147,64,32,17,34,113
8008,51,26,14,0,11,40
8009,183,44,25,80,34,149
8010,42,15,21,0,6,36
8011,40,10,26,0,4,36
8012,628,367,141,15,105,523
8013,40,16,1,10,13,27
8014,88,48,20,0,20,68
8015,100,53,22,1,24,76
8016,41,10,10,15,6,35
8017,33,25,2,0,6,27
8018,94,28,38,8,20,74
8019,86,25,30,11,20,66
8020,68,45,11,2,10,58
8021,198,88,52,20,38,160
8022,50,12,34,0,4,46
8023,91,80,2,9,0,91
8024,49,12,19,0,18,31
8025,35,6,27,0,2,33
8026,169,110,23,5,31,138
8027,113,45,23,18,27,86
8028,80,29,34,0,17,63
8029,215,89,14,75,37,178
8030,72,29,21,8,14,58
8031,13,6,4,1,2,11
8032,46,18,20,0,8,38
8033,9,6,2,0,1,8
8034,19,14,3,0,2,17
8035,104,41,12,29,22,82
8036,0,0,0,0,0,0
8037,581,391,65,4,121,460
8038,41,16,12,4,9,32
8039,136,43,63,4,26,110
8040,292,159,69,15,49,243
8041,26,13,7,0,6,20
8042,46,8,30,0,8,38
8043,197,140,11,9,37,160
8044,42,23,10,0,9,33
8045,8,2,4,0,2,6
8046,82,38,30,4,10,72
8047,5,2,2,0,1,4
8048,130,88,17,1,24,106
8049,33,6,6,10,11,22
8050,13,1,10,1,1,12
8051,54,18,24,6,6,48
8052,34,13,13,0,8,26
8053,28,18,7,0,3,25
8054,16,9,5,1,1,15
8055,25,5,15,0,5,20
8056,10,2,4,0,4,6
8057,112,41,46,6,19,93
8058,211,157,22,1,31,180
8059,203,111,30,21,41,162
8060,11,2,6,1,2,9
8061,31,9,19,0,3,28
8062,32,16,4,4,8,24
8063,58,2,40,0,16,42
8064,38,5,28,1,4,34
8065,90,47,27,4,12,78
8066,492,253,91,47,101,391
8067,192,53,51,50,38,154
8068,90,38,32,9,11,79
8069,53,27,15,1,10,43
8070,96,48,19,4,25,71
8071,207,112,61,0,34,173
8072,33,18,13,0,2,31
8073,150,54,36,29,31,119
8074,68,30,21,0,17,51
8075,16,3,6,4,3,13
8076,220,149,30,0,41,179
8077,29,17,2,3,7,22
8078,86,27,25,14,20,66
8079,83,21,45,3,14,69
8080,109,58,25,4,22,87
8081,112,49,28,14,21,91
8082,165,57,55,23,30,135
8083,168,50,57,24,37,131
8084,63,47,5,4,7,56
8085,161,59,50,17,35,126
8086,22,0,19,1,2,20
8087,31,8,11,3,9,22
8088,33,10,6,10,7,26
8089,112,42,42,9,19,93
8090,78,37,5,14,22,56
8091,24,10,9,0,5,19
8092,94,58,11,2,23,71
8093,61,31,18,1,11,50
8094,138,76,39,13,10,128
8095,65,26,28,2,9,56
8096,44,10,22,0,12,32
8097,21,10,3,0,8,13
8098,106,47,37,1,21,85
8099,1,1,0,0,0,1
8100,146,92,14,10,30,116
8101,192,137,8,3,44,148
8102,19,4,8,0,7,12
8103,17,7,7,0,3,14
8104,111,73,16,3,19,92
8105,212,124,37,3,48,164
8106,32,21,9,0,2,30
8107,30,9,15,0,6,24
8108,34,17,8,2,7,27
8109,88,26,39,1,22,66
8110,42,5,26,0,11,31
8111,41,26,7,2,6,35
8112,49,29,12,0,8,41
8113,34,25,0,2,7,27
8114,45,35,2,0,8,37
8115,26,7,10,0,9,17
8116,590,427,42,1,120,470
8117,90,29,19,22,20,70
8118,43,27,3,6,7,36
8119,397,231,86,0,80,317
8120,56,31,6,8,11,45
8121,173,60,77,0,36,137
8122,124,103,3,3,15,109
8123,231,100,14,77,40,191
8124,46,18,20,1,7,39
8125,53,14,31,0,8,45
8126,144,76,31,5,32,112
8127,18,6,9,0,3,15
8128,14,8,4,0,2,12
8129,31,21,6,0,4,27
8130,71,25,29,1,16,55
8131,55,20,19,0,16,39
8132,252,130,64,0,58,194
8133,85,43,26,4,12,73
8134,63,15,24,10,14,49
8135,32,21,9,0,2,30
8136,9,4,0,1,4,5
8137,21,1,4,12,4,17
8138,56,3,40,1,12,44
8139,36,11,9,7,9,27
8140,24,13,3,1,7,17
8141,32,21,9,0,2,30
8142,12,3,4,4,1,11
8143,130,67,12,23,28,102
8144,7,3,2,0,2,5
8145,110,50,22,14,24,86
8146,91,60,7,4,20,71
8147,42,22,10,2,8,34
8148,190,86,46,20,38,152
8149,19,5,12,1,1,18
8150,42,17,10,6,9,33
8151,122,83,17,1,21,101
8152,62,38,10,1,13,49
8153,204,150,17,2,35,169
8154,86,59,11,0,16,70
8155,22,12,8,0,2,20
8156,404,135,163,18,88,316
8157,6,2,1,0,3,3
8158,207,33,125,4,45,162
8159,77,45,17,0,15,62
8160,65,39,17,3,6,59
8161,43,7,28,4,4,39
8162,109,104,0,5,0,109
8163,89,24,46,7,12,77
8164,57,35,8,4,10,47
8165,39,19,16,1,3,36
8166,139,55,42,18,24,115
8167,64,45,4,1,14,50
8168,12,11,0,0,1,11
8169,234,178,10,0,46,188
8170,28,19,2,0,7,21
8171,69,23,35,1,10,59
8172,46,18,20,0,8,38
8173,58,17,24,2,15,43
8174,38,19,8,1,10,28
8175,166,67,35,24,40,126
8176,52,29,13,1,9,43
8177,336,150,113,6,67,269
8178,58,18,32,1,7,51
8179,31,19,9,0,3,28
8180,62,23,20,1,18,44
8181,55,25,12,6,12,43
8182,11,4,4,0,3,8
8183,530,286,91,45,108,422
8184,59,26,20,0,13,46
8185,31,4,20,0,7,24
8186,57,19,26,0,12,45
8187,17,12,1,3,1,16
8188,104,74,12,10,8,96
8189,515,360,46,1,108,407
8190,81,53,8,2,18,63
8191,1,1,0,0,0,1
8192,64,21,24,9,10,54
8193,29,1,22,0,6,23
8194,32,21,9,0,2,30
8195,108,69,24,0,15,93
8196,502,268,88,43,103,399
8197,46,20,9,8,9,37
8198,34,10,20,0,4,30
8199,206,112,30,23,41,165
8200,92,39,30,5,18,74
8201,19,3,15,0,1,18
8202,609,356,110,12,131,478
8203,36,8,14,4,10,26
8204,22,13,3,0,6,16
8205,29,11,13,0,5,24
8206,110,70,20,2,18,92
8207,38,21,11,0,6,32
8208,134,56,43,8,27,107
8209,8,3,3,2,0,8
8210,205,84,69,18,34,171
8211,54,15,23,1,15,39
8212,21,5,7,6,3,18
8213,68,36,18,0,14,54
8214,51,38,1,0,12,39
8215,68,16,26,9,17,51
8216,200,110,39,14,37,163
8217,18,3,12,0,3,15
8218,87,27,18,22,20,67
8219,204,92,56,13,43,161
8220,82,25,17,21,19,63
8221,72,36,17,0,19,53
8222,148,74,19,25,30,118
8223,31,14,10,0,7,24
8224,173,57,55,28,33,140
8225,31,13,6,6,6,25
8226,32,21,9,0,2,30
8227,31,4,16,0,11,20
8228,40,2,32,0,6,34
8229,16,2,9,1,4,12
8230,45,28,8,2,7,38
8231,68,35,17,0,16,52
8232,87,47,24,4,12,75
8233,61,33,18,0,10,51
8234,53,20,24,0,9,44
8235,23,8,12,1,2,21
8236,61,11,30,4,16,45
8237,54,31,7,0,16,38
8238,51,27,11,1,12,39
8239,34,0,28,0,6,28
8240,16,8,4,0,4,12
8241,63,37,14,0,12,51
8242,66,31,9,12,14,52
8243,0,0,0,0,0,0
8244,66,40,15,1,10,56
8245,134,104,11,0,19,115
8246,36,23,7,0,6,30
8247,31,21,1,0,9,22
8248,26,7,15,0,4,22
8249,91,57,18,2,14,77
8250,137,85,26,3,23,114
8251,60,27,14,4,15,45
8252,138,54,29,25,30,108
8253,64,33,15,0,16,48
8254,36,20,10,0,6,30
8255,47,15,17,0,15,32
8256,44,10,21,0,13,31
8257,46,18,20,0,8,38
8258,127,72,21,6,28,99
8259,21,11,6,0,4,17
8260,278,175,42,0,61,217
8261,63,32,10,6,15,48
8262,222,91,40,38,53,169
8263,86,36,31,3,16,70
8264,358,162,121,6,69,289
8265,210,48,124,0,38,172
8266,109,54,37,1,17,92
8267,65,51,2,0,12,53
8268,360,209,76,0,75,285
8269,57,32,15,0,10,47
8270,36,18,5,8,5,31
8271,27,5,14,4,4,23
8272,18,7,4,2,5,13
8273,222,154,22,0,46,176
8274,48,23,20,0,5,43
8275,41,3,29,2,7,34
8276,104,38,35,6,25,79
8277,62,38,14,10,0,62
8278,492,265,84,42,101,391
8279,33,14,11,0,8,25
8280,107,35,43,10,19,88
8281,212,161,8,0,43,169
8282,53,36,2,0,15,38
8283,106,40,33,9,24,82
8284,204,97,61,1,45,159
8285,128,57,27,17,27,101
8286,38,21,7,3,7,31
8287,152,75,28,21,28,124
8288,97,37,35,5,20,77
8289,32,10,7,5,10,22
8290,211,143,49,4,15,196
8291,46,18,20,0,8,38
8292,36,7,21,0,8,28
8293,136,52,45,14,25,111
8294,104,43,23,14,24,80
8295,32,21,9,0,2,30
8296,122,2,101,0,19,103
8297,46,13,10,13,10,36
8298,218,90,43,28,57,161
8299,495,263,85,48,99,396
8300,54,44,2,0,8,46
8301,149,74,20,23,32,117
8302,22,4,14,0,4,18
8303,82,22,41,2,17,65
8304,88,55,17,4,12,76
8305,38,10,15,6,7,31
8306,108,51,17,24,16,92
8307,50,14,15,13,8,42
8308,143,80,13,24,26,117
8309,57,40,3,0,14,43
8310,25,12,8,0,5,20
8311,73,17,36,8,12,61
8312,37,21,6,2,8,29
8313,81,31,24,9,17,64
8314,386,222,85,0,79,307
8315,38,13,15,0,10,28
8316,24,6,12,0,6,18
8317,116,47,29,16,24,92
8318,359,164,120,6,69,290
8319,17,8,6,0,3,14
8320,56,16,27,0,13,43
8321,168,99,38,1,30,138
8322,32,21,9,0,2,30
8323,5,5,0,0,0,5
8324,39,7,26,4,2,37
8325,14,5,3,2,4,10
8326,26,8,8,0,10,16
8327,54,12,28,0,14,40
8328,27,11,11,0,5,22
8329,0,0,0,0,0,0
8330,63,7,51,0,5,58
8331,96,51,12,17,16,80
8332,75,18,33,0,24,51
8333,258,56,132,5,65,193
8334,410,217,103,21,69,341
8335,90,48,20,0,22,68
8336,215,60,107,1,47,168
8337,115,46,39,0,30,85
8338,429,201,142,12,74,355
8339,438,207,142,12,77,361
8340,84,23,37,9,15,69
8341,120,54,49,3,14,106
8342,78,22,41,2,13,65
8343,673,390,138,21,124,549
8344,96,52,23,4,17,79
8345,54,26,21,0,7,47
8346,180,103,15,21,41,139
8347,40,20,10,3,7,33
8348,36,18,11,2,5,31
8349,65,28,20,1,16,49
8350,12,0,10,0,2,10
8351,600,417,52,1,130,470
8352,132,102,10,0,20,112
8353,79,40,22,6,11,68
8354,36,18,10,0,8,28
8355,38,5,24,0,9,29
8356,210,64,101,10,35,175
8357,86,51,19,4,12,74
8358,17,4,11,0,2,15
8359,36,15,13,1,7,29
8360,21,6,10,3,2,19
8361,221,73,83,15,50,171
8362,190,58,80,13,39,151
8363,46,7,29,0,10,36
8364,17,5,4,5,3,14
8365,87,35,31,7,14,73
8366,181,93,54,5,29,152
8367,57,25,21,1,10,47
8368,136,101,9,0,26,110
8369,376,170,124,11,71,305
8370,121,64,10,23,24,97
8371,375,278,19,2,76,299
8372,13,2,8,0,3,10
8373,181,94,48,9,30,151
8374,34,8,17,3,6,28
8375,33,24,5,4,0,33
8376,549,315,105,10,119,430
8377,110,61,14,12,23,87
8378,17,4,11,0,2,15
8379,99,64,10,2,23,76
8380,308,89,149,5,65,243
8381,26,14,4,4,4,22
8382,101,46,15,25,15,86
8383,45,30,5,0,10,35
8384,173,138,11,1,23,150
8385,90,53,19,4,14,76
8386,193,76,34,33,50,143
8387,79,15,44,3,17,62
8388,23,8,12,0,3,20
8389,13,8,1,0,4,9
8390,2,0,2,0,0,2
8391,52,21,12,7,12,40
8392,86,31,40,5,10,76
8393,43,25,11,0,7,36
8394,99,49,27,5,18,81
8395,49,18,25,0,6,43
8396,96,61,2,11,22,74
8397,114,68,23,0,23,91
8398,122,53,42,4,23,99
8399,262,135,92,0,35,227
8400,19,2,12,0,5,14
8401,155,91,28,0,36,119
8402,48,16,24,0,8,40
8403,71,46,6,1,18,53
8404,51,23,19,0,9,42
8405,98,64,9,2,23,75
8406,95,51,23,4,17,78
8407,99,36,22,22,19,80
8408,41,19,12,0,10,31
8409,32,21,9,0,2,30
8410,23,8,10,1,4,19
8411,4,1,2,0,1,3
8412,104,78,12,8,6,98
8413,40,12,6,12,10,30
8414,59,7,34,2,16,43
8415,75,37,16,8,14,61
8416,68,34,19,1,14,54
8417,97,7,66,5,19,78
8418,6,2,4,0,0,6
8419,361,209,79,16,57,304
8420,77,10,44,4,19,58
8421,48,21,14,1,12,36
8422,77,51,15,1,10,67
8423,86,39,29,7,11,75
8424,66,18,31,2,15,51
8425,155,64,36,22,33,122
8426,46,18,20,0,8,38
8427,74,42,21,0,11,63
8428,306,154,86,15,51,255
8429,16,5,11,0,0,16
8430,8,2,0,4,2,6
8431,66,34,19,2,11,55
8432,32,21,9,0,2,30
8433,67,38,3,13,13,54
8434,64,36,13,0,15,49
8435,277,105,111,15,46,231
8436,92,66,7,0,19,73
8437,163,98,42,13,10,153
8438,5,4,1,0,0,5
8439,121,31,64,0,26,95
8440,50,9,32,2,7,43
8441,166,98,38,1,29,137
8442,209,145,47,3,14,195
8443,134,99,8,2,25,109
8444,5,1,2,0,2,3
8445,76,10,42,5,19,57
8446,45,22,8,5,10,35
8447,97,50,28,1,18,79
8448,21,12,3,0,6,15
8449,53,25,19,0,9,44
8450,127,47,27,21,32,95
8451,139,65,36,0,38,101
8452,35,7,19,4,5,30
8453,87,77,2,8,0,87
8454,255,169,66,2,18,237
8455,27,6,16,2,3,24
8456,265,75,138,1,51,214
8457,119,53,47,5,14,105
8458,79,41,15,8,15,64
8459,15,7,6,0,2,13
8460,46,18,20,0,8,38
8461,14,4,4,3,3,11
8462,95,47,18,5,25,70
8463,55,36,4,5,10,45
8464,654,383,142,17,112,542
8465,199,89,52,20,38,161
8466,347,150,123,6,68,279
8467,127,42,46,14,25,102
8468,24,2,17,0,5,19
8469,31,11,13,0,7,24
8470,32,18,12,0,2,30
8471,207,55,53,59,40,167
8472,252,187,13,0,52,200
8473,129,46,28,24,31,98
8474,98,56,25,13,4,94
8475,151,61,32,27,31,120
8476,67,30,28,0,9,58
8477,253,190,15,0,48,205
8478,127,74,22,3,28,99
8479,19,9,4,1,5,14
8480,32,23,4,0,5,27
8481,135,52,53,7,23,112
8482,43,4,30,2,7,36
8483,32,21,9,0,2,30
8484,46,18,20,0,8,38
8485,46,21,16,0,9,37
8486,143,67,43,10,23,120
8487,73,63,2,0,8,65
8488,63,40,7,2,14,49
8489,52,23,19,2,8,44
8490,64,29,14,8,13,51
8491,135,27,71,1,36,99
8492,26,15,3,5,3,23
8493,51,29,6,6,10,41
8494,407,102,173,42,90,317
8495,203,121,63,4,15,188
8496,94,33,37,11,13,81
8497,344,147,120,6,71,273
8498,75,29,22,1,23,52
8499,46,18,20,0,8,38
8500,41,1,35,0,5,36
8501,4,1,2,0,1,3
8502,100,66,9,6,19,81
8503,123,36,62,1,24,99
8504,210,87,53,25,45,165
8505,157,91,28,1,37,120
8506,11,7,0,0,4,7
8507,24,17,1,0,6,18
8508,72,36,25,0,11,61
8509,19,11,7,1,0,19
8510,461,218,143,13,87,374
8511,53,17,22,4,10,43
8512,84,33,33,0,18,66
8513,31,22,1,0,8,23
8514,75,21,34,2,18,57
8515,68,44,12,0,12,56
8516,47,25,3,11,8,39
8517,120,61,22,11,26,94
8518,15,6,4,0,5,10
8519,64,1,55,0,8,56
8520,12,0,11,0,1,11
8521,142,49,62,6,25,117
8522,15,0,11,0,4,11
8523,42,11,22,0,9,33
8524,20,11,2,0,7,13
8525,89,52,20,0,17,72
8526,32,8,10,7,7,25
8527,36,14,18,0,4,32
8528,362,218,62,11,71,291
8529,42,30,9,3,0,42
8530,42,20,10,2,10,32
8531,32,21,9,0,2,30
8532,156,117,9,4,26,130
8533,81,30,25,1,25,56
8534,86,25,32,12,17,69
8535,125,98,2,2,23,102
8536,53,29,17,1,6,47
8537,408,116,187,9,96,312
8538,25,5,1,15,4,21
8539,52,41,1,0,10,42
8540,52,13,31,0,8,44
8541,105,52,32,0,21,84
8542,34,5,23,0,6,28
8543,8,5,2,0,1,7
8544,109,42,31,13,23,86
8545,14,10,0,0,4,10
8546,93,53,20,7,13,80
8547,139,59,31,23,26,113
8548,161,33,101,0,27,134
8549,66,33,24,0,9,57
8550,127,92,5,2,28,99
8551,236,68,114,15,39,197
8552,496,362,29,1,104,392
8553,35,18,9,0,8,27
8554,56,19,31,0,6,50
8555,37,3,25,3,6,31
8556,138,50,51,14,23,115
8557,3,0,2,0,1,2
8558,24,9,7,2,6,18
8559,100,63,23,0,14,86
8560,56,11,23,8,14,42
8561,3,1,0,0,2,1
8562,21,13,2,1,5,16
8563,30,5,16,1,8,22
8564,49,24,20,0,5,44
8565,579,409,47,1,122,457
8566,140,49,35,20,36,104
8567,141,85,22,2,32,109
8568,54,20,20,1,13,41
8569,7,5,2,0,0,7
8570,301,140,96,11,54,247
8571,46,18,20,0,8,38
8572,61,46,3,2,10,51
8573,85,43,21,1,20,65
8574,47,33,2,3,9,38
8575,34,15,4,6,9,25
8576,155,98,32,1,24,131
8577,68,50,4,0,14,54
8578,336,153,112,6,65,271
8579,19,12,4,0,3,16
8580,91,59,15,0,17,74
8581,28,6,16,0,6,22
8582,43,14,16,6,7,36
8583,61,40,10,1,10,51
8584,11,4,6,0,1,10
8585,30,5,20,0,5,25
8586,27,15,10,1,1,26
8587,45,16,15,0,14,31
8588,65,37,8,9,11,54
8589,95,21,39,12,23,72
8590,16,5,7,0,4,12
8591,28,15,9,0,4,24
8592,26,19,3,1,3,23
8593,107,77,12,0,18,89
8594,105,30,55,0,20,85
8595,171,82,54,3,32,139
8596,205,54,23,96,32,173
8597,24,6,16,0,2,22
8598,40,19,9,3,9,31
8599,447,301,45,2,99,348
8600,207,130,61,3,13,194
8601,65,44,7,0,14,51
8602,205,114,43,12,36,169
8603,32,21,9,0,2,30
8604,128,52,33,19,24,104
8605,159,71,52,6,30,129
8606,42,5,26,0,11,31
8607,50,20,23,0,7,43
8608,19,8,8,1,2,17
8609,278,93,126,14,45,233
8610,236,156,34,0,46,190
8611,108,47,22,15,24,84
8612,104,27,39,13,25,79
8613,66,23,6,22,15,51
8614,86,56,15,0,15,71
8615,111,65,22,7,17,94
8616,27,8,11,2,6,21
8617,123,45,42,12,24,99
8618,352,188,93,15,56,296
8619,48,34,3,0,11,37
8620,127,41,46,6,34,93
8621,47,27,13,1,6,41
8622,470,214,160,11,85,385
8623,295,36,202,2,55,240
8624,71,45,11,2,13,58
8625,53,31,14,0,8,45
8626,113,39,52,4,18,95
8627,18,0,14,0,4,14
8628,42,12,10,14,6,36
8629,67,37,23,2,5,62
8630,88,25,36,9,18,70
8631,432,196,139,9,88,344
8632,299,127,107,6,59,240
8633,16,0,14,0,2,14
8634,502,272,113,17,100,402
8635,102,68,1,11,22,80
8636,67,15,40,1,11,56
8637,76,59,9,7,1,75
8638,13,3,7,0,3,10
8639,40,5,29,0,6,34
8640,51,27,10,2,12,39
8641,110,64,9,11,26,84
8642,81,27,34,4,16,65
8643,64,48,12,0,4,60
8644,15,6,4,0,5,10
8645,12,5,7,0,0,12
8646,68,38,18,1,11,57
8647,132,54,34,19,25,107
8648,78,31,22,12,13,65
8649,56,12,20,6,18,38
8650,126,75,39,0,12,114
8651,15,6,3,0,6,9
8652,122,25,45,30,22,100
8653,60,28,16,2,14,46
8654,149,67,31,18,33,116
8655,67,26,26,0,15,52
8656,27,14,10,2,1,26
8657,18,6,7,1,4,14
8658,63,21,27,1,14,49
8659,150,101,18,0,31,119
8660,39,15,18,0,6,33
8661,85,49,16,6,14,71
8662,172,98,20,18,36,136
8663,61,45,2,0,14,47
8664,4,2,1,0,1,3
8665,160,114,11,0,35,125
8666,39,13,19,0,7,32
8667,95,38,28,10,19,76
8668,146,102,17,0,27,119
8669,32,1,24,1,6,26
8670,112,39,50,0,23,89
8671,121,58,29,8,26,95
8672,11,1,7,0,3,8
8673,262,182,58,3,19,243
8674,160,58,52,24,26,134
8675,38,13,20,1,4,34
8676,110,104,0,6,0,110
8677,250,120,73,5,52,198
8678,104,47,18,15,24,80
8679,503,267,90,43,103,400
8680,46,12,25,0,9,37
8681,232,114,62,0,56,176
8682,68,6,23,28,11,57
8683,65,48,4,0,13,52
8684,67,29,24,4,10,57
8685,26,14,7,0,5,21
8686,65,33,23,2,7,58
8687,113,44,41,10,18,95
8688,109,66,9,10,24,85
8689,44,29,6,1,8,36
8690,80,49,15,3,13,67
8691,52,32,9,4,7,45
8692,225,132,19,26,48,177
8693,11,3,4,0,4,7
8694,20,10,10,0,0,20
8695,95,62,9,4,20,75
8696,231,80,86,15,50,181
8697,61,15,29,8,9,52
8698,203,110,41,15,37,166
8699,53,42,1,0,10,43
8700,34,9,17,4,4,30
8701,105,28,40,12,25,80
8702,5,0,4,0,1,4
8703,32,21,9,0,2,30
8704,83,38,23,3,19,64
8705,98,26,56,2,14,84
8706,124,97,6,0,21,103
8707,27,17,4,3,3,24
8708,14,3,7,2,2,12
8709,7,7,0,0,0,7
8710,85,33,41,1,10,75
8711,46,18,20,0,8,38
8712,203,86,48,24,45,158
8713,27,13,11,2,1,26
8714,59,28,11,4,16,43
8715,48,10,26,0,12,36
8716,104,37,45,4,18,86
8717,27,14,10,0,3,24
8718,112,63,24,7,18,94
8719,26,0,22,0,4,22
8720,14,8,4,0,2,12
8721,38,23,4,2,9,29
8722,7,1,2,0,4,3
8723,152,53,49,24,26,126
8724,32,21,9,0,2,30
8725,17,2,12,0,3,14
8726,22,7,6,0,9,13
8727,85,25,18,22,20,65
8728,32,7,16,0,9,23
8729,13,2,8,1,2,11
8730,49,29,12,8,0,49
8731,46,18,20,0,8,38
8732,62,25,8,12,17,45
8733,17,7,6,0,4,13
8734,142,48,54,7,33,109
8735,101,78,3,0,20,81
8736,121,58,25,16,22,99
8737,57,35,13,2,7,50
8738,23,6,9,2,6,17
8739,193,107,42,0,44,149
8740,58,9,34,5,10,48
8741,55,24,13,6,12,43
8742,76,47,8,1,20,56
8743,429,124,165,46,94,335
8744,28,18,5,5,0,28
8745,21,3,10,1,7,14
8746,106,30,48,7,21,85
8747,56,23,22,1,10,46
8748,47,33,9,0,5,42
8749,32,21,9,0,2,30
8750,30,7,14,1,8,22
8751,95,53,24,0,18,77
8752,24,7,7,0,10,14
8753,219,89,73,19,38,181
8754,67,26,26,4,11,56
8755,41,35,3,0,3,38
8756,33,16,4,6,7,26
8757,156,75,49,1,31,125
8758,166,112,27,0,27,139
8759,163,81,48,1,33,130
8760,45,22,7,3,13,32
8761,51,26,15,1,9,42
8762,193,76,35,34,48,145
8763,126,75,20,3,28,98
8764,91,52,26,10,3,88
8765,35,10,19,3,3,32
8766,8,4,4,0,0,8
8767,15,3,8,0,4,11
8768,132,80,26,0,26,106
8769,74,37,17,4,16,58
8770,16,0,14,0,2,14
8771,42,21,12,0,9,33
8772,13,1,8,0,4,9
8773,28,9,12,0,7,21
8774,15,5,7,0,3,12
8775,35,9,14,1,11,24
8776,106,35,35,10,26,80
8777,32,15,8,4,5,27
8778,43,24,10,0,9,34
8779,132,78,29,0,25,107
8780,110,49,36,3,22,88
8781,21,7,1,7,6,15
8782,84,28,27,5,24,60
8783,43,2,25,12,4,39
8784,26,3,13,1,9,17
8785,49,27,11,0,11,38
8786,79,50,12,2,15,64
8787,86,31,24,9,22,64
8788,48,28,10,0,10,38
8789,168,75,52,8,33,135
8790,102,48,34,4,16,86
8791,32,21,9,0,2,30
8792,48,32,9,1,6,42
8793,57,1,43,0,13,44
8794,45,18,20,0,7,38
8795,207,148,12,7,40,167
8796,502,224,117,47,114,388
8797,46,18,20,0,8,38
8798,266,197,15,0,54,212
8799,64,30,20,1,13,51
8800,159,99,33,1,26,133
8801,5,2,3,0,0,5
8802,360,195,91,15,59,301
8803,55,33,10,0,12,43
8804,32,15,4,5,8,24
8805,23,11,9,1,2,21
8806,80,39,27,0,14,66
8807,75,24,31,4,16,59
8808,91,49,12,16,14,77
8809,100,56,19,5,20,80
8810,37,15,5,8,9,28
8811,46,18,20,0,8,38
8812,25,14,7,0,4,21
8813,102,28,48,8,18,84
8814,61,30,13,3,15,46
8815,286,147,79,12,48,238
8816,30,7,20,0,3,27
8817,428,104,183,45,96,332
8818,19,3,10,0,6,13
8819,19,8,8,1,2,17
8820,34,8,15,2,9,25
8821,19,12,1,6,0,19
8822,39,20,11,3,5,34
8823,115,70,22,0,23,92
8824,258,115,83,17,43,215
8825,102,31,49,0,22,80
8826,35,21,4,4,6,29
8827,49,32,6,2,9,40
8828,201,110,47,4,40,161
8829,8,3,4,0,1,7
8830,14,7,4,1,2,12
8831,5,2,3,0,0,5
8832,44,22,15,0,7,37
8833,26,9,14,0,3,23
8834,7,2,3,0,2,5
8835,22,6,10,1,5,17
8836,9,4,2,0,3,6
8837,39,4,27,0,8,31
8838,8,5,0,0,3,5
8839,33,17,12,0,4,29
8840,130,62,35,5,28,102
8841,132,45,65,0,22,110
8842,14,3,9,0,2,12
8843,24,11,2,2,9,15
8844,9,5,3,0,1,8
8845,32,21,9,0,2,30
8846,433,246,98,0,89,344
8847,155,52,42,31,30,125
8848,86,39,33,4,10,76
8849,14,8,0,2,4,10
8850,207,144,25,2,36,171
8851,71,30,15,13,13,58
8852,14,6,5,1,2,12
8853,347,151,121,6,69,278
8854,248,105,95,2,46,202
8855,162,81,47,2,32,130
8856,161,46,87,0,28,133
8857,100,46,25,12,17,83
8858,48,29,7,0,12,36
8859,59,11,38,0,10,49
8860,32,21,9,0,2,30
8861,254,19,187,1,47,207
8862,107,37,27,23,20,87
8863,47,15,24,1,7,40
8864,111,53,15,21,22,89
8865,74,50,7,0,17,57
8866,73,63,2,0,8,65
8867,109,39,42,10,18,91
8868,52,35,3,0,14,38
8869,51,4,34,1,12,39
8870,7,2,4,0,1,6
8871,119,53,18,17,31,88
8872,81,19,40,5,17,64
8873,63,37,11,2,13,50
8874,460,231,115,17,97,363
8875,80,45,14,4,17,63
8876,115,56,34,3,22,93
8877,13,6,5,0,2,11
8878,26,19,3,1,3,23
8879,43,13,15,8,7,36
8880,566,392,51,1,122,444
8881,15,3,11,0,1,14
8882,218,147,30,0,41,177
8883,78,49,12,0,17,61
8884,39,17,10,1,11,28
8885,62,30,20,0,12,50
8886,370,164,112,11,83,287
8887,79,52,15,0,12,67
8888,64,44,8,0,12,52
8889,11,8,0,0,3,8
8890,29,12,12,0,5,24
8891,19,4,4,8,3,16
8892,16,10,3,1,2,14
8893,90,43,30,1,16,74
8894,39,26,5,0,8,31
8895,27,12,9,0,6,21
8896,30,12,10,1,7,23
8897,55,33,10,0,12,43
8898,35,22,8,1,4,31
8899,123,89,9,0,25,98
8900,70,51,7,2,10,60
8901,69,4,48,0,17,52
8902,80,38,5,15,22,58
8903,13,4,6,0,3,10
8904,162,12,92,26,32,130
8905,46,10,23,0,13,33
8906,139,47,42,22,28,111
8907,95,56,20,0,19,76
8908,42,10,22,3,7,35
8909,30,10,16,0,4,26
8910,46,18,20,0,8,38
8911,153,119,1,1,32,121
8912,55,37,5,0,13,42
8913,124,83,21,0,20,104
8914,25,10,8,5,2,23
8915,37,18,14,0,5,32
8916,77,57,7,0,13,64
8917,88,31,38,2,17,71
8918,164,62,55,21,26,138
8919,150,42,80,2,26,124
8920,138,63,46,0,29,109
8921,112,45,16,17,34,78
8922,41,22,12,0,7,34
8923,49,29,12,0,8,41
8924,63,21,27,1,14,49
8925,34,4,15,6,9,25
8926,19,13,3,0,3,16
8927,274,16,205,0,53,221
8928,164,76,31,27,30,134
8929,7,2,3,0,2,5
8930,35,23,8,0,4,31
8931,23,8,10,0,5,18
8932,39,24,10,5,0,39
8933,65,37,13,2,13,52
8934,84,65,4,4,11,73
8935,8,0,6,0,2,6
8936,7,2,3,0,2,5
8937,12,4,3,2,3,9
8938,111,78,14,10,9,102
8939,30,14,9,4,3,27
8940,137,73,33,0,31,106
8941,228,170,8,1,49,179
8942,40,13,14,5,8,32
8943,86,23,48,2,13,73
8944,452,226,110,20,96,356
8945,111,49,28,2,32,79
8946,63,47,12,0,4,59
8947,45,15,18,0,12,33
8948,344,250,16,2,76,268
8949,39,8,22,2,7,32
8950,477,130,202,38,107,370
8951,227,157,50,2,18,209
8952,32,11,15,0,6,26
8953,127,78,24,0,25,102
8954,62,41,5,1,15,47
8955,173,59,84,0,30,143
8956,96,46,21,4,25,71
8957,25,9,12,0,4,21
8958,31,4,19,0,8,23
8959,90,64,15,1,10,80
8960,277,18,204,2,53,224
8961,158,100,31,0,27,131
8962,54,35,5,5,9,45
8963,123,40,44,6,33,90
8964,45,19,12,8,6,39
8965,26,15,4,0,7,19
8966,110,83,7,13,7,103
8967,54,32,14,0,8,46
8968,6,4,2,0,0,6
8969,65,38,12,1,14,51
8970,78,44,18,2,14,64
8971,76,26,34,0,16,60
8972,325,194,61,0,70,255
8973,154,97,29,1,27,127
8974,135,75,22,4,34,101
8975,93,33,38,10,12,81
8976,29,8,11,2,8,21
8977,33,12,12,2,7,26
8978,67,36,18,3,10,57
8979,77,21,37,5,14,63
8980,62,36,14,3,9,53
8981,99,44,33,4,18,81
8982,444,139,192,15,98,346
8983,30,8,18,0,4,26
8984,37,21,3,0,13,24
8985,58,9,29,5,15,43
8986,16,7,9,0,0,16
8987,90,56,11,2,21,69
8988,67,31,22,0,14,53
8989,343,145,121,6,71,272
8990,203,84,36,33,50,153
8991,13,3,8,1,1,12
8992,270,141,94,0,35,235
8993,62,37,14,1,10,52
8994,12,6,4,2,0,12
8995,29,4,15,2,8,21
8996,253,131,84,0,38,215
8997,27,11,12,0,4,23
8998,192,48,31,82,31,161
8999,75,8,43,5,19,56
9000,105,45,22,18,20,85
9001,124,61,27,14,22,102
9002,116,68,24,0,24,92
9003,13,11,1,0,1,12
9004,118,60,36,0,22,96
9005,277,142,94,0,41,236
9006,66,22,27,3,14,52
9007,411,298,27,0,86,325
9008,38,24,8,0,6,32
9009,650,406,91,8,145,505
9010,118,48,44,1,25,93
9011,76,21,27,12,16,60
9012,32,14,9,0,9,23
9013,35,23,6,0,6,29
9014,114,78,17,1,18,96
9015,66,31,12,9,14,52
9016,1292,524,178,336,254,1038
9017,76,50,15,1,10,66
9018,129,94,17,0,18,111
9019,19,8,5,0,6,13
9020,126,63,41,11,11,115
9021,41,32,3,0,6,35
9022,56,11,5,31,9,47
9023,88,39,34,1,14,74
9024,25,10,13,0,2,23
9025,10,4,3,0,3,7
9026,197,124,56,4,13,184
9027,17,5,6,0,6,11
9028,37,4,19,4,10,27
9029,277,30,194,2,51,226
9030,47,16,13,3,15,32
9031,38,18,15,0,5,33
9032,15,8,1,6,0,15
9033,45,16,23,0,6,39
9034,116,43,35,14,24,92
9035,26,14,5,0,7,19
9036,60,30,11,2,17,43
9037,50,22,10,6,12,38
9038,9,2,2,0,5,4
9039,46,32,8,1,5,41
9040,188,108,22,23,35,153
9041,68,31,18,0,19,49
9042,31,2,21,0,8,23
9043,249,113,67,24,45,204
9044,10,0,9,0,1,9
9045,28,14,10,0,4,24
9046,14,9,3,0,2,12
9047,171,56,78,0,37,134
9048,28,16,4,0,8,20
9049,39,22,11,0,6,33
9050,58,45,1,0,12,46
9051,76,39,25,4,8,68
9052,446,218,131,13,84,362
9053,99,47,11,20,21,78
9054,31,12,15,0,4,27
9055,85,53,15,3,14,71
9056,230,100,15,76,39,191
9057,54,29,17,0,8,46
9058,86,51,20,0,15,71
9059,84,37,31,3,13,71
9060,32,21,9,0,2,30
9061,109,55,16,15,23,86
9062,7,4,2,0,1,6
9063,68,24,13,15,16,52
9064,30,7,16,2,5,25
9065,44,9,27,1,7,37
9066,29,12,8,4,5,24
9067,30,12,13,0,5,25
9068,4,0,4,0,0,4
9069,140,98,17,1,24,116
9070,119,60,29,6,24,95
9071,32,21,9,0,2,30
9072,8,4,4,0,0,8
9073,92,26,48,4,14,78
9074,288,149,79,12,48,240
9075,6,1,3,0,2,4
9076,512,270,86,49,107,405
9077,29,12,14,0,3,26
9078,2,2,0,0,0,2
9079,34,15,14,0,5,29
9080,39,10,23,0,6,33
9081,5,2,2,0,1,4
9082,138,83,15,21,19,119
9083,51,35,6,4,6,45
9084,635,400,83,8,144,491
9085,26,19,3,1,3,23
9086,31,6,14,1,10,21
9087,46,20,18,0,8,38
9088,481,224,106,53,98,383
9089,26,15,6,1,4,22
9090,233,155,32,0,46,187
9091,123,46,29,16,32,91
9092,30,10,14,1,5,25
9093,174,119,16,0,39,135
9094,179,47,19,84,29,150
9095,37,7,21,1,8,29
9096,213,119,45,12,37,176
9097,80,27,36,4,13,67
9098,43,19,17,0,7,36
9099,92,33,32,2,25,67
9100,295,120,122,3,50,245
9101,462,230,89,44,99,363
9102,10,4,3,0,3,7
9103,127,47,26,22,32,95
9104,220,73,82,15,50,170
9105,25,7,12,2,4,21
9106,57,11,31,1,14,43
9107,24,15,3,1,5,19
9108,5,0,3,0,2,3
9109,48,34,11,3,0,48
9110,49,9,29,1,10,39
9111,30,16,1,6,7,23
9112,73,26,27,6,14,59
9113,130,87,18,1,24,106
9114,11,8,3,0,0,11
9115,50,10,31,0,9,41
9116,71,45,15,0,11,60
9117,137,81,23,4,29,108
9118,504,261,88,49,106,398
9119,14,4,6,2,2,12
9120,18,5,8,0,5,13
9121,44,24,12,0,8,36
9122,75,23,27,10,15,60
9123,219,75,81,14,49,170
9124,135,54,40,15,26,109
9125,104,43,26,13,22,82
9126,75,42,14,1,18,57
9127,294,214,21,0,59,235
9128,47,22,14,3,8,39
9129,112,41,46,6,19,93
9130,33,8,17,4,4,29
9131,29,13,10,0,6,23
9132,86,56,15,0,15,71
9133,8,3,3,2,0,8
9134,25,13,10,0,2,23
9135,493,339,46,1,107,386
9136,124,39,51,7,27,97
9137,32,21,9,0,2,30
9138,24,12,6,1,5,19
9139,56,29,10,4,13,43
9140,163,69,38,17,39,124
9141,19,6,6,4,3,16
9142,48,13,28,1,6,42
9143,82,24,22,15,21,61
9144,73,19,24,12,18,55
9145,61,17,23,8,13,48
9146,46,18,20,0,8,38
9147,98,24,52,3,19,79
9148,14,8,4,0,2,12
9149,123,60,28,13,22,101
9150,47,28,10,0,9,38
9151,3,1,1,0,1,2
9152,498,311,78,3,106,392
9153,163,110,27,0,26,137
9154,109,38,48,4,19,90
9155,167,78,37,16,36,131
9156,72,32,13,9,18,54
9157,15,9,4,0,2,13
9158,200,110,28,23,39,161
9159,111,38,27,25,21,90
9160,40,22,6,2,10,30
9161,103,65,10,5,23,80
9162,46,18,20,0,8,38
9163,323,150,92,13,68,255
9164,143,48,72,0,23,120
9165,19,14,3,0,2,17
9166,139,104,4,2,29,110
9167,51,23,16,1,11,40
9168,13,2,6,0,5,8
9169,354,206,73,0,75,279
9170,638,357,155,23,103,535
9171,127,75,21,3,28,99
9172,98,38,35,0,25,73
9173,100,46,15,24,15,85
9174,66,11,43,1,11,55
9175,83,67,2,0,14,69
9176,28,17,3,0,8,20
9177,32,21,9,0,2,30
9178,39,22,12,0,5,34
9179,75,20,37,3,15,60
9180,84,40,24,1,19,65
9181,176,10,132,0,34,142
9182,57,18,20,2,17,40
9183,222,131,18,26,47,175
9184,9,4,2,1,2,7
9185,132,54,42,8,28,104
9186,15,3,7,0,5,10
9187,83,23,36,9,15,68
9188,59,17,29,0,13,46
9189,217,157,23,1,36,181
9190,386,124,168,10,84,302
9191,27,12,11,0,4,23
9192,35,10,14,0,11,24
9193,20,9,9,0,2,18
9194,140,41,52,14,33,107
9195,111,55,36,0,20,91
9196,58,36,10,4,8,50
9197,55,40,5,0,10,45
9198,22,11,8,0,3,19
9199,11,3,8,0,0,11
9200,45,15,19,0,11,34
9201,115,24,43,22,26,89
9202,12,7,2,0,3,9
9203,30,8,17,1,4,26
9204,55,26,13,9,7,48
9205,110,105,0,5,0,110
9206,348,155,121,11,61,287
9207,78,41,8,18,11,67
9208,102,35,28,15,24,78
9209,100,65,10,2,23,77
9210,49,10,28,1,10,39
9211,41,21,3,2,15,26
9212,30,16,5,1,8,22
9213,189,103,55,0,31,158
9214,247,172,21,4,50,197
9215,116,63,10,15,28,88
9216,32,21,9,0,2,30
9217,17,7,8,0,2,15
9218,76,46,18,0,12,64
9219,117,26,44,25,22,95
9220,132,88,22,0,22,110
9221,36,12,14,2,8,28
9222,100,30,51,0,19,81
9223,14,5,3,3,3,11
9224,44,10,23,0,11,33
9225,21,3,10,0,8,13
9226,25,4,1,16,4,21
9227,50,16,20,2,12,38
9228,14,6,5,0,3,11
9229,154,101,30,0,23,131
9230,78,46,20,0,12,66
9231,55,24,18,0,13,42
9232,8,0,5,0,3,5
9233,46,18,20,0,8,38
9234,24,9,12,0,3,21
9235,75,40,21,0,14,61
9236,50,35,2,1,12,38
9237,98,44,12,15,27,71
9238,70,22,30,2,16,54
9239,293,114,104,21,54,239
9240,195,49,105,6,35,160
9241,78,13,41,7,17,61
9242,198,95,59,1,43,155
9243,379,164,135,10,70,309
9244,5,3,1,0,1,4
9245,120,81,20,9,10,110
9246,52,31,8,2,11,41
9247,71,30,28,2,11,60
9248,63,42,6,1,14,49
9249,93,26,42,0,25,68
9250,126,51,54,0,21,105
9251,39,2,29,1,7,32
9252,69,15,32,3,19,50
9253,56,14,34,0,8,48
9254,77,21,41,2,13,64
9255,7,3,2,1,1,6
9256,81,45,19,2,15,66
9257,231,157,32,0,42,189
9258,70,4,47,4,15,55
9259,116,68,22,7,19,97
9260,96,21,44,13,18,78
9261,52,25,13,1,13,39
9262,10,6,4,0,0,10
9263,15,12,1,0,2,13
9264,94,38,27,10,19,75
9265,36,15,11,4,6,30
9266,21,1,15,0,5,16
9267,189,137,14,2,36,153
9268,46,28,10,0,8,38
9269,19,6,10,0,3,16
9270,219,148,30,0,41,178
9271,45,24,2,11,8,37
9272,49,26,7,7,9,40
9273,90,27,46,3,14,76
9274,31,19,3,0,9,22
9275,110,66,20,7,17,93
9276,30,10,4,8,8,22
9277,126,62,41,0,23,103
9278,75,19,31,0,25,50
9279,52,31,12,0,9,43
9280,518,373,38,0,107,411
9281,149,110,5,0,34,115
9282,52,31,6,2,13,39
9283,121,43,51,6,21,100
9284,18,8,7,0,3,15
9285,100,30,29,22,19,81
9286,110,39,40,6,25,85
9287,12,7,3,0,2,10
9288,32,10,9,9,4,28
9289,109,50,44,1,14,95
9290,555,324,123,15,93,462
9291,106,38,32,11,25,81
9292,13,5,6,0,2,11
9293,92,32,31,9,20,72
9294,19,10,4,0,5,14
9295,64,42,4,0,18,46
9296,113,51,25,12,25,88
9297,44,6,29,0,9,35
9298,266,181,18,4,63,203
9299,11,2,7,0,2,9
9300,82,46,18,1,17,65
9301,93,51,29,7,6,87
9302,99,71,5,7,16,83
9303,47,11,27,1,8,39
9304,31,10,15,0,6,25
9305,247,104,84,16,43,204
9306,58,23,20,0,15,43
9307,6,6,0,0,0,6
9308,50,25,18,0,7,43
9309,29,20,0,2,7,22
9310,20,15,0,0,5,15
9311,24,9,11,0,4,20
9312,74,17,45,0,12,62
9313,13,3,7,1,2,11
9314,44,35,2,0,7,37
9315,31,0,22,0,9,22
9316,228,120,68,0,40,188
9317,73,39,11,4,19,54
9318,100,35,26,12,27,73
9319,53,26,20,0,7,46
9320,60,24,15,8,13,47
9321,105,81,7,0,17,88
9322,27,15,8,1,3,24
9323,166,98,38,1,29,137
9324,53,22,14,1,16,37
9325,13,8,2,0,3,10
9326,31,0,7,19,5,26
9327,188,39,49,64,36,152
9328,48,16,11,10,11,37
9329,95,91,0,4,0,95
9330,28,19,4,2,3,25
9331,194,129,19,0,46,148
9332,68,32,22,1,13,55
9333,70,42,8,4,16,54
9334,56,16,30,1,9,47
9335,18,7,5,0,6,12
9336,71,14,41,1,15,56
9337,117,57,27,8,25,92
9338,466,275,81,8,102,364
9339,84,43,16,11,14,70
9340,162,85,30,22,25,137
9341,345,177,99,5,64,281
9342,121,29,40,29,23,98
9343,132,28,47,29,28,104
9344,169,82,53,2,32,137
9345,30,12,13,0,5,25
9346,228,172,7,3,46,182
9347,32,21,9,0,2,30
9348,313,188,55,0,70,243
9349,76,50,8,2,16,60
9350,223,141,66,1,15,208
9351,143,105,9,0,29,114
9352,26,11,5,7,3,23
9353,45,10,16,11,8,37
9354,348,204,70,0,74,274
9355,79,51,16,0,12,67
9356,56,29,14,0,13,43
9357,148,51,39,30,28,120
9358,101,61,17,3,20,81
9359,14,7,2,3,2,12
9360,55,16,25,0,14,41
9361,137,102,3,0,32,105
9362,140,65,46,5,24,116
9363,217,54,40,85,38,179
9364,41,16,14,5,6,35
9365,2,0,0,0,2,0
9366,111,73,23,3,12,99
9367,93,37,21,8,27,66
9368,37,10,14,5,8,29
9369,77,46,18,1,12,65
9370,41,13,13,6,9,32
9371,53,0,33,3,17,36
9372,30,12,9,3,6,24
9373,140,55,46,14,25,115
9374,50,17,21,4,8,42
9375,362,216,70,13,63,299
9376,16,6,6,2,2,14
9377,61,33,16,0,12,49
9378,60,14,39,1,6,54
9379,60,42,9,0,9,51
9380,58,46,1,0,11,47
9381,53,21,16,3,13,40
9382,28,7,14,1,6,22
9383,213,114,47,0,52,161
9384,89,31,35,11,12,77
9385,22,20,0,0,2,20
9386,82,15,38,12,17,65
9387,147,60,45,9,33,114
9388,10,4,3,0,3,7
9389,43,9,23,3,8,35
9390,188,57,93,0,38,150
9391,31,9,15,1,6,25
9392,221,60,109,14,38,183
9393,161,130,5,3,23,138
9394,9,5,2,1,1,8
9395,82,44,15,9,14,68
9396,80,61,5,4,10,70
9397,27,7,2,11,7,20
9398,203,66,81,15,41,162
9399,224,103,71,4,46,178
9400,29,11,12,0,6,23
9401,32,18,6,1,7,25
9402,19,8,5,0,6,13
9403,17,0,13,0,4,13
9404,352,185,93,15,59,293
9405,20,7,7,2,4,16
9406,32,21,9,0,2,30
9407,41,17,11,2,11,30
9408,27,15,8,0,4,23
9409,51,36,4,3,8,43
9410,18,8,6,1,3,15
9411,47,15,20,1,11,36
9412,39,23,8,0,8,31
9413,399,234,84,16,65,334
9414,29,7,13,0,9,20
9415,79,30,32,2,15,64
9416,35,17,7,3,8,27
9417,23,0,20,0,3,20
9418,5,1,3,0,1,4
9419,31,19,3,0,9,22
9420,15,3,8,0,4,11
9421,74,24,24,14,12,62
9422,168,86,22,27,33,135
9423,234,100,48,27,59,175
9424,263,101,107,5,50,213
9425,46,9,17,11,9,37
9426,46,18,20,0,8,38
9427,32,21,9,0,2,30
9428,99,32,49,4,14,85
9429,77,47,15,0,15,62
9430,35,27,0,0,8,27
9431,34,7,17,3,7,27
9432,95,35,41,3,16,79
9433,134,54,53,7,20,114
9434,454,141,188,31,94,360
9435,11,8,1,0,2,9
9436,124,57,35,0,32,92
9437,21,14,3,0,4,17
9438,93,44,28,4,17,76
9439,25,18,4,0,3,22
9440,77,38,20,0,19,58
9441,118,46,36,8,28,90
9442,237,175,9,4,49,188
9443,63,29,21,0,13,50
9444,19,2,13,0,4,15
9445,53,12,25,4,12,41
9446,59,34,12,0,13,46
9447,55,38,6,1,10,45
9448,110,27,46,11,26,84
9449,60,20,16,13,11,49
9450,23,15,3,0,5,18
9451,114,54,39,0,21,93
9452,23,15,6,1,1,22
9453,22,3,17,0,2,20
9454,43,20,15,0,8,35
9455,76,27,22,12,15,61
9456,50,27,11,0,12,38
9457,104,29,56,1,18,86
9458,22,15,2,0,5,17
9459,86,56,11,5,14,72
9460,46,18,20,0,8,38
9461,49,27,12,0,10,39
9462,134,58,52,1,23,111
9463,177,70,41,21,45,132
9464,319,136,110,6,67,252
9465,77,18,44,7,8,69
9466,203,51,103,14,35,168
9467,41,20,5,7,9,32
9468,50,29,13,0,8,42
9469,127,92,17,0,18,109
9470,405,228,95,0,82,323
9471,180,139,16,1,24,156
9472,201,54,39,68,40,161
9473,31,4,24,0,3,28
9474,7,3,3,0,1,6
9475,53,27,10,7,9,44
9476,63,28,22,0,13,50
9477,64,19,32,1,12,52
9478,45,6,27,1,11,34
9479,8,4,2,0,2,6
9480,24,8,11,0,5,19
9481,29,23,1,0,5,24
9482,17,8,5,3,1,16
9483,123,67,22,2,32,91
9484,135,91,19,1,24,111
9485,127,75,21,3,28,99
9486,19,14,3,0,2,17
9487,32,21,9,0,2,30
9488,15,2,2,9,2,13
9489,350,188,92,15,55,295
9490,93,71,6,1,15,78
9491,28,7,15,0,6,22
9492,80,46,18,2,14,66
9493,14,9,2,2,1,13
9494,59,22,13,15,9,50
9495,151,98,26,6,21,130
9496,287,160,35,33,59,228
9497,142,108,3,2,29,113
9498,32,20,0,6,6,26
9499,164,51,88,4,21,143
9500,15,2,2,9,2,13
9501,105,50,38,1,16,89
9502,97,26,21,29,21,76
9503,6,4,0,2,0,6
9504,27,15,5,3,4,23
9505,73,29,28,1,15,58
9506,153,52,40,29,32,121
9507,84,36,38,1,9,75
9508,55,23,21,0,11,44
9509,42,33,1,0,8,34
9510,192,58,98,5,31,161
9511,25,11,7,2,5,20
9512,359,119,149,16,75,284
9513,226,74,86,14,52,174
9514,185,106,22,22,35,150
9515,39,5,28,0,6,33
9516,41,15,13,3,10,31
9517,116,85,7,0,24,92
9518,541,375,50,1,115,426
9519,22,10,5,1,6,16
9520,174,69,53,7,45,129
9521,235,155,34,0,46,189
9522,47,29,6,0,12,35
9523,159,80,32,16,31,128
9524,160,69,54,14,23,137
9525,15,5,10,0,0,15
9526,10,5,2,1,2,8
9527,38,17,16,0,5,33
9528,112,40,51,1,20,92
9529,22,13,7,0,2,20
9530,9,6,0,0,3,6
9531,50,26,9,0,15,35
9532,31,19,3,0,9,22
9533,661,365,166,23,107,554
9534,137,93,19,1,24,113
9535,35,16,10,3,6,29
9536,176,58,70,13,35,141
9537,15,5,4,0,6,9
9538,72,11,48,0,13,59
9539,77,10,43,5,19,58
9540,61,34,10,2,15,46
9541,81,37,5,16,23,58
9542,125,65,14,16,30,95
9543,46,29,8,0,9,37
9544,46,18,20,0,8,38
9545,36,8,20,1,7,29
9546,91,30,43,1,17,74
9547,160,120,5,0,35,125
9548,389,224,86,0,79,310
9549,60,46,6,0,8,52
9550,99,22,31,30,16,83
9551,63,14,36,1,12,51
9552,5,4,1,0,0,5
9553,58,1,48,0,9,49
9554,13,2,8,0,3,10
9555,51,33,10,1,7,44
9556,28,11,9,4,4,24
9557,40,27,1,1,11,29
9558,192,102,51,4,35,157
9559,17,8,6,0,3,14
9560,5,3,2,0,0,5
9561,127,74,22,3,28,99
9562,67,42,16,9,0,67
9563,66,37,19,4,6,60
9564,65,53,0,1,11,54
9565,99,47,33,0,19,80
9566,50,11,30,0,9,41
9567,34,8,15,1,10,24
9568,79,21,36,13,9,70
9569,42,30,1,0,11,31
9570,38,4,25,1,8,30
9571,87,32,17,8,30,57
9572,62,17,28,4,13,49
9573,10,4,2,1,3,7
9574,7,1,3,0,3,4
9575,52,17,21,4,10,42
9576,376,280,20,2,74,302
9577,39,2,29,1,7,32
9578,29,5,5,10,9,20
9579,211,49,104,5,53,158
9580,177,99,33,0,45,132
9581,482,354,30,0,98,384
9582,18,12,1,5,0,18
9583,68,48,4,0,16,52
9584,148,70,27,18,33,115
9585,435,207,143,9,76,359
9586,16,5,5,0,6,10
9587,51,31,5,6,9,42
9588,95,38,40,2,15,80
9589,224,148,29,4,43,181
9590,91,41,30,4,16,75
9591,46,5,29,0,12,34
9592,49,28,9,2,10,39
9593,10,5,4,0,1,9
9594,37,14,10,0,13,24
9595,77,38,10,8,21,56
9596,40,13,8,8,11,29
9597,16,9,4,0,3,13
9598,14,3,8,0,3,11
9599,19,10,6,0,3,16
9600,46,18,20,0,8,38
9601,257,58,65,83,51,206
9602,8,5,1,0,2,6
9603,172,106,31,3,32,140
9604,64,17,25,0,22,42
9605,22,8,11,0,3,19
9606,18,10,2,0,6,12
9607,17,9,6,0,2,15
9608,151,63,44,9,35,116
9609,483,260,104,17,102,381
9610,14,5,2,3,4,10
9611,72,17,48,2,5,67
9612,252,53,134,7,58,194
9613,31,14,13,0,4,27
9614,39,20,8,3,8,31
9615,13,2,10,0,1,12
9616,46,18,20,0,8,38
9617,217,140,36,1,40,177
9618,97,48,16,2,31,66
9619,53,18,12,16,7,46
9620,117,31,34,27,25,92
9621,75,39,20,0,16,59
9622,356,159,122,6,69,287
9623,37,19,11,1,6,31
9624,54,24,25,0,5,49
9625,26,10,11,1,4,22
9626,14,3,2,6,3,11
9627,667,394,134,19,120,547
9628,277,18,203,2,54,223
9629,60,14,40,0,6,54
9630,39,9,11,7,12,27
9631,105,44,41,1,19,86
9632,179,91,29,28,31,148
9633,672,392,150,19,111,561
9634,25,21,1,3,0,25
9635,42,8,17,7,10,32
9636,11,2,4,1,4,7
9637,19,0,16,2,1,18
9638,33,24,5,0,4,29
9639,87,65,5,4,13,74
9640,51,30,11,0,10,41
9641,71,14,32,11,14,57
9642,63,42,6,1,14,49
9643,564,415,33,1,115,449
9644,10,7,1,0,2,8
9645,29,3,23,0,3,26
9646,110,64,16,9,21,89
9647,44,22,11,0,11,33
9648,40,15,18,1,6,34
9649,51,30,5,9,7,44
9650,96,60,9,5,22,74
9651,44,35,2,0,7,37
9652,57,30,6,4,17,40
9653,49,32,6,0,11,38
9654,34,5,18,0,11,23
9655,41,8,25,4,4,37
9656,52,35,5,3,9,43
9657,32,21,9,0,2,30
9658,51,17,19,2,13,38
9659,116,62,10,21,23,93
9660,163,76,47,7,33,130
9661,96,50,13,17,16,80
9662,39,17,14,0,8,31
9663,10,5,5,0,0,10
9664,65,29,19,2,15,50
9665,59,29,23,1,6,53
9666,160,116,6,0,38,122
9667,402,228,92,0,82,320
9668,43,21,17,0,5,38
9669,191,73,34,34,50,141
9670,28,6,7,6,9,19
9671,34,15,12,1,6,28
9672,70,40,17,0,13,57
9673,111,46,44,3,18,93
9674,45,14,16,7,8,37
9675,123,60,27,14,22,101
9676,14,10,2,1,1,13
9677,138,95,20,0,23,115
9678,8,6,1,0,1,7
9679,460,227,88,46,99,361
9680,28,1,18,0,9,19
9681,127,76,26,0,25,102
9682,106,42,30,9,25,81
9683,29,10,13,0,6,23
9684,316,235,13,2,66,250
9685,33,14,10,0,9,24
9686,429,199,135,10,85,344
9687,27,8,11,2,6,21
9688,17,9,5,0,3,14
9689,34,15,12,1,6,28
9690,37,15,14,0,8,29
9691,590,355,115,11,109,481
9692,90,41,29,2,18,72
9693,132,58,40,11,23,109
9694,77,37,19,8,13,64
9695,656,388,140,16,112,544
9696,220,73,82,15,50,170
9697,279,94,127,15,43,236
9698,76,47,18,0,11,65
9699,29,19,3,1,6,23
9700,28,6,19,0,3,25
9701,111,47,37,7,20,91
9702,46,30,7,0,9,37
9703,217,62,21,99,35,182
9704,226,52,30,107,37,189
9705,96,60,21,0,15,81
9706,83,32,38,0,13,70
9707,70,19,39,1,11,59
9708,109,69,20,2,18,91
9709,173,109,47,2,15,158
9710,32,21,9,0,2,30
9711,81,15,36,14,16,65
9712,141,78,26,6,31,110
9713,16,2,10,0,4,12
9714,88,10,47,11,20,68
9715,85,41,21,1,22,63
9716,221,166,15,0,40,181
9717,19,7,7,0,5,14
9718,10,5,3,0,2,8
9719,69,47,8,4,10,59
9720,19,11,5,1,2,17
9721,22,5,5,2,10,12
9722,176,71,39,22,44,132
9723,342,146,119,6,71,271
9724,25,15,4,0,6,19
9725,37,12,18,2,5,32
9726,17,8,3,3,3,14
9727,37,8,25,1,3,34
9728,257,122,85,4,46,211
9729,674,394,143,18,119,555
9730,16,3,13,0,0,16
9731,119,96,3,3,17,102
9732,78,35,30,0,13,65
9733,160,71,53,5,31,129
9734,15,6,6,0,3,12
9735,47,28,5,1,13,34
9736,4,1,3,0,0,4
9737,106,71,15,0,20,86
9738,3,3,0,0,0,3
9739,36,11,5,8,12,24
9740,39,1,19,13,6,33
9741,84,24,39,1,20,64
9742,83,34,16,15,18,65
9743,82,37,33,0,12,70
9744,126,69,28,0,29,97
9745,17,9,3,0,5,12
9746,16,2,13,0,1,15
9747,106,86,6,0,14,92
9748,390,292,20,2,76,314
9749,307,187,52,0,68,239
9750,32,21,9,0,2,30
9751,32,21,9,0,2,30
9752,26,8,12,0,6,20
9753,201,86,42,25,48,153
9754,13,8,3,1,1,12
9755,89,26,38,5,20,69
9756,519,365,44,1,109,410
9757,27,14,10,0,3,24
9758,147,109,4,2,32,115
9759,193,76,33,34,50,143
9760,42,15,23,0,4,38
9761,72,41,13,0,18,54
9762,30,9,15,0,6,24
9763,10,1,9,0,0,10
9764,282,29,197,2,54,228
9765,89,57,16,1,15,74
9766,33,5,23,1,4,29
9767,656,383,142,17,114,542
9768,13,8,0,0,5,8
9769,21,8,9,0,4,17
9770,54,14,28,2,10,44
9771,92,59,19,0,14,78
9772,42,14,15,3,10,32
9773,73,26,34,3,10,63
9774,576,409,47,1,119,457
9775,27,10,10,0,7,20
9776,51,12,30,0,9,42
9777,87,21,26,26,14,73
9778,31,15,9,0,7,24
9779,39,10,21,0,8,31
9780,40,6,5,19,10,30
9781,36,21,5,2,8,28
9782,107,23,43,16,25,82
9783,134,2,113,0,19,115
9784,86,36,35,0,15,71
9785,71,48,7,1,15,56
9786,53,16,18,3,16,37
9787,74,38,25,0,11,63
9788,10,5,3,0,2,8
9789,11,2,6,0,3,8
9790,170,89,45,5,31,139
9791,7,5,2,0,0,7
9792,65,14,29,8,14,51
9793,15,9,2,0,4,11
9794,280,73,152,1,54,226
9795,16,6,5,0,5,11
9796,38,17,19,0,2,36
9797,15,8,4,0,3,12
9798,57,31,9,0,17,40
9799,214,107,36,34,37,177
9800,48,24,16,1,7,41
9801,9,2,2,0,5,4
9802,106,39,34,7,26,80
9803,29,6,18,3,2,27
9804,75,53,2,0,20,55
9805,213,113,48,0,52,161
9806,84,22,39,5,18,66
9807,144,90,28,0,26,118
9808,10,8,2,0,0,10
9809,59,27,17,5,10,49
9810,78,26,37,0,15,63
9811,53,21,22,3,7,46
9812,47,32,2,0,13,34
9813,58,33,11,0,14,44
9814,99,44,33,4,18,81
9815,27,9,13,1,4,23
9816,8,2,1,4,1,7
9817,15,3,11,0,1,14
9818,17,15,0,0,2,15
9819,45,30,2,0,13,32
9820,197,54,49,56,38,159
9821,14,0,8,0,6,8
9822,103,74,11,9,9,94
9823,15,4,8,1,2,13
9824,36,1,29,0,6,30
9825,74,39,19,0,16,58
9826,102,66,15,3,18,84
9827,203,105,34,28,36,167
9828,26,15,7,0,4,22
9829,51,17,14,5,15,36
9830,3,1,0,1,1,2
9831,258,196,13,0,49,209
9832,61,20,26,0,15,46
9833,31,21,0,4,6,25
9834,38,9,16,6,7,31
9835,77,20,37,8,12,65
9836,110,57,32,1,20,90
9837,50,19,19,1,11,39
9838,33,12,10,0,11,22
9839,73,10,48,0,15,58
9840,20,15,1,0,4,16
9841,36,18,13,0,5,31
9842,60,36,16,0,8,52
9843,439,233,96,13,97,342
9844,560,386,50,1,123,437
9845,130,106,5,2,17,113
9846,38,9,5,17,7,31
9847,147,69,42,5,31,116
9848,187,47,67,29,44,143
9849,341,188,81,13,59,282
9850,77,38,19,1,19,58
9851,85,67,2,2,14,71
9852,80,64,2,0,14,66
9853,49,13,24,0,12,37
9854,24,6,8,0,10,14
9855,11,6,2,0,3,8
9856,438,124,172,46,96,342
9857,208,103,36,31,38,170
9858,39,11,9,14,5,34
9859,8,2,5,0,1,7
9860,436,273,66,3,94,342
9861,368,191,107,4,66,302
9862,46,18,20,0,8,38
9863,160,107,22,1,30,130
9864,156,48,49,23,36,120
9865,142,97,20,1,24,118
9866,155,67,56,1,31,124
9867,207,80,47,32,48,159
9868,83,51,13,0,19,64
9869,71,37,19,0,15,56
9870,70,20,26,2,22,48
9871,91,38,35,1,17,74
9872,21,2,14,0,5,16
9873,302,171,77,0,54,248
9874,538,375,49,1,113,425
9875,76,38,23,2,13,63
9876,57,46,3,1,7,50
9877,32,2,27,0,3,29
9878,27,13,3,5,6,21
9879,128,63,42,12,11,117
9880,128,101,3,0,24,104
9881,161,106,37,11,7,154
9882,82,51,22,9,0,82
9883,421,124,156,47,94,327
9884,6,4,0,2,0,6
9885,42,26,9,1,6,36
9886,686,397,142,21,126,560
9887,28,2,20,0,6,22
9888,67,40,12,0,15,52
9889,65,48,12,0,5,60
9890,64,18,21,15,10,54
9891,206,52,27,95,32,174
9892,70,35,23,2,10,60
9893,203,113,28,23,39,164
9894,45,1,34,0,10,35
9895,21,8,4,3,6,15
9896,9,0,4,2,3,6
9897,70,51,7,0,12,58
9898,56,35,11,2,8,48
9899,44,6,23,4,11,33
9900,56,30,10,4,12,44
9901,46,22,12,1,11,35
9902,36,14,13,0,9,27
9903,24,12,8,0,4,20
9904,83,28,40,2,13,70
9905,37,15,20,0,2,35
9906,95,48,14,2,31,64
9907,69,40,14,0,15,54
9908,37,20,9,0,8,29
9909,89,27,25,18,19,70
9910,29,14,8,3,4,25
9911,6,4,2,0,0,6
9912,11,0,10,0,1,10
9913,155,99,3,17,36,119
9914,18,3,9,2,4,14
9915,26,5,14,2,5,21
9916,189,104,54,0,31,158
9917,177,66,50,32,29,148
9918,70,15,38,6,11,59
9919,75,50,7,0,18,57
9920,60,33,10,0,17,43
9921,20,13,3,0,4,16
9922,95,36,34,10,15,80
9923,96,50,23,4,19,77
9924,11,7,0,0,4,7
9925,41,17,7,6,11,30
9926,68,7,40,8,13,55
9927,691,401,142,22,126,565
9928,100,67,6,0,27,73
9929,9,3,4,0,2,7
9930,138,76,39,1,22,116
9931,75,44,18,0,13,62
9932,170,125,19,0,26,144
9933,7,2,4,0,1,6
9934,39,20,9,0,10,29
9935,79,43,22,0,14,65
9936,70,35,18,2,15,55
9937,127,74,22,3,28,99
9938,1,1,0,0,0,1
9939,33,9,16,0,8,25
9940,45,23,11,1,10,35
9941,31,15,8,2,6,25
9942,61,16,30,1,14,47
9943,44,13,24,1,6,38
9944,37,26,4,0,7,30
9945,628,393,86,9,140,488
9946,24,1,15,3,5,19
9947,35,15,6,5,9,26
9948,22,16,4,0,2,20
9949,220,118,50,14,38,182
9950,6,5,0,1,0,6
9951,2,0,1,0,1,1
9952,6,4,0,0,2,4
9953,438,179,113,48,98,340
9954,68,37,13,4,14,54
9955,49,32,6,2,9,40
9956,38,18,9,1,10,28
9957,83,50,17,6,10,73
9958,32,21,4,0,7,25
9959,51,27,7,6,11,40
9960,71,52,7,0,12,59
9961,233,145,35,0,53,180
9962,61,35,13,0,13,48
9963,40,27,1,1,11,29
9964,25,5,15,0,5,20
9965,53,32,8,2,11,42
9966,19,6,10,0,3,16
9967,125,42,47,11,25,100
9968,79,45,17,2,15,64
9969,76,41,21,0,14,62
9970,32,21,9,0,2,30
9971,91,26,37,10,18,73
9972,81,38,10,18,15,66
9973,169,70,52,9,38,131
9974,103,25,61,1,16,87
9975,93,44,13,12,24,69
9976,41,28,0,0,13,28
9977,80,41,16,8,15,65
9978,232,155,32,0,45,187
9979,111,70,19,2,20,91
9980,259,177,18,4,60,199
9981,32,21,9,0,2,30
9982,6,6,0,0,0,6
9983,51,25,10,7,9,42
9984,62,35,12,4,11,51
9985,6,6,0,0,0,6
9986,25,14,7,0,4,21
9987,29,13,5,0,11,18
9988,134,63,45,2,24,110
9989,28,3,13,2,10,18
9990,37,18,10,1,8,29
9991,36,18,5,1,12,24
9992,111,61,34,8,8,103
9993,71,38,2,20,11,60
9994,199,99,50,0,50,149
9995,52,36,5,0,11,41
9996,55,34,9,1,11,44
9997,196,88,50,20,38,158
9998,209,151,17,4,37,172
9999,65,51,2,0,12,53
10000,90,42,25,4,19,71
10001,46,18,20,0,8,38
10002,23,15,3,0,5,18
10003,12,4,7,0,1,11
10004,83,63,5,4,11,72
10005,32,21,9,0,2,30
10006,33,5,14,7,7,26
10007,111,54,32,3,22,89
10008,147,36,83,1,27,120
10009,27,0,19,0,8,19
10010,506,244,106,56,100,406
10011,129,110,2,0,17,112
10012,128,101,7,2,18,110
10013,38,12,18,1,7,31
10014,402,232,90,0,80,322
10015,47,34,0,0,13,34
10016,306,140,92,15,59,247
10017,57,42,10,5,0,57
10018,28,5,16,2,5,23
10019,86,65,1,0,20,66
10020,111,34,34,13,30,81
10021,57,19,26,0,12,45
10022,32,14,11,0,7,25
10023,26,14,9,0,3,23
10024,179,110,6,20,43,136
10025,51,10,28,0,13,38
10026,141,27,48,25,41,100
10027,4,1,3,0,0,4
10028,47,16,17,3,11,36
10029,223,151,54,2,16,207
10030,103,19,58,0,26,77
10031,113,38,37,12,26,87
10032,108,48,36,5,19,89
10033,140,46,45,22,27,113
10034,52,31,9,0,12,40
10035,348,195,84,0,69,279
10036,13,7,2,0,4,9
10037,193,50,30,80,33,160
10038,47,29,12,1,5,42
10039,32,21,9,0,2,30
10040,40,15,19,0,6,34
10041,26,10,7,2,7,19
10042,49,9,26,2,12,37
10043,67,21,31,6,9,58
10044,166,89,41,4,32,134
10045,12,0,11,0,1,11
10046,76,47,13,8,8,68
10047,23,4,3,10,6,17
10048,219,63,108,4,44,175
10049,185,85,43,19,38,147
10050,31,2,25,0,4,27
10051,62,37,14,1,10,52
10052,67,26,23,3,15,52
10053,58,27,18,0,13,45
10054,50,29,6,2,13,37
10055,30,16,11,0,3,27
10056,44,10,28,1,5,39
10057,146,93,25,3,25,121
10058,28,13,9,0,6,22
10059,243,100,15,83,45,198
10060,357,154,129,10,64,293
10061,234,14,176,0,44,190
10062,81,45,21,6,9,72
10063,5,3,0,0,2,3
10064,448,137,182,30,99,349
10065,111,37,44,11,19,92
10066,38,17,16,0,5,33
10067,27,17,4,3,3,24
10068,8,1,4,0,3,5
10069,58,14,34,1,9,49
10070,46,18,20,0,8,38
10071,22,14,2,0,6,16
10072,89,56,11,2,20,69
10073,68,34,13,5,16,52
10074,14,4,10,0,0,14
10075,220,66,105,2,47,173
10076,37,0,30,0,7,30
10077,77,48,13,8,8,69
10078,163,95,38,1,29,134
10079,105,34,42,10,19,86
10080,36,16,10,0,10,26
10081,58,18,30,1,9,49
10082,6,0,4,0,2,4
10083,49,34,8,0,7,42
10084,16,5,8,0,3,13
10085,87,35,24,10,18,69
10086,59,12,31,4,12,47
10087,43,13,19,4,7,36
10088,10,7,1,0,2,8
10089,82,34,38,1,9,73
10090,20,4,11,0,5,15
10091,40,5,19,5,11,29
10092,32,21,9,0,2,30
10093,130,41,48,17,24,106
10094,26,7,5,5,9,17
10095,17,4,11,0,2,15
10096,44,11,22,3,8,36
10097,387,177,133,8,69,318
10098,12,8,4,0,0,12
10099,438,113,189,38,98,340
10100,45,10,23,5,7,38
10101,28,15,6,1,6,22
10102,24,7,5,5,7,17
10103,443,242,118,0,83,360
10104,35,20,6,1,8,27
10105,224,19,164,2,39,185
10106,137,61,50,5,21,116
10107,230,106,67,18,39,191
10108,539,259,118,51,111,428
10109,73,31,19,1,22,51
10110,58,37,6,0,15,43
10111,49,34,2,1,12,37
10112,26,9,9,3,5,21
10113,56,3,40,1,12,44
10114,89,27,24,20,18,71
10115,38,15,13,0,10,28
10116,4,2,1,0,1,3
10117,49,35,3,0,11,38
10118,36,16,12,0,8,28
10119,127,74,27,0,26,101
10120,41,16,19,1,5,36
10121,19,4,10,0,5,14
10122,204,135,22,0,47,157
10123,32,21,9,0,2,30
10124,655,383,141,17,114,541
10125,95,25,54,2,14,81
10126,94,48,19,2,25,69
10127,55,18,23,1,13,42
10128,61,19,24,4,14,47
10129,20,8,5,2,5,15
10130,21,14,1,2,4,17
10131,188,147,7,0,34,154
10132,18,9,8,0,1,17
10133,48,34,3,0,11,37
10134,90,38,31,8,13,77
10135,10,1,7,0,2,8
10136,38,8,20,0,10,28
10137,70,39,17,0,14,56
10138,67,16,26,9,16,51
10139,19,5,9,0,5,14
10140,62,19,32,0,11,51
10141,47,15,25,4,3,44
10142,145,39,10,69,27,118
10143,40,18,16,0,6,34
10144,43,23,8,1,11,32
10145,189,87,48,16,38,151
10146,94,48,25,4,17,77
10147,99,63,25,0,11,88
10148,34,15,12,1,6,28
10149,121,92,4,2,23,98
10150,12,4,5,0,3,9
10151,28,15,8,0,5,23
10152,364,160,129,6,69,295
10153,97,55,12,13,17,80
10154,21,6,10,3,2,19
10155,239,132,34,26,47,192
10156,144,24,55,24,41,103
10157,20,10,4,1,5,15
10158,105,38,25,19,23,82
10159,222,119,67,0,36,186
10160,84,21,49,0,14,70
10161,9,2,5,2,0,9
10162,23,4,16,0,3,20
10163,87,46,20,8,13,74
10164,33,12,16,2,3,30
10165,83,40,17,9,17,66
10166,324,77,161,6,80,244
10167,115,60,14,13,28,87
10168,12,4,6,1,1,11
10169,46,18,20,0,8,38
10170,104,74,5,1,24,80
10171,63,36,16,1,10,53
10172,33,15,8,1,9,24
10173,17,6,10,1,0,17
10174,229,99,15,75,40,189
10175,67,44,13,0,10,57
10176,14,5,3,0,6,8
10177,72,39,20,0,13,59
10178,165,87,52,0,26,139
10179,80,36,28,0,16,64
10180,41,14,22,0,5,36
10181,176,54,89,0,33,143
10182,71,46,14,0,11,60
10183,116,49,29,16,22,94
10184,231,98,45,29,59,172
10185,29,9,13,0,7,22
10186,91,53,25,11,2,89
10187,199,83,30,40,46,153
10188,19,8,7,0,4,15
10189,255,179,15,3,58,197
10190,17,6,9,1,1,16
10191,263,175,64,5,19,244
10192,93,30,32,12,19,74
10193,22,10,6,1,5,17
10194,17,11,4,0,2,15
10195,40,17,15,2,6,34
10196,195,141,10,7,37,158
10197,357,268,20,2,67,290
10198,72,51,5,0,16,56
10199,110,44,23,21,22,88
10200,34,2,24,0,8,26
10201,1,1,0,0,0,1
10202,84,38,22,1,23,61
10203,46,19,16,2,9,37
10204,97,49,17,11,20,77
10205,53,35,4,0,14,39
10206,49,10,28,1,10,39
10207,433,135,158,46,94,339
10208,96,49,31,3,13,83
10209,126,57,23,18,28,98
10210,203,50,104,14,35,168
10211,152,24,98,1,29,123
10212,45,21,13,2,9,36
10213,396,231,82,16,67,329
10214,206,89,59,20,38,168
10215,12,9,2,0,1,11
10216,138,54,44,9,31,107
10217,45,10,24,0,11,34
10218,8,4,1,2,1,7
10219,299,155,92,0,52,247
10220,80,18,40,6,16,64
10221,81,56,11,5,9,72
10222,80,36,31,1,12,68
10223,146,45,73,4,24,122
10224,42,23,8,2,9,33
10225,40,20,11,1,8,32
10226,35,20,7,0,8,27
10227,304,169,81,0,54,250
10228,446,204,150,11,81,365
10229,42,18,14,0,10,32
10230,117,42,41,5,29,88
10231,6,3,0,2,1,5
10232,62,43,8,4,7,55
10233,77,17,36,8,16,61
10234,220,149,30,0,41,179
10235,22,14,2,3,3,19
10236,35,15,14,0,6,29
10237,13,2,8,0,3,10
10238,36,15,15,0,6,30
10239,138,43,71,0,24,114
10240,39,9,26,0,4,35
10241,163,117,21,0,25,138
10242,422,199,135,10,78,344
10243,54,34,10,0,10,44
10244,18,6,7,2,3,15
10245,32,21,9,0,2,30
10246,33,24,5,0,4,29
10247,89,55,15,0,19,70
10248,38,10,15,6,7,31
10249,72,45,12,3,12,60
10250,32,21,9,0,2,30
10251,32,9,18,0,5,27
10252,30,13,13,0,4,26
10253,526,221,144,46,115,411
10254,97,37,26,13,21,76
10255,224,96,14,76,38,186
10256,473,343,30,0,100,373
10257,60,29,21,2,8,52
10258,9,3,4,0,2,7
10259,151,84,20,22,25,126
10260,25,12,5,1,7,18
10261,25,17,2,1,5,20
10262,57,9,33,5,10,47
10263,179,127,15,2,35,144
10264,35,10,14,5,6,29
10265,259,147,65,0,47,212
10266,75,20,34,8,13,62
10267,17,8,6,0,3,14
10268,185,79,64,4,38,147
10269,49,32,6,2,9,40
10270,27,14,6,3,4,23
10271,9,7,1,1,0,9
10272,80,18,42,1,19,61
10273,46,26,13,0,7,39
10274,22,3,14,1,4,18
10275,32,7,19,1,5,27
10276,17,6,8,0,3,14
10277,347,203,69,0,75,272
10278,171,113,27,1,30,141
10279,87,28,31,12,16,71
10280,71,38,15,0,18,53
10281,93,46,30,3,14,79
10282,105,88,2,0,15,90
10283,64,25,13,11,15,49
10284,64,36,5,0,23,41
10285,127,74,22,3,28,99
10286,108,47,29,12,20,88
10287,47,5,33,2,7,40
10288,61,24,23,1,13,48
10289,198,39,54,65,40,158
10290,28,10,11,1,6,22
10291,61,18,32,1,10,51
10292,21,1,4,12,4,17
10293,141,116,6,0,19,122
10294,6,2,4,0,0,6
10295,144,59,56,2,27,117
10296,51,32,8,2,9,42
10297,42,6,26,3,7,35
10298,29,11,4,2,12,17
10299,65,24,23,5,13,52
10300,78,41,18,5,14,64
10301,205,109,32,21,43,162
10302,150,62,31,22,35,115
10303,64,33,15,5,11,53
10304,260,129,63,16,52,208
10305,268,118,93,10,47,221
10306,13,2,5,0,6,7
10307,74,40,19,0,15,59
10308,117,33,36,23,25,92
10309,43,7,22,4,10,33
10310,74,19,35,8,12,62
10311,31,8,17,0,6,25
10312,96,62,23,0,11,85
10313,20,10,6,0,4,16
10314,47,27,8,0,12,35
10315,72,44,8,0,20,52
10316,66,30,16,4,16,50
10317,38,16,14,0,8,30
10318,425,117,169,47,92,333
10319,73,46,9,3,15,58
10320,46,15,25,2,4,42
10321,85,34,37,2,12,73
10322,33,7,15,7,4,29
10323,211,96,59,13,43,168
10324,315,73,159,6,77,238
10325,263,142,61,0,60,203
10326,53,12,29,0,12,41
10327,108,82,8,0,18,90
10328,16,5,7,1,3,13
10329,81,38,23,0,20,61
10330,43,27,4,3,9,34
10331,29,5,22,0,2,27
10332,21,0,19,0,2,19
10333,664,388,142,17,117,547
10334,139,53,46,9,31,108
10335,12,11,0,0,1,11
10336,34,8,16,0,10,24
10337,89,56,13,3,17,72
10338,74,30,30,0,14,60
10339,20,10,7,1,2,18
10340,199,96,60,0,43,156
10341,133,49,43,17,24,109
10342,48,29,6,3,10,38
10343,138,80,21,3,34,104
10344,69,47,8,4,10,59
10345,350,186,92,15,57,293
10346,76,32,26,2,16,60
10347,31,18,3,0,10,21
10348,39,8,13,6,12,27
10349,242,183,13,0,46,196
10350,52,36,4,1,11,41
10351,84,33,27,14,10,74
10352,23,6,12,0,5,18
10353,153,14,105,0,34,119
10354,15,0,11,0,4,11
10355,5,4,0,0,1,4
10356,38,0,31,0,7,31
10357,14,6,4,1,3,11
10358,101,66,1,12,22,79
10359,20,8,6,2,4,16
10360,207,91,62,18,36,171
10361,40,8,17,0,15,25
10362,79,34,31,0,14,65
10363,36,25,2,0,9,27
10364,66,28,24,0,14,52
10365,14,1,12,0,1,13
10366,96,40,34,1,21,75
10367,26,12,5,0,9,17
10368,105,48,33,5,19,86
10369,460,214,150,10,86,374
10370,74,35,26,1,12,62
10371,48,20,17,1,10,38
10372,47,19,14,1,13,34
10373,17,4,8,0,5,12
10374,30,14,7,0,9,21
10375,99,37,38,8,16,83
10376,33,15,11,0,7,26
10377,6,1,4,0,1,5
10378,100,51,16,14,19,81
10379,17,6,7,1,3,14
10380,58,16,24,7,11,47
10381,155,67,36,16,36,119
10382,71,23,20,11,17,54
10383,154,74,49,1,30,124
10384,543,394,33,1,115,428
10385,56,29,14,0,13,43
10386,140,106,6,0,28,112
10387,8,5,1,1,1,7
10388,75,21,43,1,10,65
10389,16,8,5,0,3,13
10390,87,28,40,2,17,70
10391,83,28,42,0,13,70
10392,58,14,34,1,9,49
10393,55,11,27,11,6,49
10394,86,66,1,0,19,67
10395,22,10,10,0,2,20
10396,36,11,15,0,10,26
10397,101,36,40,11,14,87
10398,40,21,10,1,8,32
10399,165,97,35,8,25,140
10400,26,10,11,1,4,22
10401,36,17,14,0,5,31
10402,167,126,7,9,25,142
10403,174,85,50,4,35,139
10404,71,20,21,16,14,57
10405,38,6,4,19,9,29
10406,29,2,19,2,6,23
10407,37,7,11,8,11,26
10408,31,4,24,0,3,28
10409,29,17,6,0,6,23
10410,63,47,12,0,4,59
10411,232,43,131,7,51,181
10412,31,14,9,0,8,23
10413,15,10,2,0,3,12
10414,7,1,2,0,4,3
10415,159,45,87,0,27,132
10416,643,360,157,23,103,540
10417,51,20,22,2,7,44
10418,46,18,20,0,8,38
10419,47,33,2,0,12,35
10420,16,4,7,0,5,11
10421,32,20,7,1,4,28
10422,32,6,20,1,5,27
10423,94,35,34,5,20,74
10424,69,45,9,0,15,54
10425,512,237,117,50,108,404
10426,112,67,23,0,22,90
10427,82,12,53,0,17,65
10428,15,4,9,0,2,13
10429,454,224,86,50,94,360
10430,125,43,47,11,24,101
10431,36,22,5,1,8,28
10432,426,200,137,12,77,349
10433,346,151,121,6,68,278
10434,45,5,30,5,5,40
10435,75,10,50,0,15,60
10436,53,38,8,0,7,46
10437,91,22,51,0,18,73
10438,47,27,10,1,9,38
10439,99,45,34,0,20,79
10440,9,5,3,0,1,8
10441,22,8,11,0,3,19
10442,247,117,73,4,53,194
10443,75,37,25,1,12,63
10444,37,19,8,1,9,28
10445,170,119,14,2,35,135
10446,61,21,25,0,15,46
10447,63,42,5,0,16,47
10448,143,51,35,20,37,106
10449,63,32,14,4,13,50
10450,72,41,16,1,14,58
10451,33,8,17,4,4,29
10452,301,151,91,1,58,243
10453,169,46,14,83,26,143
10454,32,21,9,0,2,30
10455,31,17,6,0,8,23
10456,186,87,47,15,37,149
10457,82,56,6,1,19,63
10458,15,2,9,0,4,11
10459,8,0,6,0,2,6
10460,11,3,5,0,3,8
10461,1,0,0,0,1,0
10462,25,1,15,0,9,16
10463,32,17,13,0,2,30
10464,109,52,34,4,19,90
10465,76,31,24,7,14,62
10466,23,16,1,0,6,17
10467,194,142,14,1,37,157
10468,14,10,0,0,4,10
10469,601,413,56,1,131,470
10470,45,27,8,2,8,37
10471,678,392,154,21,111,567
10472,41,13,18,4,6,35
10473,82,35,8,24,15,67
10474,45,19,13,5,8,37
10475,91,36,16,10,29,62
10476,33,8,17,4,4,29
10477,220,149,30,0,41,179
10478,39,22,7,0,10,29
10479,84,71,3,0,10,74
10480,71,52,3,0,16,55
10481,127,64,41,11,11,116
10482,83,64,1,0,18,65
10483,152,4,126,0,22,130
10484,88,52,21,2,13,75
10485,2,1,0,0,1,1
10486,74,8,57,0,9,65
10487,62,25,28,0,9,53
10488,46,18,20,0,8,38
10489,79,46,17,2,14,65
10490,13,4,3,3,3,10
10491,49,19,11,15,4,45
10492,472,238,117,17,100,372
10493,366,211,78,17,60,306
10494,76,28,32,3,13,63
10495,50,14,23,2,11,39
10496,176,46,53,41,36,140
10497,248,184,7,3,54,194
10498,45,21,5,8,11,34
10499,41,26,9,2,4,37
10500,67,4,46,0,17,50
10501,353,184,99,3,67,286
10502,21,8,3,3,7,14
10503,224,121,51,14,38,186
10504,10,4,6,0,0,10
10505,398,222,101,0,75,323
10506,64,18,21,15,10,54
10507,61,29,15,0,17,44
10508,13,0,9,0,4,9
10509,184,105,21,23,35,149
10510,86,50,20,3,13,73
10511,54,14,31,0,9,45
10512,6,2,1,3,0,6
10513,45,26,12,0,7,38
10514,12,5,4,0,3,9
10515,71,19,40,1,11,60
10516,80,47,16,2,15,65
10517,44,30,1,1,12,32
10518,70,56,2,0,12,58
10519,14,4,5,0,5,9
10520,26,5,16,0,5,21
10521,27,17,3,0,7,20
10522,24,10,11,0,3,21
10523,82,19,44,7,12,70
10524,12,5,4,3,0,12
10525,31,19,3,0,9,22
10526,35,9,8,7,11,24
10527,15,4,6,0,5,10
10528,97,41,34,3,19,78
10529,54,17,23,2,12,42
10530,38,11,19,1,7,31
10531,56,38,11,0,7,49
10532,142,95,21,1,25,117
10533,35,22,7,3,3,32
10534,219,58,110,14,37,182
10535,1,0,1,0,0,1
10536,151,110,10,0,31,120
10537,225,103,77,0,45,180
10538,138,55,29,24,30,108
10539,208,88,54,23,43,165
10540,31,17,5,3,6,25
10541,46,18,20,0,8,38
10542,18,2,8,0,8,10
10543,67,19,34,4,10,57
10544,51,37,6,1,7,44
10545,23,12,3,5,3,20
10546,36,11,18,1,6,30
10547,3,3,0,0,0,3
10548,4,3,1,0,0,4
10549,18,10,4,1,3,15
10550,145,50,70,0,25,120
10551,152,108,6,3,35,117
10552,119,42,48,0,29,90
10553,160,4,129,0,27,133
10554,157,47,50,24,36,121
10555,359,185,92,19,63,296
10556,58,5,49,0,4,54
10557,55,40,5,1,9,46
10558,20,7,9,0,4,16
10559,127,74,22,3,28,99
10560,27,6,18,0,3,24
10561,69,38,19,2,10,59
10562,108,20,62,1,25,83
10563,29,10,10,0,9,20
10564,53,27,15,2,9,44
10565,43,10,23,0,10,33
10566,69,51,6,1,11,58
10567,50,22,16,3,9,41
10568,49,33,2,0,14,35
10569,102,42,20,18,22,80
10570,86,20,47,0,19,67
10571,204,136,51,2,15,189
10572,0,0,0,0,0,0
10573,16,6,7,0,3,13
10574,56,24,14,6,12,44
10575,114,83,7,0,24,90
10576,63,32,10,6,15,48
10577,169,87,56,0,26,143
10578,26,8,9,0,9,17
10579,32,21,9,0,2,30
10580,519,286,83,46,104,415
10581,497,255,90,50,102,395
10582,78,42,12,6,18,60
10583,60,36,14,8,2,58
10584,85,51,18,4,12,73
10585,129,88,9,5,27,102
10586,148,41,10,70,27,121
10587,9,1,5,1,2,7
10588,104,27,26,28,23,81
10589,205,107,34,26,38,167
10590,33,22,5,1,5,28
10591,77,39,20,0,18,59
10592,119,44,30,21,24,95
10593,27,8,14,2,3,24
10594,171,72,54,3,42,129
10595,4,2,1,0,1,3
10596,287,159,62,12,54,233
10597,180,122,18,0,40,140
10598,8,3,3,1,1,7
10599,23,0,17,0,6,17
10600,37,9,15,1,12,25
10601,31,15,11,0,5,26
10602,56,33,2,11,10,46
10603,671,393,135,20,123,548
10604,155,12,87,26,30,125
10605,65,28,25,2,10,55
10606,63,32,23,2,6,57
10607,67,35,3,17,12,55
10608,109,9,68,9,23,86
10609,46,38,2,0,6,40
10610,16,0,14,0,2,14
10611,32,21,9,0,2,30
10612,63,23,14,16,10,53
10613,192,92,57,2,41,151
10614,35,10,17,0,8,27
10615,118,80,11,3,24,94
10616,21,16,3,0,2,19
10617,82,62,5,4,11,71
10618,46,22,18,0,6,40
10619,22,4,8,3,7,15
10620,481,232,95,49,105,376
10621,51,17,23,0,11,40
10622,54,39,2,0,13,41
10623,270,158,47,10,55,215
10624,57,25,24,0,8,49
10625,121,61,37,0,23,98
10626,130,87,19,1,23,107
10627,54,26,20,0,8,46
10628,94,30,24,21,19,75
10629,485,354,28,1,102,383
10630,70,18,39,0,13,57
10631,127,74,22,3,28,99
10632,44,20,5,8,11,33
10633,8,2,4,0,2,6
10634,82,42,10,8,22,60
10635,25,9,4,2,10,15
10636,72,8,41,5,18,54
10637,349,177,106,5,61,288
10638,64,22,30,0,12,52
10639,63,29,5,16,13,50
10640,49,23,15,0,11,38
10641,34,17,10,0,7,27
10642,182,52,18,82,30,152
10643,112,53,34,5,20,92
10644,29,1,22,1,5,24
10645,95,52,18,0,25,70
10646,21,6,9,0,6,15
10647,50,23,16,2,9,41
10648,53,32,10,0,11,42
10649,94,69,7,1,17,77
10650,98,76,8,0,14,84
10651,157,67,53,14,23,134
10652,103,54,21,4,24,79
10653,36,1,26,1,8,28
10654,124,43,56,1,24,100
10655,20,2,10,0,8,12
10656,111,62,16,9,24,87
10657,60,24,17,10,9,51
10658,28,2,21,1,4,24
10659,67,20,31,3,13,54
10660,19,2,10,0,7,12
10661,108,29,60,0,19,89
10662,53,25,16,0,12,41
10663,46,18,20,0,8,38
10664,16,2,9,1,4,12
10665,18,14,1,0,3,15
10666,69,38,19,1,11,58
10667,73,36,7,9,21,52
10668,117,38,40,17,22,95
10669,24,4,12,2,6,18
10670,21,16,2,1,2,19
10671,38,5,28,1,4,34
10672,180,13,133,0,34,146
10673,43,15,16,0,12,31
10674,87,58,8,0,21,66
10675,10,7,1,0,2,8
10676,71,33,29,0,9,62
10677,138,62,43,11,22,116
10678,24,13,7,0,4,20
10679,29,4,17,0,8,21
10680,100,27,56,0,17,83
10681,60,8,34,2,16,44
10682,514,257,96,53,108,406
10683,45,33,0,0,12,33
10684,35,7,21,1,6,29
10685,32,21,9,0,2,30
10686,333,187,82,0,64,269
10687,34,5,22,0,7,27
10688,7,4,1,0,2,5
10689,95,56,20,0,19,76
10690,10,5,3,0,2,8
10691,4,1,2,0,1,3
10692,337,143,88,37,69,268
10693,11,5,5,0,1,10
10694,147,107,4,2,34,113
10695,61,19,24,6,12,49
10696,54,35,9,0,10,44
10697,29,16,7,0,6,23
10698,16,4,10,0,2,14
10699,16,11,1,0,4,12
10700,41,15,14,0,12,29
10701,53,37,10,0,6,47
10702,46,18,20,0,8,38
10703,18,7,6,0,5,13
10704,11,6,1,0,4,7
10705,71,48,6,0,17,54
10706,169,6,132,0,31,138
10707,81,53,17,0,11,70
10708,100,64,13,3,20,80
10709,201,110,30,22,39,162
10710,58,31,16,1,10,48
10711,27,5,19,0,3,24
10712,50,19,21,0,10,40
10713,173,109,12,13,39,134
10714,13,4,6,0,3,10
10715,94,48,28,1,17,77
10716,64,30,23,0,11,53
10717,105,38,38,8,21,84
10718,240,129,68,0,43,197
10719,77,27,28,6,16,61
10720,26,13,8,0,5,21
10721,42,18,18,0,6,36
10722,63,47,12,0,4,59
10723,395,226,88,0,81,314
10724,80,42,13,9,16,64
10725,114,44,40,5,25,89
10726,101,37,37,5,22,79
10727,132,67,13,23,29,103
10728,205,111,61,0,33,172
10729,38,10,22,1,5,33
10730,40,33,0,0,7,33
10731,46,18,20,0,8,38
10732,87,45,12,2,28,59
10733,46,18,20,0,8,38
10734,31,13,11,0,7,24
10735,429,146,146,47,90,339
10736,174,46,57,36,35,139
10737,154,65,33,23,33,121
10738,98,38,24,14,22,76
10739,83,31,35,5,12,71
10740,98,55,23,1,19,79
10741,143,88,19,2,34,109
10742,77,41,19,1,16,61
10743,42,8,19,2,13,29
10744,130,56,46,3,25,105
10745,51,11,5,24,11,40
10746,18,2,9,1,6,12
10747,28,2,12,7,7,21
10748,27,9,7,2,9,18
10749,88,24,52,0,12,76
10750,68,44,12,0,12,56
10751,38,22,5,3,8,30
10752,144,68,47,5,24,120
10753,14,0,13,0,1,13
10754,74,38,20,0,16,58
10755,51,34,7,0,10,41
10756,66,33,21,0,12,54
10757,46,18,20,0,8,38
10758,25,14,7,0,4,21
10759,88,45,24,2,17,71
10760,83,42,23,2,16,67
10761,430,134,180,17,99,331
10762,402,284,39,1,78,324
10763,11,1,8,0,2,9
10764,83,40,23,7,13,70
10765,35,7,20,0,8,27
10766,32,21,9,0,2,30
10767,85,45,25,0,15,70
10768,75,37,19,0,19,56
10769,59,44,2,0,13,46
10770,18,1,11,4,2,16
10771,26,8,12,0,6,20
10772,68,25,26,4,13,55
10773,46,18,20,0,8,38
10774,468,136,191,37,104,364
10775,33,9,16,0,8,25
10776,109,48,30,11,20,89
10777,32,15,9,0,8,24
10778,69,44,12,1,12,57
10779,15,2,5,2,6,9
10780,130,73,35,1,21,109
10781,47,18,21,0,8,39
10782,55,32,9,0,14,41
10783,52,31,11,1,9,43
10784,38,6,3,20,9,29
10785,140,87,26,0,27,113
10786,44,19,16,1,8,36
10787,42,28,4,2,8,34
10788,39,20,10,1,8,31
10789,84,30,27,10,17,67
10790,207,56,113,4,34,173
10791,12,2,8,0,2,10
10792,20,0,18,0,2,18
10793,51,33,10,1,7,44
10794,58,28,21,0,9,49
10795,18,3,13,0,2,16
10796,135,61,26,20,28,107
10797,178,100,33,0,45,133
10798,24,6,9,0,9,15
10799,215,59,107,1,48,167
10800,38,22,8,3,5,33
10801,183,110,6,23,44,139
10802,70,56,2,0,12,58
10803,46,18,20,0,8,38
10804,65,43,2,2,18,47
10805,190,60,93,0,37,153
10806,23,6,3,6,8,15
10807,218,106,45,23,44,174
10808,202,108,61,0,33,169
10809,24,6,13,0,5,19
10810,97,30,40,10,17,80
10811,33,13,12,0,8,25
10812,102,57,24,3,18,84
10813,178,101,32,0,45,133
10814,46,18,20,0,8,38
10815,126,57,33,12,24,102
10816,34,19,8,0,7,27
10817,31,12,9,3,7,24
10818,27,6,16,0,5,22
10819,130,99,1,1,29,101
10820,293,131,90,15,57,236
10821,91,52,22,4,13,78
10822,391,224,87,0,80,311
10823,67,36,13,2,16,51
10824,81,19,31,12,19,62
10825,65,37,18,0,10,55
10826,58,21,29,0,8,50
10827,212,157,18,2,35,177
10828,84,46,20,0,18,66
10829,154,21,76,25,32,122
10830,41,8,23,2,8,33
10831,155,98,31,0,26,129
10832,349,150,125,6,68,281
10833,58,26,23,2,7,51
10834,37,20,6,2,9,28
10835,165,69,37,27,32,133
10836,28,12,11,0,5,23
10837,34,13,10,5,6,28
10838,20,11,3,0,6,14
10839,381,175,126,6,74,307
10840,18,2,14,0,2,16
10841,111,87,3,0,21,90
10842,157,99,3,18,37,120
10843,31,15,8,0,8,23
10844,27,16,8,0,3,24
10845,41,9,24,0,8,33
10846,51,29,9,0,13,38
10847,59,14,32,0,13,46
10848,43,20,12,0,11,32
10849,20,3,9,1,7,13
10850,95,64,6,0,25,70
10851,68,26,14,14,14,54
10852,19,13,3,0,3,16
10853,111,36,52,1,22,89
10854,461,213,146,11,91,370
10855,84,45,18,1,20,64
10856,86,21,47,2,16,70
10857,236,170,21,5,40,196
10858,74,11,48,0,15,59
10859,43,18,12,3,10,33
10860,130,37,67,0,26,104
10861,68,20,21,9,18,50
10862,45,31,1,0,13,32
10863,423,205,140,6,72,351
10864,58,28,14,2,14,44
10865,67,37,15,3,12,55
10866,44,17,12,3,12,32
10867,65,36,21,0,8,57
10868,63,38,13,0,12,51
10869,12,6,1,0,5,7
10870,83,57,5,7,14,69
10871,117,53,25,14,25,92
10872,140,48,68,0,24,116
10873,117,28,55,5,29,88
10874,14,5,5,0,4,10
10875,47,27,12,0,8,39
10876,32,21,9,0,2,30
10877,46,30,8,1,7,39
10878,59,15,23,7,14,45
10879,91,25,44,8,14,77
10880,196,117,45,0,34,162
10881,75,21,27,1,26,49
10882,101,39,36,0,26,75
10883,141,85,29,0,27,114
10884,19,8,8,1,2,17
10885,10,8,1,0,1,9
10886,497,295,89,6,107,390
10887,20,10,4,1,5,15
10888,52,22,19,1,10,42
10889,13,2,9,0,2,11
10890,16,2,13,0,1,15
10891,181,75,36,27,43,138
10892,55,25,16,2,12,43
10893,25,12,6,2,5,20
10894,78,40,26,4,8,70
10895,32,7,9,8,8,24
10896,32,21,9,0,2,30
10897,30,0,25,0,5,25
10898,247,187,13,0,47,200
10899,193,75,34,34,50,143
10900,40,1,33,0,6,34
10901,136,87,28,0,21,115
10902,199,75,52,30,42,157
10903,8,2,5,0,1,7
10904,17,9,5,0,3,14
10905,49,30,7,0,12,37
10906,7,4,0,1,2,5
10907,87,32,29,10,16,71
10908,88,42,14,14,18,70
10909,29,2,20,1,6,23
10910,455,234,114,11,96,359
10911,83,30,32,5,16,67
10912,567,319,109,13,126,441
10913,18,4,9,0,5,13
10914,49,20,22,0,7,42
10915,46,18,20,0,8,38
10916,75,21,28,0,26,49
10917,216,38,137,0,41,175
10918,62,39,12,1,10,52
10919,124,67,10,23,24,100
10920,165,61,49,26,29,136
10921,252,80,120,12,40,212
10922,5,5,0,0,0,5
10923,17,1,13,0,3,14
10924,19,3,15,0,1,18
10925,45,25,8,4,8,37
10926,53,30,8,3,12,41
10927,70,36,22,0,12,58
10928,322,150,92,17,63,259
10929,80,18,32,12,18,62
10930,230,140,7,31,52,178
10931,33,4,19,2,8,25
10932,189,76,84,4,25,164
10933,54,0,34,3,17,37
10934,23,4,14,1,4,19
10935,22,11,6,0,5,17
10936,19,2,10,0,7,12
10937,7,2,2,2,1,6
10938,90,38,23,10,19,71
10939,146,36,76,1,33,113
10940,63,33,10,7,13,50
10941,265,55,145,3,62,203
10942,60,30,15,4,11,49
10943,22,8,9,1,4,18
10944,340,181,100,0,59,281
10945,32,12,16,0,4,28
10946,157,52,46,32,27,130
10947,24,4,17,0,3,21
10948,44,29,6,0,9,35
10949,127,55,20,18,34,93
10950,30,15,6,1,8,22
10951,310,175,77,0,58,252
10952,90,55,20,3,12,78
10953,40,16,13,0,11,29
10954,26,18,0,0,8,18
10955,127,77,25,0,25,102
10956,286,160,35,33,58,228
10957,14,6,2,0,6,8
10958,5,2,2,0,1,4
10959,70,39,18,0,13,57
10960,77,54,2,2,19,58
10961,76,42,20,0,14,62
10962,191,129,47,2,13,178
10963,68,26,33,0,9,59
10964,100,42,36,4,18,82
10965,46,28,12,0,6,40
10966,78,44,10,3,21,57
10967,103,33,26,25,19,84
10968,56,25,22,0,9,47
10969,46,32,9,0,5,41
10970,47,14,19,2,12,35
10971,6,3,1,0,2,4
10972,78,38,21,3,16,62
10973,5,2,2,0,1,4
10974,244,185,13,0,46,198
10975,177,132,18,1,26,151
10976,46,18,20,0,8,38
10977,105,57,23,0,25,80
10978,50,17,17,8,8,42
10979,70,35,17,0,18,52
10980,470,228,93,49,100,370
10981,138,85,27,0,26,112
10982,9,2,2,3,2,7
10983,70,24,19,7,20,50
10984,375,193,104,17,61,314
10985,85,41,17,5,22,63
10986,182,52,28,71,31,151
10987,40,12,15,6,7,33
10988,2,0,2,0,0,2
10989,6,1,3,0,2,4
10990,186,70,47,29,40,146
10991,54,26,14,1,13,41
10992,56,3,40,1,12,44
10993,571,373,77,4,117,454
10994,8,1,5,0,2,6
10995,45,22,7,3,13,32
10996,518,376,31,1,110,408
10997,79,21,42,2,14,65
10998,13,4,4,3,2,11
10999,165,50,85,0,30,135
11000,57,22,17,11,7,50
11001,107,69,11,4,23,84
11002,135,103,4,2,26,109
11003,22,10,9,0,3,19
11004,48,14,23,0,11,37
11005,20,3,14,0,3,17
11006,153,118,2,2,31,122
11007,37,9,23,0,5,32
11008,28,10,10,2,6,22
11009,33,6,13,7,7,26
11010,32,21,9,0,2,30
11011,12,10,1,0,1,11
11012,75,57,6,1,11,64
11013,48,24,16,0,8,40
11014,79,37,20,3,19,60
11015,12,6,5,0,1,11
11016,610,420,57,1,132,478
11017,120,59,27,13,21,99
11018,77,41,24,4,8,69
11019,108,38,39,5,26,82
11020,92,44,32,1,15,77
11021,100,65,20,0,15,85
11022,22,6,9,3,4,18
11023,293,152,80,14,47,246
11024,365,186,105,1,73,292
11025,31,9,19,0,3,28
11026,120,59,22,16,23,97
11027,190,121,25,3,41,149
11028,249,129,84,0,36,213
11029,61,14,12,24,11,50
11030,115,40,28,29,18,97
11031,354,160,110,11,73,281
11032,25,10,11,0,4,21
11033,27,10,11,0,6,21
11034,41,15,13,5,8,33
11035,24,12,3,0,9,15
11036,149,59,31,25,34,115
11037,64,37,16,0,11,53
11038,25,5,11,0,9,16
11039,105,67,7,7,24,81
11040,85,27,26,12,20,65
11041,148,53,36,29,30,118
11042,72,46,12,3,11,61
11043,49,20,6,16,7,42
11044,213,113,48,0,52,161
11045,61,28,5,14,14,47
11046,449,156,153,47,93,356
11047,30,3,21,0,6,24
11048,92,64,11,0,17,75
11049,169,50,94,4,21,148
11050,27,21,1,0,5,22
11051,42,11,22,0,9,33
11052,334,177,87,15,55,279
11053,59,25,23,3,8,51
11054,545,373,49,1,122,423
11055,680,407,133,23,117,563
11056,152,98,29,0,25,127
11057,139,80,13,19,27,112
11058,56,22,23,0,11,45
11059,63,22,17,15,9,54
11060,53,23,21,2,7,46
11061,61,24,25,0,12,49
11062,169,53,90,4,22,147
11063,23,1,15,0,7,16
11064,32,6,19,2,5,27
11065,65,36,12,2,15,50
11066,16,6,9,0,1,15
11067,75,16,15,32,12,63
11068,79,39,21,7,12,67
11069,28,16,3,4,5,23
11070,52,24,16,1,11,41
11071,38,6,3,20,9,29
11072,156,75,49,1,31,125
11073,38,9,23,3,3,35
11074,51,25,16,1,9,42
11075,39,3,26,0,10,29
11076,164,76,33,27,28,136
11077,31,14,9,3,5,26
11078,15,8,1,5,1,14
11079,18,11,2,1,4,14
11080,108,51,38,1,18,90
11081,142,90,29,0,23,119
11082,32,21,9,0,2,30
11083,31,9,16,1,5,26
11084,57,9,36,2,10,47
11085,96,33,41,10,12,84
11086,66,33,17,2,14,52
11087,33,2,23,1,7,26
11088,27,17,7,1,2,25
11089,42,9,19,2,12,30
11090,54,22,21,1,10,44
11091,43,25,3,8,7,36
11092,37,7,11,8,11,26
11093,56,2,38,0,16,40
11094,0,0,0,0,0,0
11095,38,8,26,2,2,36
11096,126,98,8,2,18,108
11097,283,94,128,15,46,237
11098,24,12,10,1,1,23
11099,65,27,20,7,11,54
11100,41,3,30,2,6,35
11101,101,36,38,5,22,79
11102,2,1,1,0,0,2
11103,17,9,5,1,2,15
11104,107,30,46,9,22,85
11105,32,6,20,1,5,27
11106,75,31,19,1,24,51
11107,16,7,6,1,2,14
11108,32,9,18,0,5,27
11109,30,5,18,2,5,25
11110,35,18,8,0,9,26
11111,33,11,11,1,10,23
11112,75,50,7,1,17,58
11113,314,155,84,12,63,251
11114,155,80,45,0,30,125
11115,46,28,2,11,5,41
11116,24,19,2,2,1,23
11117,19,11,5,1,2,17
11118,43,17,16,2,8,35
11119,108,66,19,6,17,91
11120,18,6,8,0,4,14
11121,77,21,35,7,14,63
11122,66,48,3,0,15,51
11123,265,181,32,5,47,218
11124,97,31,39,10,17,80
11125,46,2,28,7,9,37
11126,94,51,19,1,23,71
11127,47,0,41,0,6,41
11128,21,2,14,0,5,16
11129,29,17,6,1,5,24
11130,49,32,7,0,10,39
11131,52,28,13,0,11,41
11132,17,3,12,0,2,15
11133,34,3,27,0,4,30
11134,322,189,60,6,67,255
11135,102,68,0,12,22,80
11136,15,13,0,0,2,13
11137,486,229,105,53,99,387
11138,17,12,1,0,4,13
11139,51,13,28,1,9,42
11140,14,4,6,0,4,10
11141,42,18,13,0,11,31
11142,9,5,4,0,0,9
11143,197,101,36,23,37,160
11144,41,29,0,2,10,31
11145,152,100,23,1,28,124
11146,55,29,6,4,16,39
11147,43,14,18,4,7,36
11148,57,23,23,1,10,47
11149,95,28,42,6,19,76
11150,96,23,31,25,17,79
11151,130,66,13,23,28,102
11152,9,2,2,3,2,7
11153,72,23,31,2,16,56
11154,222,96,14,75,37,185
11155,77,11,53,0,13,64
11156,68,12,43,0,13,55
11157,80,61,6,1,12,68
11158,19,8,5,0,6,13
11159,11,4,6,0,1,10
11160,616,353,143,17,103,513
11161,16,7,5,0,4,12
11162,48,8,26,4,10,38
11163,136,103,4,2,27,109
11164,83,35,34,0,14,69
11165,401,290,23,0,88,313
11166,694,408,142,20,124,570
11167,205,112,60,0,33,172
11168,17,9,3,0,5,12
11169,162,70,44,11,37,125
11170,321,193,57,0,71,250
11171,48,15,24,1,8,40
11172,10,7,1,0,2,8
11173,97,30,40,10,17,80
11174,104,50,35,0,19,85
11175,448,139,186,28,95,353
11176,294,36,200,2,56,238
11177,18,7,9,0,2,16
11178,84,49,17,0,18,66
11179,43,16,19,0,8,35
11180,133,48,59,1,25,108
11181,585,352,106,9,118,467
11182,76,10,42,5,19,57
11183,33,15,9,0,9,24
11184,15,7,7,0,1,14
11185,43,23,9,0,11,32
11186,47,18,17,0,12,35
11187,20,17,0,0,3,17
11188,15,14,0,0,1,14
11189,3,1,2,0,0,3
11190,232,176,9,0,47,185
11191,89,27,33,11,18,71
11192,144,51,36,30,27,117
11193,70,19,39,0,12,58
11194,80,22,39,4,15,65
11195,357,162,120,6,69,288
11196,95,26,48,0,21,74
11197,69,37,12,2,18,51
11198,15,9,4,0,2,13
11199,13,0,11,1,1,12
11200,63,41,13,0,9,54
11201,134,49,35,20,30,104
11202,100,35,42,0,23,77
11203,245,136,54,14,41,204
11204,101,64,22,0,15,86
11205,16,4,7,1,4,12
11206,20,15,0,0,5,15
11207,31,1,22,0,8,23
11208,28,13,6,0,9,19
11209,44,18,15,2,9,35
11210,21,1,18,0,2,19
11211,32,7,19,1,5,27
11212,34,14,11,0,9,25
11213,354,189,93,15,57,297
11214,87,70,1,0,16,71
11215,8,3,3,0,2,6
11216,3,2,1,0,0,3
11217,28,16,6,4,2,26
11218,1,1,0,0,0,1
11219,54,26,18,0,10,44
11220,146,66,27,20,33,113
11221,173,85,35,21,32,141
11222,42,18,12,4,8,34
11223,194,28,129,0,37,157
11224,28,12,7,2,7,21
11225,111,83,7,0,21,90
11226,239,159,62,2,16,223
11227,255,111,84,17,43,212
11228,52,28,9,4,11,41
11229,37,9,22,1,5,32
11230,38,19,9,0,10,28
11231,83,16,51,0,16,67
11232,38,7,20,3,8,30
11233,119,47,39,8,25,94
11234,62,30,23,1,8,54
11235,60,30,18,2,10,50
11236,22,15,2,0,5,17
11237,25,1,18,1,5,20
11238,31,22,3,0,6,25
11239,46,18,20,0,8,38
11240,28,15,6,0,7,21
11241,63,34,8,2,19,44
11242,361,265,18,2,76,285
11243,14,3,7,0,4,10
11244,48,21,16,2,9,39
11245,42,12,20,2,8,34
11246,109,58,25,4,22,87
11247,75,29,21,12,13,62
11248,33,13,15,0,5,28
11249,32,21,9,0,2,30
11250,32,21,9,0,2,30
11251,367,114,156,16,81,286
11252,360,164,121,6,69,291
11253,29,10,8,4,7,22
11254,438,251,81,22,84,354
11255,68,46,7,0,15,53
11256,33,3,22,0,8,25
11257,43,10,28,0,5,38
11258,78,40,15,9,14,64
11259,30,14,13,0,3,27
11260,46,18,20,0,8,38
11261,53,9,33,0,11,42
11262,85,24,39,2,20,65
11263,17,4,7,1,5,12
11264,204,99,60,0,45,159
11265,79,37,26,0,16,63
11266,124,68,35,1,20,104
11267,110,68,10,9,23,87
11268,477,130,202,38,107,370
11269,36,24,7,0,5,31
11270,28,17,4,0,7,21
11271,199,97,38,30,34,165
11272,105,46,26,12,21,84
11273,163,73,52,6,32,131
11274,52,36,5,1,10,42
11275,100,66,1,12,21,79
11276,575,337,129,15,94,481
11277,19,14,3,0,2,17
11278,211,106,38,31,36,175
11279,20,2,0,10,8,12
11280,37,14,14,0,9,28
11281,37,25,3,2,7,30
11282,33,22,2,0,9,24
11283,47,20,11,6,10,37
11284,374,162,116,25,71,303
11285,11,1,9,0,1,10
11286,21,18,0,0,3,18
11287,133,51,61,1,20,113
11288,173,56,62,25,30,143
11289,46,18,20,0,8,38
11290,205,111,31,23,40,165
11291,230,156,32,0,42,188
11292,8,6,0,0,2,6
11293,16,2,9,1,4,12
11294,122,52,46,6,18,104
11295,27,13,8,0,6,21
11296,16,6,3,2,5,11
11297,26,15,6,1,4,22
11298,12,2,5,0,5,7
11299,139,26,88,1,24,115
11300,673,377,164,24,108,565
11301,22,7,6,0,9,13
11302,39,5,27,1,6,33
11303,414,296,38,1,79,335
11304,43,32,3,1,7,36
11305,84,34,18,9,23,61
11306,70,49,4,0,17,53
11307,181,77,78,5,21,160
11308,152,59,38,22,33,119
11309,68,22,29,1,16,52
11310,48,13,14,7,14,34
11311,21,3,8,3,7,14
11312,19,9,8,0,2,17
11313,31,16,11,2,2,29
11314,31,7,16,1,7,24
11315,86,42,28,0,16,70
11316,14,4,5,0,5,9
11317,44,19,9,7,9,35
11318,475,345,30,0,100,375
11319,53,25,18,0,10,43
11320,102,42,46,1,13,89
11321,6,1,4,0,1,5
11322,104,67,10,2,25,79
11323,90,56,14,0,20,70
11324,88,37,34,2,15,73
11325,35,8,17,0,10,25
11326,75,40,3,17,15,60
11327,168,116,7,4,41,127
11328,33,7,18,4,4,29
11329,158,119,5,2,32,126
11330,17,4,7,3,3,14
11331,105,75,4,2,24,81
11332,38,11,18,0,9,29
11333,55,28,18,0,9,46
11334,36,7,21,1,7,29
11335,37,15,14,0,8,29
11336,132,47,26,27,32,100
11337,24,11,10,0,3,21
11338,8,2,4,1,1,7
11339,101,35,44,9,13,88
11340,11,8,1,0,2,9
11341,52,15,26,0,11,41
11342,117,58,27,7,25,92
11343,350,164,101,14,71,279
11344,46,25,10,0,11,35
11345,24,13,1,5,5,19
11346,63,13,35,1,14,49
11347,31,7,15,4,5,26
11348,17,1,13,0,3,14
11349,319,193,58,0,68,251
11350,84,41,28,3,12,72
11351,5,4,0,0,1,4
11352,349,150,122,6,71,278
11353,78,49,16,0,13,65
11354,15,3,9,1,2,13
11355,24,6,14,0,4,20
11356,228,152,33,1,42,186
11357,18,4,13,0,1,17
11358,12,5,5,0,2,10
11359,11,8,0,0,3,8
11360,61,38,11,1,11,50
11361,60,31,15,1,13,47
11362,21,0,14,0,7,14
11363,38,29,5,0,4,34
11364,15,3,11,0,1,14
11365,240,128,69,0,43,197
11366,59,25,22,1,11,48
11367,12,10,1,0,1,11
11368,83,20,50,1,12,71
11369,49,22,8,6,13,36
11370,46,18,20,0,8,38
11371,470,251,105,13,101,369
11372,155,97,28,6,24,131
11373,122,58,28,14,22,100
11374,526,309,116,14,87,439
11375,23,6,12,0,5,18
11376,46,18,20,0,8,38
11377,209,112,35,23,39,170
11378,80,60,1,0,19,61
11379,93,36,21,18,18,75
11380,66,44,9,2,11,55
11381,13,5,7,0,1,12
11382,70,48,8,4,10,60
11383,44,26,12,1,5,39
11384,84,35,5,31,13,71
11385,32,25,4,0,3,29
11386,28,17,6,0,5,23
11387,52,16,16,8,12,40
11388,58,13,35,1,9,49
11389,35,21,4,4,6,29
11390,31,10,14,3,4,27
11391,43,4,33,2,4,39
11392,177,39,46,59,33,144
11393,60,31,20,0,9,51
11394,83,43,16,8,16,67
11395,46,18,20,0,8,38
11396,22,7,11,2,2,20
11397,89,45,28,3,13,76
11398,103,34,5,45,19,84
11399,44,8,28,1,7,37
11400,130,50,52,5,23,107
11401,144,70,37,0,37,107
11402,144,76,31,7,30,114
11403,208,114,32,23,39,169
11404,160,28,102,1,29,131
11405,1077,389,437,46,205,872
11406,285,53,177,1,54,231
11407,341,144,120,6,71,270
11408,71,54,5,4,8,63
11409,74,31,19,1,23,51
11410,291,140,95,5,51,240
11411,360,273,20,0,67,293
11412,278,91,128,15,44,234
11413,5,1,2,1,1,4
11414,46,14,20,4,8,38
11415,0,0,0,0,0,0
11416,37,21,8,0,8,29
11417,98,38,35,0,25,73
11418,442,215,115,17,95,347
11419,39,16,10,3,10,29
11420,56,35,12,3,6,50
11421,27,12,6,4,5,22
11422,47,23,14,1,9,38
11423,6,0,5,1,0,6
11424,369,188,108,1,72,297
11425,58,24,14,6,14,44
11426,623,361,128,18,116,507
11427,49,29,10,0,10,39
11428,511,362,37,1,111,400
11429,301,138,107,0,56,245
11430,19,1,15,0,3,16
11431,21,1,13,3,4,17
11432,8,5,3,0,0,8
11433,58,3,43,2,10,48
11434,324,187,59,12,66,258
11435,16,2,9,1,4,12
11436,79,55,4,0,20,59
11437,146,81,17,20,28,118
11438,464,219,101,43,101,363
11439,166,124,4,1,37,129
11440,314,163,85,15,51,263
11441,36,9,19,0,8,28
11442,65,43,9,4,9,56
11443,342,171,97,1,73,269
11444,160,70,50,5,35,125
11445,85,38,30,0,17,68
11446,105,30,57,0,18,87
11447,39,23,8,0,8,31
11448,336,154,111,6,65,271
11449,41,14,18,1,8,33
11450,46,18,20,0,8,38
11451,212,71,81,13,47,165
11452,20,11,2,0,7,13
11453,255,194,13,0,48,207
11454,465,218,143,12,92,373
11455,53,4,35,9,5,48
11456,79,53,10,0,16,63
11457,45,11,26,1,7,38
11458,6,0,5,0,1,5
11459,210,113,62,0,35,175
11460,2,1,1,0,0,2
11461,53,32,5,0,16,37
11462,149,86,27,1,35,114
11463,172,136,10,1,25,147
11464,49,25,15,4,5,44
11465,108,56,22,5,25,83
11466,14,6,6,0,2,12
11467,419,185,103,45,86,333
11468,46,18,20,0,8,38
11469,37,16,13,0,8,29
11470,190,122,31,5,32,158
11471,116,76,24,3,13,103
11472,18,6,9,0,3,15
11473,0,0,0,0,0,0
11474,50,24,19,0,7,43
11475,88,21,39,6,22,66
11476,1,1,0,0,0,1
11477,28,17,8,3,0,28
11478,31,20,5,0,6,25
11479,2,1,1,0,0,2
11480,16,2,9,1,4,12
11481,84,17,41,9,17,67
11482,246,87,112,3,44,202
11483,1276,514,174,336,252,1024
11484,111,74,15,1,21,90
11485,297,161,69,0,67,230
11486,59,23,12,10,14,45
11487,76,44,9,2,21,55
11488,24,0,17,0,7,17
11489,10,1,7,0,2,8
11490,25,4,17,0,4,21
11491,46,9,27,4,6,40
11492,182,128,15,1,38,144
11493,144,101,16,2,25,119
11494,46,21,9,5,11,35
11495,38,19,11,1,7,31
11496,372,169,115,12,76,296
11497,70,48,12,0,10,60
11498,106,74,18,0,14,92
11499,45,29,5,5,6,39
11500,55,18,31,0,6,49
11501,32,21,9,0,2,30
11502,103,84,2,2,15,88
11503,104,74,12,10,8,96
11504,38,6,4,19,9,29
11505,99,53,28,14,4,95
11506,94,53,25,1,15,79
11507,130,68,13,22,27,103
11508,38,21,12,0,5,33
11509,69,60,2,0,7,62
11510,41,27,5,0,9,32
11511,54,39,8,0,7,47
11512,27,5,15,1,6,21
11513,39,34,0,0,5,34
11514,20,9,3,2,6,14
11515,21,5,10,0,6,15
11516,90,20,44,15,11,79
11517,17,6,9,0,2,15
11518,34,10,18,5,1,33
11519,15,9,1,4,1,14
11520,43,13,15,8,7,36
11521,21,8,3,6,4,17
11522,170,112,27,1,30,140
11523,21,10,10,0,1,20
11524,202,132,50,4,16,186
11525,70,48,12,0,10,60
11526,126,71,22,5,28,98
11527,26,0,20,3,3,23
11528,52,17,23,2,10,42
11529,77,44,10,5,18,59
11530,605,338,146,19,102,503
11531,355,154,126,6,69,286
11532,86,35,31,3,17,69
11533,42,8,16,11,7,35
11534,27,6,16,0,5,22
11535,26,16,4,0,6,20
11536,47,15,25,3,4,43
11537,33,24,5,0,4,29
11538,29,10,15,0,4,25
11539,14,6,1,3,4,10
11540,435,137,181,24,93,342
11541,100,68,11,3,18,82
11542,658,386,144,16,112,546
11543,58,44,1,0,13,45
11544,17,11,3,0,3,14
11545,15,3,11,0,1,14
11546,70,59,0,1,10,60
11547,116,79,14,0,23,93
11548,18,6,3,3,6,12
11549,44,8,15,9,12,32
11550,64,41,5,0,18,46
11551,7,3,3,0,1,6
11552,363,196,91,15,61,302
11553,56,37,12,0,7,49
11554,79,45,14,1,19,60
11555,35,19,11,1,4,31
11556,82,13,44,4,21,61
11557,473,198,122,49,104,369
11558,400,230,87,15,68,332
11559,79,43,20,4,12,67
11560,276,135,81,5,55,221
11561,120,57,15,25,23,97
11562,122,90,4,2,26,96
11563,133,103,11,0,19,114
11564,336,189,67,13,67,269
11565,75,53,7,3,12,63
11566,157,48,49,24,36,121
11567,171,44,18,81,28,143
11568,154,6,89,26,33,121
11569,100,34,26,21,19,81
11570,206,83,84,2,37,169
11571,32,0,29,1,2,30
11572,36,22,8,1,5,31
11573,22,13,6,0,3,19
11574,120,57,25,16,22,98
11575,412,196,131,9,76,336
11576,90,35,38,3,14,76
11577,31,11,17,0,3,28
11578,29,14,9,4,2,27
11579,41,20,12,0,9,32
11580,5,4,0,0,1,4
11581,24,8,12,0,4,20
11582,12,6,4,1,1,11
11583,143,81,37,1,24,119
11584,45,25,11,3,6,39
11585,85,53,6,11,15,70
11586,82,48,21,0,13,69
11587,26,12,8,0,6,20
11588,14,4,7,0,3,11
11589,63,41,4,0,18,45
11590,138,54,57,1,26,112
11591,28,6,19,0,3,25
11592,23,11,5,4,3,20
11593,66,21,29,0,16,50
11594,96,26,36,12,22,74
11595,202,87,57,20,38,164
11596,76,36,19,8,13,63
11597,226,88,14,81,43,183
11598,95,27,53,2,13,82
11599,28,4,19,1,4,24
11600,35,9,14,1,11,24
11601,342,258,19,2,63,279
11602,50,18,17,2,13,37
11603,114,32,32,27,23,91
11604,7,4,0,2,1,6
11605,269,79,130,17,43,226
11606,28,8,15,0,5,23
11607,27,11,8,1,7,20
11608,5,0,3,0,2,3
11609,44,7,28,5,4,40
11610,137,73,33,0,31,106
11611,20,8,8,0,4,16
11612,36,9,15,4,8,28
11613,61,49,2,0,10,51
11614,27,17,5,0,5,22
11615,54,31,16,0,7,47
11616,18,6,9,0,3,15
11617,53,36,3,1,13,40
11618,52,20,14,1,17,35
11619,52,20,17,1,14,38
11620,26,14,11,0,1,25
11621,63,35,17,0,11,52
11622,23,3,17,0,3,20
11623,79,27,34,4,14,65
11624,24,2,18,0,4,20
11625,33,1,25,1,6,27
11626,140,85,14,10,31,109
11627,146,81,20,22,23,123
11628,31,11,6,7,7,24
11629,21,14,6,0,1,20
11630,112,27,62,1,22,90
11631,101,39,23,25,14,87
11632,63,2,43,4,14,49
11633,12,2,5,0,5,7
11634,55,20,15,4,16,39
11635,68,11,39,0,18,50
11636,44,10,14,9,11,33
11637,53,26,16,1,10,43
11638,124,54,19,18,33,91
11639,58,14,34,1,9,49
11640,213,155,24,1,33,180
11641,489,266,102,13,108,381
11642,290,39,190,4,57,233
11643,108,25,39,25,19,89
11644,67,46,4,0,17,50
11645,17,7,7,0,3,14
11646,518,274,118,18,108,410
11647,5,2,2,0,1,4
11648,438,216,114,14,94,344
11649,14,3,10,0,1,13
11650,92,49,26,4,13,79
11651,15,3,4,2,6,9
11652,33,17,12,1,3,30
11653,348,189,99,0,60,288
11654,22,8,8,0,6,16
11655,113,84,7,15,7,106
11656,66,11,44,0,11,55
11657,42,12,16,7,7,35
11658,15,6,4,1,4,11
11659,57,19,20,5,13,44
11660,213,113,48,0,52,161
11661,10,2,8,0,0,10
11662,81,27,38,2,14,67
11663,31,18,7,1,5,26
11664,228,153,34,0,41,187
11665,203,60,19,91,33,170
11666,68,46,7,0,15,53
11667,131,76,27,0,28,103
11668,79,24,26,8,21,58
11669,39,12,15,2,10,29
11670,108,57,16,12,23,85
11671,26,4,14,1,7,19
11672,111,59,23,1,28,83
11673,56,33,8,1,14,42
11674,124,29,41,29,25,99
11675,140,40,68,1,31,109
11676,50,1,16,25,8,42
11677,97,47,28,5,17,80
11678,22,18,2,0,2,20
11679,189,60,61,24,44,145
11680,29,1,23,2,3,26
11681,51,34,5,1,11,40
11682,82,57,8,2,15,67
11683,56,3,40,1,12,44
11684,73,27,33,3,10,63
11685,210,113,62,0,35,175
11686,73,45,11,2,15,58
11687,114,107,0,7,0,114
11688,126,64,27,10,25,101
11689,181,132,11,2,36,145
11690,2,0,1,0,1,1
11691,32,21,9,0,2,30
11692,336,142,118,6,70,266
11693,37,7,21,0,9,28
11694,11,8,1,0,2,9
11695,102,42,30,8,22,80
11696,12,3,4,0,5,7
11697,82,41,16,8,17,65
11698,27,10,9,2,6,21
11699,71,44,16,0,11,60
11700,32,21,9,0,2,30
11701,16,0,13,0,3,13
11702,31,16,13,1,1,30
11703,38,19,8,0,11,27
11704,12,0,10,0,2,10
11705,23,16,3,0,4,19
11706,13,2,8,0,3,10
11707,196,131,20,0,45,151
11708,161,100,10,14,37,124
11709,179,101,32,0,46,133
11710,131,41,49,16,25,106
11711,32,9,20,0,3,29
11712,33,14,12,0,7,26
11713,62,21,26,1,14,48
11714,17,6,6,1,4,13
11715,77,37,22,3,15,62
11716,189,75,45,22,47,142
11717,540,325,105,11,99,441
11718,157,66,53,15,23,134
11719,16,9,1,3,3,13
11720,79,36,24,5,14,65
11721,20,2,12,1,5,15
11722,31,13,10,2,6,25
11723,96,52,24,4,16,80
11724,77,42,17,2,16,61
11725,112,77,18,0,17,95
11726,26,4,12,5,5,21
11727,42,3,30,2,7,35
11728,21,0,13,1,7,14
11729,13,5,4,0,4,9
11730,102,46,35,4,17,85
11731,11,3,5,0,3,8
11732,113,56,27,7,23,90
11733,12,3,6,2,1,11
11734,123,51,31,18,23,100
11735,104,52,28,5,19,85
11736,32,21,9,0,2,30
11737,142,87,27,0,28,114
11738,122,39,46,4,33,89
11739,16,2,6,0,8,8
11740,50,19,17,1,13,37
11741,25,11,11,0,3,22
11742,79,49,16,0,14,65
11743,43,5,29,0,9,34
11744,13,2,8,0,3,10
11745,122,29,67,1,25,97
11746,55,28,14,0,13,42
11747,52,35,6,1,10,42
11748,28,15,8,0,5,23
11749,101,32,40,10,19,82
11750,425,127,175,32,91,334
11751,32,21,9,0,2,30
11752,115,46,26,24,19,96
11753,573,336,127,15,95,478
11754,32,21,9,0,2,30
11755,91,49,11,10,21,70
11756,24,11,5,2,6,18
11757,109,58,25,4,22,87
11758,133,87,32,1,13,120
11759,21,10,4,0,7,14
11760,63,13,39,1,10,53
11761,107,52,37,0,18,89
11762,29,11,12,0,6,23
11763,447,139,188,25,95,352
11764,62,23,27,1,11,51
11765,29,19,6,0,4,25
11766,49,6,31,0,12,37
11767,25,17,6,1,1,24
11768,45,34,0,0,11,34
11769,157,54,40,30,33,124
11770,22,14,6,0,2,20
11771,14,2,9,0,3,11
11772,193,139,16,2,36,157
11773,12,4,7,0,1,11
11774,87,32,39,1,15,72
11775,5,4,1,0,0,5
11776,57,36,6,0,15,42
11777,104,49,5,33,17,87
11778,35,19,9,0,7,28
11779,122,42,38,19,23,99
11780,137,37,68,1,31,106
11781,476,221,154,13,88,388
11782,17,13,0,1,3,14
11783,13,6,3,1,3,10
11784,157,100,3,17,37,120
11785,93,48,18,2,25,68
11786,133,35,72,0,26,107
11787,204,29,95,32,48,156
11788,4,0,4,0,0,4
11789,19,10,3,0,6,13
11790,103,22,49,13,19,84
11791,56,26,19,0,11,45
11792,89,34,19,8,28,61
11793,25,0,22,0,3,22
11794,28,11,13,0,4,24
11795,159,34,52,39,34,125
11796,178,127,13,1,37,141
11797,97,51,28,1,17,80
11798,61,33,18,1,9,52
11799,44,23,15,0,6,38
11800,67,21,25,2,19,48
11801,40,13,13,6,8,32
11802,50,29,11,0,10,40
11803,118,62,22,11,23,95
11804,550,383,47,1,119,431
11805,31,12,3,5,11,20
11806,83,57,15,1,10,73
11807,304,147,91,1,65,239
11808,34,13,14,0,7,27
11809,15,9,4,0,2,13
11810,172,102,32,5,33,139
11811,106,18,55,13,20,86
11812,91,41,32,3,15,76
11813,33,15,11,0,7,26
11814,91,29,46,0,16,75
11815,163,92,22,20,29,134
11816,46,18,20,1,7,39
11817,42,17,20,0,5,37
11818,29,14,4,5,6,23
11819,125,42,67,0,16,109
11820,101,38,31,8,24,77
11821,90,39,12,23,16,74
11822,111,44,38,6,23,88
11823,49,21,13,3,12,37
11824,4,1,1,1,1,3
11825,55,32,15,2,6,49
11826,68,37,16,0,15,53
11827,14,8,0,2,4,10
11828,149,57,39,21,32,117
11829,36,6,27,0,3,33
11830,6,3,2,1,0,6
11831,93,23,51,0,19,74
11832,26,12,5,3,6,20
11833,8,0,6,0,2,6
11834,53,21,15,6,11,42
11835,22,3,13,2,4,18
11836,23,8,10,0,5,18
11837,12,5,4,0,3,9
11838,57,10,19,20,8,49
11839,50,34,2,1,13,37
11840,34,14,13,0,7,27
11841,13,1,6,0,6,7
11842,93,66,13,0,14,79
11843,49,32,6,2,9,40
11844,168,53,12,74,29,139
11845,16,2,9,1,4,12
11846,39,8,21,2,8,31
11847,97,27,41,0,29,68
11848,124,68,9,23,24,100
11849,83,39,30,4,10,73
11850,31,10,16,0,5,26
11851,652,385,140,17,110,542
11852,22,12,6,2,2,20
11853,116,36,30,21,29,87
11854,37,26,8,3,0,37
11855,518,369,37,1,111,407
11856,74,37,25,4,8,66
11857,80,44,16,4,16,64
11858,204,52,26,95,31,173
11859,64,41,13,2,8,56
11860,11,3,3,0,5,6
11861,41,11,24,4,2,39
11862,78,41,4,17,16,62
11863,4,0,3,0,1,3
11864,40,11,19,1,9,31
11865,29,7,16,1,5,24
11866,92,47,34,2,9,83
11867,178,81,57,5,35,143
11868,46,24,3,11,8,38
11869,24,9,9,0,6,18
11870,46,18,20,0,8,38
11871,61,32,19,0,10,51
11872,74,32,24,6,12,62
11873,535,299,116,17,103,432
11874,398,193,117,14,74,324
11875,198,65,80,13,40,158
11876,6,3,0,0,3,3
11877,100,35,43,0,22,78
11878,109,49,38,1,21,88
11879,72,22,24,6,20,52
11880,32,21,9,0,2,30
11881,185,102,21,19,43,142
11882,176,75,26,30,45,131
11883,254,174,32,3,45,209
11884,22,0,19,1,2,20
11885,89,54,19,4,12,77
11886,277,76,131,6,64,213
11887,13,3,8,0,2,11
11888,27,7,9,4,7,20
11889,33,13,8,7,5,28
11890,93,81,2,0,10,83
11891,4,1,3,0,0,4
11892,384,193,114,2,75,309
11893,42,22,10,0,10,32
11894,17,6,5,1,5,12
11895,144,39,65,3,37,107
11896,124,50,31,19,24,100
11897,49,23,8,7,11,38
11898,62,31,19,0,12,50
11899,7,3,3,0,1,6
11900,10,8,0,0,2,8
11901,29,2,21,0,6,23
11902,139,44,64,6,25,114
11903,52,30,7,0,15,37
11904,432,105,181,46,100,332
11905,40,14,20,0,6,34
11906,220,150,29,0,41,179
11907,125,90,5,4,26,99
11908,27,11,11,0,5,22
11909,116,47,25,21,23,93
11910,3,1,0,1,1,2
11911,53,26,17,0,10,43
11912,660,365,163,24,108,552
11913,66,46,9,0,11,55
11914,42,27,0,6,9,33
11915,51,12,28,4,7,44
11916,37,12,15,1,9,28
11917,166,54,75,0,37,129
11918,272,204,15,0,53,219
11919,30,16,7,2,5,25
11920,43,31,1,0,11,32
11921,468,221,96,49,102,366
11922,15,7,4,0,4,11
11923,87,26,19,22,20,67
11924,22,9,10,1,2,20
11925,48,28,5,6,9,39
11926,100,42,18,20,20,80
11927,167,15,95,23,34,133
11928,32,21,9,0,2,30
11929,46,21,17,0,8,38
11930,88,72,1,0,15,73
11931,43,7,24,2,10,33
11932,30,11,14,0,5,25
11933,115,24,37,26,28,87
11934,197,76,36,34,51,146
11935,207,145,48,2,12,195
11936,129,75,13,20,21,108
11937,24,3,18,0,3,21
11938,32,21,9,0,2,30
11939,73,49,9,2,13,60
11940,74,6,45,6,17,57
11941,49,25,3,13,8,41
11942,78,31,20,8,19,59
11943,32,21,9,0,2,30
11944,22,6,13,0,3,19
11945,16,11,2,0,3,13
11946,120,53,41,5,21,99
11947,21,5,10,0,6,15
11948,61,35,16,0,10,51
11949,92,64,7,0,21,71
11950,19,7,8,0,4,15
11951,82,42,12,8,20,62
11952,100,34,32,12,22,78
11953,74,53,0,2,19,55
11954,48,18,12,3,15,33
11955,131,71,20,16,24,107
11956,479,227,119,30,103,376
11957,12,11,0,0,1,11
11958,27,12,7,2,6,21
11959,68,52,5,4,7,61
11960,21,3,15,0,3,18
11961,139,54,35,15,35,104
11962,37,14,10,0,13,24
11963,17,6,3,5,3,14
11964,32,2,22,1,7,25
11965,68,38,10,7,13,55
11966,70,48,12,0,10,60
11967,32,15,2,5,10,22
11968,457,259,92,12,94,363
11969,192,72,50,29,41,151
11970,133,73,23,3,34,99
11971,61,18,32,1,10,51
11972,14,7,2,4,1,13
11973,90,21,49,0,20,70
11974,35,18,10,1,6,29
11975,31,17,8,0,6,25
11976,559,382,60,2,115,444
11977,57,8,32,2,15,42
11978,42,13,22,0,7,35
11979,180,127,13,1,39,141
11980,36,11,14,6,5,31
11981,49,24,13,0,12,37
11982,342,145,120,6,71,271
11983,7,5,1,0,1,6
11984,149,86,27,1,35,114
11985,8,0,7,0,1,7
11986,52,21,13,3,15,37
11987,63,32,13,7,11,52
11988,238,72,110,6,50,188
11989,56,18,31,0,7,49
11990,129,44,49,11,25,104
11991,29,11,14,0,4,25
11992,46,18,20,0,8,38
11993,61,33,17,1,10,51
11994,226,142,64,3,17,209
11995,38,20,14,0,4,34
11996,372,187,94,11,80,292
11997,13,8,3,1,1,12
11998,36,11,14,0,11,25
11999,183,146,9,0,28,155
12000,54,22,21,1,10,44
12001,21,0,14,0,7,14
12002,252,138,58,15,41,211
12003,81,35,30,0,16,65
12004,35,8,17,0,10,25
12005,59,30,19,0,10,49
12006,31,4,17,5,5,26
12007,6,2,1,0,3,3
12008,166,111,26,0,29,137
12009,30,8,17,1,4,26
12010,149,61,44,15,29,120
12011,77,44,18,0,15,62
12012,27,12,12,0,3,24
12013,3,2,1,0,0,3
12014,53,16,31,0,6,47
12015,69,48,9,1,11,58
12016,86,57,13,0,16,70
12017,108,33,40,13,22,86
12018,86,64,7,0,15,71
12019,1,0,1,0,0,1
12020,215,165,8,0,42,173
12021,461,237,112,13,99,362
12022,22,9,8,1,4,18
12023,28,6,7,6,9,19
12024,177,132,18,1,26,151
12025,70,51,7,2,10,60
12026,63,30,14,0,19,44
12027,39,18,4,5,12,27
12028,9,6,0,0,3,6
12029,41,16,14,0,11,30
12030,37,7,21,2,7,30
12031,62,42,8,4,8,54
12032,663,367,164,24,108,555
12033,209,111,35,23,40,169
12034,66,35,13,0,18,48
12035,75,27,22,8,18,57
12036,24,8,7,0,9,15
12037,19,6,1,7,5,14
12038,1025,386,401,46,192,833
12039,311,91,121,24,75,236
12040,78,22,41,2,13,65
12041,72,30,26,0,16,56
12042,14,7,3,0,4,10
12043,8,4,0,0,4,4
12044,41,20,16,0,5,36
12045,88,29,31,12,16,72
12046,156,66,36,18,36,120
12047,31,16,9,2,4,27
12048,86,51,19,4,12,74
12049,28,9,17,0,2,26
12050,58,13,23,12,10,48
12051,302,154,102,0,46,256
12052,66,12,35,0,19,47
12053,8,0,7,0,1,7
12054,76,56,7,1,12,64
12055,33,12,10,0,11,22
12056,13,4,5,0,4,9
12057,45,25,13,0,7,38
12058,24,10,11,0,3,21
12059,137,94,18,1,24,113
12060,145,69,27,24,25,120
12061,3,3,0,0,0,3
12062,19,2,15,0,2,17
12063,80,38,28,4,10,70
12064,16,9,6,0,1,15
12065,461,337,22,0,102,359
12066,65,7,47,0,11,54
12067,33,3,5,17,8,25
12068,18,14,1,0,3,15
12069,308,167,71,0,70,238
12070,33,8,17,0,8,25
12071,11,1,9,0,1,10
12072,10,0,9,0,1,9
12073,74,42,13,5,14,60
12074,377,193,100,19,65,312
12075,118,52,32,8,26,92
12076,23,10,6,0,7,16
12077,26,8,12,0,6,20
12078,79,36,28,0,15,64
12079,0,0,0,0,0,0
12080,27,19,4,2,2,25
12081,56,8,34,0,14,42
12082,76,43,17,0,16,60
12083,164,80,49,6,29,135
12084,130,48,55,5,22,108
12085,104,83,4,9,8,96
12086,34,17,12,0,5,29
12087,31,3,21,0,7,24
12088,50,3,38,1,8,42
12089,141,92,18,0,31,110
12090,74,19,26,12,17,57
12091,59,29,11,5,14,45
12092,15,12,0,0,3,12
12093,10,0,6,0,4,6
12094,31,14,11,1,5,26
12095,431,118,197,14,102,329
12096,149,81,14,25,29,120
12097,345,146,122,6,71,274
12098,657,383,147,20,107,550
12099,318,141,119,5,53,265
12100,89,38,28,3,20,69
12101,10,4,6,0,0,10
12102,152,87,37,1,27,125
12103,63,17,28,0,18,45
12104,101,65,6,7,23,78
12105,36,16,11,0,9,27
12106,246,71,127,1,47,199
12107,105,49,35,4,17,88
12108,59,30,12,0,17,42
12109,386,132,130,42,82,304
12110,175,63,62,17,33,142
12111,57,29,7,9,12,45
12112,38,22,5,3,8,30
12113,5,2,1,0,2,3
12114,61,40,9,2,10,51
12115,10,3,4,0,3,7
12116,356,155,110,11,80,276
12117,47,17,20,1,9,38
12118,32,21,9,0,2,30
12119,25,6,14,0,5,20
12120,12,4,3,1,4,8
12121,274,140,93,0,41,233
12122,56,29,17,0,10,46
12123,36,13,12,0,11,25
12124,323,164,90,5,64,259
12125,58,18,32,1,7,51
12126,45,1,31,0,13,32
12127,43,10,25,1,7,36
12128,124,35,60,1,28,96
12129,35,15,10,0,10,25
12130,94,29,26,20,19,75
12131,14,6,5,2,1,13
12132,72,35,8,13,16,56
12133,139,40,68,1,30,109
12134,76,9,48,5,14,62
12135,53,33,7,0,13,40
12136,46,8,30,0,8,38
12137,159,79,23,26,31,128
12138,220,149,30,0,41,179
12139,2,0,1,1,0,2
12140,37,21,6,2,8,29
12141,48,23,13,0,12,36
12142,42,20,15,0,7,35
12143,74,18,40,1,15,59
12144,8,4,1,0,3,5
12145,74,40,19,0,15,59
12146,38,6,4,19,9,29
12147,587,383,70,7,127,460
12148,46,23,14,0,9,37
12149,9,2,3,3,1,8
12150,9,6,2,1,0,9
12151,46,18,20,0,8,38
12152,470,235,89,46,100,370
12153,44,11,19,2,12,32
12154,260,193,15,0,52,208
12155,198,109,28,23,38,160
12156,61,22,31,0,8,53
12157,138,77,23,7,31,107
12158,151,61,46,15,29,122
12159,119,43,54,0,22,97
12160,32,21,9,0,2,30
12161,57,27,17,0,13,44
12162,46,13,10,13,10,36
12163,135,83,19,4,29,106
12164,13,13,0,0,0,13
12165,69,23,29,1,16,53
12166,46,18,20,0,8,38
12167,33,20,5,4,4,29
12168,46,18,20,0,8,38
12169,68,37,12,0,19,49
12170,43,22,12,0,9,34
12171,74,59,2,0,13,61
12172,64,1,52,0,11,53
12173,29,22,4,0,3,26
12174,153,75,26,22,30,123
12175,360,159,126,6,69,291
12176,40,28,5,0,7,33
12177,236,59,33,104,40,196
12178,63,29,3,16,15,48
12179,103,30,55,0,18,85
12180,108,51,26,6,25,83
12181,14,2,7,0,5,9
12182,57,35,9,2,11,46
12183,86,70,2,0,14,72
12184,39,12,17,3,7,32
12185,132,45,24,38,25,107
12186,74,35,21,0,18,56
12187,52,37,4,0,11,41
12188,32,21,9,0,2,30
12189,46,9,22,5,10,36
12190,40,20,12,1,7,33
12191,25,16,3,1,5,20
12192,66,30,15,12,9,57
12193,81,52,11,0,18,63
12194,105,53,31,4,17,88
12195,242,108,88,3,43,199
12196,43,8,20,0,15,28
12197,162,42,56,26,38,124
12198,212,118,30,23,41,171
12199,19,9,5,2,3,16
12200,79,38,31,1,9,70
12201,29,4,20,0,5,24
12202,40,9,23,0,8,32
12203,18,5,10,0,3,15
12204,57,27,8,8,14,43
12205,107,54,29,5,19,88
12206,28,16,4,0,8,20
12207,99,33,26,21,19,80
12208,66,36,8,9,13,53
12209,8,1,5,0,2,6
12210,53,39,9,5,0,53
12211,82,29,40,0,13,69
12212,78,42,15,4,17,61
12213,37,17,8,2,10,27
12214,453,136,186,36,95,358
12215,95,54,17,7,17,78
12216,221,118,35,22,46,175
12217,81,37,32,0,12,69
12218,155,105,14,2,34,121
12219,116,90,4,0,22,94
12220,55,32,15,2,6,49
12221,56,8,35,0,13,43
12222,16,12,0,0,4,12
12223,146,59,57,8,22,124
12224,302,48,200,1,53,249
12225,67,46,8,2,11,56
12226,25,4,10,5,6,19
12227,199,140,45,2,12,187
12228,55,24,14,2,15,40
12229,43,13,19,4,7,36
12230,130,72,22,7,29,101
12231,100,64,9,5,22,78
12232,98,8,66,5,19,79
12233,70,35,23,4,8,62
12234,59,16,22,3,18,41
12235,29,2,21,1,5,24
12236,57,34,13,0,10,47
12237,11,5,3,0,3,8
12238,38,9,17,4,8,30
12239,41,6,29,0,6,35
12240,16,2,9,0,5,11
12241,46,18,20,0,8,38
12242,63,35,12,0,16,47
12243,56,23,5,13,15,41
12244,71,19,40,1,11,60
12245,37,9,23,0,5,32
12246,138,101,5,2,30,108
12247,673,395,141,18,119,554
12248,140,84,28,0,28,112
12249,91,58,12,1,20,71
12250,665,391,142,17,115,550
12251,88,32,18,10,28,60
12252,117,68,19,9,21,96
12253,100,56,27,1,16,84
12254,126,49,30,15,32,94
12255,467,212,158,10,87,380
12256,73,23,26,1,23,50
12257,117,26,70,0,21,96
12258,50,31,12,0,7,43
12259,178,100,33,0,45,133
12260,45,20,16,0,9,36
12261,53,26,11,4,12,41
12262,62,37,13,0,12,50
12263,32,21,9,0,2,30
12264,11,7,2,1,1,10
12265,32,21,9,0,2,30
12266,50,36,4,2,8,42
12267,44,31,4,0,9,35
12268,46,18,20,0,8,38
12269,44,2,26,12,4,40
12270,23,9,8,0,6,17
12271,405,130,166,17,92,313
12272,450,140,187,28,95,355
12273,25,17,1,0,7,18
12274,67,10,6,33,18,49
12275,121,44,35,18,24,97
12276,322,168,86,15,53,269
12277,13,1,9,0,3,10
12278,161,68,35,24,34,127
12279,20,10,4,0,6,14
12280,11,4,5,0,2,9
12281,27,19,6,0,2,25
12282,384,201,97,19,67,317
12283,339,142,120,6,71,268
12284,65,17,3,30,15,50
12285,17,10,4,0,3,14
12286,59,5,39,1,14,45
12287,20,10,4,1,5,15
12288,50,29,2,3,16,34
12289,31,1,25,0,5,26
12290,12,3,6,2,1,11
12291,77,37,21,3,16,61
12292,41,14,17,4,6,35
12293,99,35,19,13,32,67
12294,54,27,18,0,9,45
12295,13,5,8,0,0,13
12296,665,389,142,17,117,548
12297,8,3,3,0,2,6
12298,14,9,3,0,2,12
12299,42,27,5,5,5,37
12300,71,5,50,1,15,56
12301,226,121,69,0,36,190
12302,48,32,2,0,14,34
12303,62,46,2,0,14,48
12304,282,96,125,15,46,236
12305,36,25,3,0,8,28
12306,15,3,7,3,2,13
12307,108,29,60,0,19,89
12308,9,6,2,1,0,9
12309,32,21,9,0,2,30
12310,32,21,9,0,2,30
12311,5,3,1,0,1,4
12312,666,388,143,17,118,548
12313,162,60,49,17,36,126
12314,8,4,1,1,2,6
12315,98,65,9,4,20,78
12316,106,52,34,0,20,86
12317,75,38,19,9,9,66
12318,117,52,26,15,24,93
12319,119,48,5,46,20,99
12320,273,176,71,5,21,252
12321,87,23,36,17,11,76
12322,13,0,11,0,2,11
12323,67,44,9,0,14,53
12324,59,30,8,9,12,47
12325,32,21,9,0,2,30
12326,79,46,19,0,14,65
12327,206,122,47,0,37,169
12328,30,1,25,0,4,26
12329,120,56,36,3,25,95
12330,95,59,19,2,15,80
12331,246,167,18,3,58,188
12332,46,26,7,1,12,34
12333,177,109,5,20,43,134
12334,50,16,13,7,14,36
12335,30,19,2,0,9,21
12336,60,26,14,4,16,44
12337,102,41,27,11,23,79
12338,176,104,11,24,37,139
12339,105,22,50,14,19,86
12340,276,152,75,0,49,227
12341,9,3,0,5,1,8
12342,211,90,51,25,45,166
12343,135,82,29,6,18,117
12344,52,25,16,0,11,41
12345,57,36,5,0,16,41
12346,26,9,5,8,4,22
12347,33,16,11,0,6,27
12348,17,0,13,0,4,13
12349,65,48,12,0,5,60
12350,64,48,12,0,4,60
12351,111,38,41,0,32,79
12352,63,20,33,3,7,56
12353,190,106,25,23,36,154
12354,67,38,3,14,12,55
12355,62,28,23,0,11,51
12356,3,0,0,0,3,0
12357,110,44,23,19,24,86
12358,263,101,100,15,47,216
12359,74,55,6,0,13,61
12360,131,43,34,29,25,106
12361,87,18,45,9,15,72
12362,92,21,51,3,17,75
12363,102,24,62,0,16,86
12364,59,31,13,1,14,45
12365,40,29,6,5,0,40
12366,20,9,5,0,6,14
12367,95,27,23,26,19,76
12368,58,22,23,3,10,48
12369,300,138,87,16,59,241
12370,39,13,18,1,7,32
12371,51,30,4,7,10,41
12372,132,74,32,12,14,118
12373,50,21,20,0,9,41
12374,69,34,19,4,12,57
12375,39,8,24,0,7,32
12376,147,36,76,1,34,113
12377,74,42,21,3,8,66
12378,78,52,9,0,17,61
12379,40,14,18,3,5,35
12380,137,110,7,2,18,119
12381,244,102,15,82,45,199
12382,83,61,5,0,17,66
12383,48,28,11,0,9,39
12384,49,22,17,0,10,39
12385,38,5,28,1,4,34
12386,29,21,2,0,6,23
12387,125,47,42,12,24,101
12388,205,110,62,0,33,172
12389,14,5,4,1,4,10
12390,33,15,13,0,5,28
12391,63,36,16,0,11,52
12392,132,71,39,0,22,110
12393,151,38,77,1,35,116
12394,28,1,12,8,7,21
12395,43,2,32,0,9,34
12396,679,396,140,21,122,557
12397,166,86,21,26,33,133
12398,172,112,22,0,38,134
12399,101,36,38,5,22,79
12400,293,213,12,0,68,225
12401,508,280,123,20,85,423
12402,173,84,53,3,33,140
12403,44,26,9,0,9,35
12404,104,87,3,3,11,93
12405,80,48,17,0,15,65
12406,40,13,7,9,11,29
12407,66,45,2,2,17,49
12408,15,10,1,2,2,13
12409,115,45,36,7,27,88
12410,18,3,13,0,2,16
12411,11,1,8,0,2,9
12412,355,269,20,0,66,289
12413,59,31,9,1,18,41
12414,108,48,29,17,14,94
12415,44,19,15,0,10,34
12416,61,28,19,1,13,48
12417,1046,383,419,46,198,848
12418,26,17,2,0,7,19
12419,32,21,9,0,2,30
12420,283,79,38,120,46,237
12421,29,7,12,2,8,21
12422,27,4,20,0,3,24
12423,56,40,8,0,8,48
12424,244,124,83,0,37,207
12425,116,46,26,18,26,90
12426,246,103,15,81,47,199
12427,10,4,3,0,3,7
12428,114,53,26,2,33,81
12429,586,410,51,1,124,462
12430,52,22,19,1,10,42
12431,22,2,8,8,4,18
12432,155,94,31,5,25,130
12433,44,18,18,0,8,36
12434,68,31,24,2,11,57
12435,30,21,3,0,6,24
12436,43,18,18,0,7,36
12437,46,18,20,0,8,38
12438,10,6,2,0,2,8
12439,151,111,5,2,33,118
12440,21,4,12,0,5,16
12441,71,35,12,6,18,53
12442,31,19,5,0,7,24
12443,331,153,104,8,66,265
12444,36,5,19,4,8,28
12445,166,64,46,26,30,136
12446,16,7,6,0,3,13
12447,199,76,53,28,42,157
12448,128,109,2,0,17,111
12449,29,20,6,0,3,26
12450,72,44,14,0,14,58
12451,573,371,82,4,116,457
12452,53,28,9,7,9,44
12453,33,24,5,0,4,29
12454,2,1,0,0,1,1
12455,45,25,3,9,8,37
12456,62,36,17,0,9,53
12457,72,46,16,1,9,63
12458,325,163,93,1,68,257
12459,40,13,19,3,5,35
12460,88,46,11,2,29,59
12461,628,359,137,18,114,514
12462,46,18,20,0,8,38
12463,143,53,61,5,24,119
12464,76,38,15,12,11,65
12465,69,42,19,0,8,61
12466,39,19,16,1,3,36
12467,108,43,23,17,25,83
12468,117,51,21,19,26,91
12469,46,18,20,0,8,38
12470,260,190,13,2,55,205
12471,33,12,15,0,6,27
12472,59,22,25,0,12,47
12473,193,129,21,0,43,150
12474,15,13,0,0,2,13
12475,90,28,38,1,23,67
12476,5,3,1,0,1,4
12477,88,66,3,0,19,69
12478,151,52,75,0,24,127
12479,375,193,107,15,60,315
12480,30,10,15,1,4,26
12481,326,144,108,6,68,258
12482,75,53,2,0,20,55
12483,118,35,42,16,25,93
12484,257,136,80,0,41,216
12485,34,19,7,0,8,26
12486,140,75,36,0,29,111
12487,84,52,17,2,13,71
12488,58,30,3,14,11,47
12489,178,100,33,0,45,133
12490,203,82,31,41,49,154
12491,67,34,23,2,8,59
12492,76,41,12,6,17,59
12493,7,2,2,0,3,4
12494,0,0,0,0,0,0
12495,252,148,51,0,53,199
12496,650,377,142,17,114,536
12497,98,48,17,2,31,67
12498,52,15,13,17,7,45
12499,29,7,12,2,8,21
12500,82,27,41,0,14,68
12501,35,17,7,3,8,27
12502,103,56,10,14,23,80
12503,66,30,22,0,14,52
12504,45,32,4,1,8,37
12505,25,9,12,0,4,21
12506,68,33,17,6,12,56
12507,66,27,22,2,15,51
12508,178,47,55,40,36,142
12509,140,62,24,18,36,104
12510,7,3,2,1,1,6
12511,105,38,24,20,23,82
12512,243,147,10,31,55,188
12513,53,20,17,2,14,39
12514,42,18,11,0,13,29
12515,53,4,40,1,8,45
12516,11,2,4,1,4,7
12517,66,41,14,1,10,56
12518,21,5,6,3,7,14
12519,111,45,36,9,21,90
12520,85,41,25,2,17,68
12521,493,340,48,1,104,389
12522,52,27,13,0,12,40
12523,37,14,16,0,7,30
12524,92,37,13,23,19,73
12525,137,51,45,15,26,111
12526,242,182,12,0,48,194
12527,44,29,6,1,8,36
12528,114,47,45,3,19,95
12529,86,39,18,13,16,70
12530,85,55,15,0,15,70
12531,54,16,29,5,4,50
12532,223,90,75,20,38,185
12533,49,26,4,7,12,37
12534,215,124,66,6,19,196
12535,73,22,28,12,11,62
12536,25,21,1,3,0,25
12537,32,21,9,0,2,30
12538,20,10,5,1,4,16
12539,241,131,69,0,41,200
12540,56,39,6,2,9,47
12541,21,1,12,1,7,14
12542,59,39,4,2,14,45
12543,250,145,55,0,50,200
12544,100,61,22,4,13,87
12545,185,117,31,5,32,153
12546,72,4,50,0,18,54
12547,7,2,3,0,2,5
12548,46,18,20,0,8,38
12549,55,30,14,2,9,46
12550,99,31,49,5,14,85
12551,24,7,9,2,6,18
12552,36,16,8,5,7,29
12553,111,51,35,6,19,92
12554,23,13,0,5,5,18
12555,31,8,11,3,9,22
12556,195,102,35,21,37,158
12557,50,31,10,0,9,41
12558,21,10,4,0,7,14
12559,86,28,41,2,15,71
12560,12,5,5,0,2,10
12561,46,18,20,0,8,38
12562,12,2,4,1,5,7
12563,66,28,26,0,12,54
12564,156,107,35,2,12,144
12565,110,31,57,0,22,88
12566,55,24,22,0,9,46
12567,47,24,18,0,5,42
12568,106,35,36,15,20,86
12569,1,0,0,1,0,1
12570,287,160,35,33,59,228
12571,35,16,10,0,9,26
12572,79,24,28,15,12,67
12573,32,10,2,15,5,27
12574,76,40,20,0,16,60
12575,6,4,1,0,1,5
12576,28,18,6,1,3,25
12577,68,37,17,1,13,55
12578,72,21,34,4,13,59
12579,32,21,9,0,2,30
12580,95,79,3,0,13,82
12581,46,11,22,0,13,33
12582,39,7,14,11,7,32
12583,31,12,15,0,4,27
12584,231,173,9,3,46,185
12585,178,101,32,0,45,133
12586,1,1,0,0,0,1
12587,151,62,35,20,34,117
12588,2,1,1,0,0,2
12589,371,151,100,40,80,291
12590,51,41,1,0,9,42
12591,39,12,17,0,10,29
12592,63,26,17,4,16,47
12593,276,155,35,31,55,221
12594,81,27,42,0,12,69
12595,89,40,15,12,22,67
12596,73,18,36,9,10,63
12597,483,224,155,13,91,392
12598,537,259,119,45,114,423
12599,211,142,54,1,14,197
12600,46,28,9,0,9,37
12601,56,16,27,2,11,45
12602,15,3,8,0,4,11
12603,240,126,68,0,46,194
12604,13,5,2,1,5,8
12605,38,5,28,1,4,34
12606,159,54,79,0,26,133
12607,166,84,47,1,34,132
12608,81,66,1,0,14,67
12609,437,207,144,8,78,359
12610,142,24,53,24,41,101
12611,32,2,22,0,8,24
12612,18,9,7,1,1,17
12613,262,14,195,2,51,211
12614,127,58,40,4,25,102
12615,20,3,0,9,8,12
12616,109,54,35,0,20,89
12617,6,3,3,0,0,6
12618,23,4,14,0,5,18
12619,136,72,27,10,27,109
12620,93,33,38,6,16,77
12621,56,18,20,7,11,45
12622,10,5,4,0,1,9
12623,50,26,6,4,14,36
12624,441,209,135,11,86,355
12625,12,5,4,0,3,9
12626,35,19,9,0,7,28
12627,28,3,22,0,3,25
12628,76,52,15,6,3,73
12629,67,29,15,10,13,54
12630,172,43,63,27,39,133
12631,97,70,2,0,25,72
12632,255,149,50,7,49,206
12633,88,19,52,0,17,71
12634,285,138,92,0,55,230
12635,39,2,19,12,6,33
12636,177,136,5,2,34,143
12637,56,38,11,0,7,49
12638,33,16,9,0,8,25
12639,143,15,97,2,29,114
12640,2,1,0,0,1,1
12641,38,18,15,0,5,33
12642,40,19,14,0,7,33
12643,449,256,89,12,92,357
12644,10,4,5,0,1,9
12645,31,15,7,4,5,26
12646,154,82,38,0,34,120
12647,95,25,54,2,14,81
12648,33,1,25,1,6,27
12649,9,1,5,0,3,6
12650,66,33,24,0,9,57
12651,207,131,26,11,39,168
12652,8,1,5,1,1,7
12653,85,25,39,9,12,73
12654,18,5,7,0,6,12
12655,116,73,9,16,18,98
12656,28,14,8,0,6,22
12657,226,53,24,113,36,190
12658,125,64,12,22,27,98
12659,214,106,35,35,38,176
12660,205,135,23,0,47,158
12661,65,34,20,2,9,56
12662,15,12,0,0,3,12
12663,28,11,10,1,6,22
12664,57,2,30,18,7,50
12665,46,18,20,0,8,38
12666,192,73,64,7,48,144
12667,149,46,51,21,31,118
12668,53,20,24,1,8,45
12669,48,18,24,0,6,42
12670,18,10,2,0,6,12
12671,251,186,14,0,51,200
12672,109,34,53,4,18,91
12673,69,24,27,4,14,55
12674,107,50,19,22,16,91
12675,143,55,44,7,37,106
12676,34,17,14,2,1,33
12677,92,41,26,1,24,68
12678,348,149,122,6,71,277
12679,85,55,15,0,15,70
12680,27,14,6,4,3,24
12681,89,40,14,17,18,71
12682,401,174,134,13,80,321
12683,64,38,15,1,10,54
12684,86,43,25,4,14,72
12685,69,33,17,0,19,50
12686,57,25,22,0,10,47
12687,78,44,18,2,14,64
12688,16,5,9,0,2,14
12689,38,12,12,7,7,31
12690,165,63,56,21,25,140
12691,8,6,0,0,2,6
12692,25,0,19,3,3,22
12693,165,55,55,25,30,135
12694,132,89,18,1,24,108
12695,38,22,5,3,8,30
12696,416,196,89,47,84,332
12697,91,38,32,1,20,71
12698,103,21,49,15,18,85
12699,133,104,10,0,19,114
12700,57,36,9,1,11,46
12701,25,14,6,0,5,20
12702,88,19,40,10,19,69
12703,400,170,120,27,83,317
12704,21,12,2,4,3,18
12705,123,68,22,3,30,93
12706,105,50,28,3,24,81
12707,56,23,14,7,12,44
12708,112,83,7,0,22,90
12709,32,21,9,0,2,30
12710,51,34,5,3,9,42
12711,7,1,5,0,1,6
12712,129,67,37,13,12,117
12713,92,29,33,12,18,74
12714,80,48,16,0,16,64
12715,65,27,24,0,14,51
12716,322,167,85,15,55,267
12717,71,37,22,0,12,59
12718,60,37,14,0,9,51
12719,13,1,10,0,2,11
12720,32,21,9,0,2,30
12721,538,296,113,13,116,422
12722,39,19,10,0,10,29
12723,56,45,3,1,7,49
12724,75,38,24,0,13,62
12725,16,6,7,0,3,13
12726,46,10,15,10,11,35
12727,431,200,90,49,92,339
12728,129,100,6,0,23,106
12729,31,6,23,0,2,29
12730,50,12,26,1,11,39
12731,36,8,22,1,5,31
12732,52,21,16,6,9,43
12733,167,115,7,4,41,126
12734,57,25,4,18,10,47
12735,80,39,23,0,18,62
12736,51,33,5,1,12,39
12737,143,59,48,8,28,115
12738,55,25,20,0,10,45
12739,266,57,160,1,48,218
12740,9,3,1,0,5,4
12741,70,34,17,6,13,57
12742,447,217,125,12,93,354
12743,65,48,0,0,17,48
12744,124,73,27,0,24,100
12745,44,25,11,0,8,36
12746,53,28,11,2,12,41
12747,76,23,38,0,15,61
12748,76,11,50,0,15,61
12749,85,31,19,12,23,62
12750,201,100,33,33,35,166
12751,14,5,4,2,3,11
12752,55,33,8,0,14,41
12753,17,10,4,1,2,15
12754,19,4,13,0,2,17
12755,32,21,9,0,2,30
12756,82,45,21,0,16,66
12757,47,18,22,1,6,41
12758,59,32,12,0,15,44
12759,44,7,18,9,10,34
12760,400,231,89,0,80,320
12761,31,14,13,0,4,27
12762,8,5,1,0,2,6
12763,33,0,28,0,5,28
12764,62,20,24,4,14,48
12765,12,4,5,1,2,10
12766,464,176,146,44,98,366
12767,104,34,25,25,20,84
12768,15,3,8,2,2,13
12769,36,9,19,0,8,28
12770,52,30,7,3,12,40
12771,64,40,10,0,14,50
12772,46,18,20,0,8,38
12773,32,21,9,0,2,30
12774,133,59,28,19,27,106
12775,142,56,45,9,32,110
12776,101,33,43,9,16,85
12777,86,45,30,5,6,80
12778,85,43,21,1,20,65
12779,56,3,40,1,12,44
12780,183,130,14,1,38,145
12781,79,38,29,1,11,68
12782,468,176,149,43,100,368
12783,61,25,14,11,11,50
12784,27,4,16,0,7,20
12785,72,15,42,1,14,58
12786,26,16,8,1,1,25
12787,29,19,4,0,6,23
12788,96,21,58,0,17,79
12789,39,25,12,0,2,37
12790,162,84,45,2,31,131
12791,9,3,4,1,1,8
12792,64,14,34,7,9,55
12793,444,137,178,33,96,348
12794,94,29,48,0,17,77
12795,34,21,7,0,6,28
12796,32,21,9,0,2,30
12797,54,18,12,13,11,43
12798,33,13,7,5,8,25
12799,117,52,36,5,24,93
12800,116,48,29,15,24,92
12801,47,26,12,3,6,41
12802,193,54,34,70,35,158
12803,199,140,44,2,13,186
12804,213,43,55,73,42,171
12805,50,3,38,0,9,41
12806,220,117,34,33,36,184
12807,171,65,43,24,39,132
12808,360,160,124,6,70,290
12809,65,31,18,2,14,51
12810,197,89,68,2,38,159
12811,55,14,30,1,10,45
12812,83,35,30,1,17,66
12813,38,31,0,0,7,31
12814,32,21,9,0,2,30
12815,18,4,9,1,4,14
12816,24,15,4,1,4,20
12817,34,10,13,0,11,23
12818,87,34,32,1,20,67
12819,407,305,20,0,82,325
12820,44,15,16,0,13,31
12821,208,100,39,33,36,172
12822,20,5,10,0,5,15
12823,55,20,15,6,14,41
12824,346,169,111,1,65,281
12825,14,0,11,0,3,11
12826,345,146,125,6,68,277
12827,27,17,3,0,7,20
12828,17,3,11,0,3,14
12829,128,46,27,23,32,96
12830,55,39,8,1,7,48
12831,387,173,96,34,84,303
12832,226,132,21,26,47,179
12833,225,76,84,15,50,175
12834,126,46,39,19,22,104
12835,347,146,127,6,68,279
12836,14,10,0,0,4,10
12837,91,44,25,1,21,70
12838,678,394,156,21,107,571
12839,31,16,2,4,9,22
12840,46,18,20,0,8,38
12841,72,45,13,0,14,58
12842,32,21,9,0,2,30
12843,64,37,18,3,6,58
12844,61,21,32,0,8,53
12845,40,23,14,0,3,37
12846,48,14,24,0,10,38
12847,431,119,170,47,95,336
12848,24,10,7,1,6,18
12849,33,13,13,0,7,26
12850,33,9,11,7,6,27
12851,100,25,45,3,27,73
12852,22,2,18,0,2,20
12853,72,44,13,0,15,57
12854,38,5,25,0,8,30
12855,111,20,55,15,21,90
12856,20,4,9,0,7,13
12857,32,21,9,0,2,30
12858,36,16,8,5,7,29
12859,83,56,12,0,15,68
12860,122,39,36,20,27,95
12861,17,2,13,0,2,15
12862,52,6,27,3,16,36
12863,36,15,15,0,6,30
12864,383,288,20,0,75,308
12865,43,28,7,0,8,35
12866,54,13,20,3,18,36
12867,50,14,31,0,5,45
12868,107,25,57,3,22,85
12869,77,23,36,1,17,60
12870,264,18,196,0,50,214
12871,59,31,20,0,8,51
12872,43,14,24,0,5,38
12873,30,14,5,0,11,19
12874,63,20,24,4,15,48
12875,52,18,23,4,7,45
12876,19,9,5,1,4,15
12877,313,155,92,1,65,248
12878,185,121,11,13,40,145
12879,64,2,37,18,7,57
12880,319,159,92,15,53,266
12881,80,21,37,8,14,66
12882,77,33,24,0,20,57
12883,18,1,11,1,5,13
12884,88,44,25,2,17,71
12885,38,19,9,0,10,28
12886,44,18,10,5,11,33
12887,133,59,46,1,27,106
12888,134,47,29,27,31,103
12889,71,35,12,6,18,53
12890,86,40,13,10,23,63
12891,52,34,10,1,7,45
12892,183,76,54,11,42,141
12893,76,21,43,0,12,64
12894,32,12,6,7,7,25
12895,58,28,21,0,9,49
12896,213,97,59,13,44,169
12897,25,21,1,3,0,25
12898,134,74,22,4,34,100
12899,342,147,120,5,70,272
12900,70,42,10,1,17,53
12901,431,137,157,49,88,343
12902,20,9,6,1,4,16
12903,63,31,16,4,12,51
12904,218,91,14,76,37,181
12905,12,9,1,1,1,11
12906,44,24,10,2,8,36
12907,30,5,21,2,2,28
12908,140,86,23,1,30,110
12909,35,9,14,4,8,27
12910,4,2,2,0,0,4
12911,42,14,18,4,6,36
12912,83,39,30,4,10,73
12913,76,38,17,2,19,57
12914,19,0,16,1,2,17
12915,27,15,8,0,4,23
12916,56,13,19,6,18,38
12917,71,35,12,6,18,53
12918,509,218,128,50,113,396
12919,461,163,156,45,97,364
12920,40,0,28,0,12,28
12921,34,12,17,1,4,30
12922,237,89,20,83,45,192
12923,32,17,6,0,9,23
12924,7,1,3,0,3,4
12925,131,53,30,15,33,98
12926,370,152,98,40,80,290
12927,38,13,20,1,4,34
12928,35,13,13,0,9,26
12929,184,28,81,30,45,139
12930,98,34,45,5,14,84
12931,100,78,3,0,19,81
12932,11,6,2,0,3,8
12933,228,144,66,1,17,211
12934,89,34,35,6,14,75
12935,29,2,21,1,5,24
12936,200,105,30,28,37,163
12937,14,8,4,0,2,12
12938,76,42,19,0,15,61
12939,406,135,164,19,88,318
12940,10,2,5,1,2,8
12941,24,5,12,0,7,17
12942,38,22,5,3,8,30
12943,17,3,9,1,4,13
12944,26,16,3,0,7,19
12945,133,99,6,0,28,105
12946,84,23,42,4,15,69
12947,22,17,0,0,5,17
12948,23,8,11,0,4,19
12949,55,36,5,2,12,43
12950,450,270,54,36,90,360
12951,95,24,56,1,14,81
12952,73,25,37,1,10,63
12953,20,0,15,2,3,17
12954,276,100,118,14,44,232
12955,29,7,15,0,7,22
12956,31,8,13,2,8,23
12957,24,9,11,0,4,20
12958,97,43,36,4,14,83
12959,119,41,42,7,29,90
12960,124,86,12,1,25,99
12961,71,38,9,8,16,55
12962,45,24,10,4,7,38
12963,40,21,12,0,7,33
12964,77,35,23,2,17,60
12965,61,41,9,1,10,51
12966,149,62,32,21,34,115
12967,4,2,1,0,1,3
12968,37,19,8,1,9,28
12969,13,0,12,0,1,12
12970,35,16,10,3,6,29
12971,23,7,12,0,4,19
12972,1304,524,184,338,258,1046
12973,127,60,16,19,32,95
12974,13,2,7,0,4,9
12975,44,6,26,4,8,36
12976,436,214,114,16,92,344
12977,23,3,11,0,9,14
12978,355,207,70,10,68,287
12979,46,18,20,0,8,38
12980,56,35,13,0,8,48
12981,15,9,1,5,0,15
12982,67,48,8,0,11,56
12983,8,3,1,0,4,4
12984,51,26,7,8,10,41
12985,10,4,3,0,3,7
12986,73,39,15,2,17,56
12987,21,2,10,1,8,13
12988,37,26,0,1,10,27
12989,82,68,1,0,13,69
12990,107,60,19,5,23,84
12991,280,145,79,0,56,224
12992,73,48,8,2,15,58
12993,11,2,8,0,1,10
12994,100,34,26,21,19,81
12995,31,10,19,1,1,30
12996,50,8,29,3,10,40
12997,121,52,23,22,24,97
12998,78,27,7,27,17,61
12999,5,2,2,0,1,4
13000,164,114,13,0,37,127
13001,5,1,3,0,1,4
13002,48,27,10,0,11,37
13003,40,29,6,5,0,40
13004,200,106,67,4,23,177
13005,44,34,2,2,6,38
13006,0,0,0,0,0,0
13007,104,70,11,1,22,82
13008,45,18,19,0,8,37
13009,69,23,22,7,17,52
13010,140,95,17,2,26,114
13011,564,415,34,1,114,450
13012,55,38,6,1,10,45
13013,61,16,28,2,15,46
13014,22,10,8,0,4,18
13015,41,19,12,3,7,34
13016,12,7,2,0,3,9
13017,43,19,13,0,11,32
13018,12,1,9,0,2,10
13019,2,0,0,1,1,1
13020,210,69,82,15,44,166
13021,354,265,21,0,68,286
13022,94,42,35,0,17,77
13023,33,7,18,4,4,29
13024,80,8,61,0,11,69
13025,142,77,31,8,26,116
13026,45,27,2,10,6,39
13027,214,76,78,10,50,164
13028,382,201,98,19,64,318
13029,81,43,17,3,18,63
13030,107,25,59,2,21,86
13031,137,72,34,0,31,106
13032,20,3,0,9,8,12
13033,20,11,3,1,5,15
13034,108,61,18,3,26,82
13035,59,19,16,13,11,48
13036,59,37,14,0,8,51
13037,30,18,9,0,3,27
13038,98,25,36,13,24,74
13039,21,8,9,0,4,17
13040,2,1,1,0,0,2
13041,13,2,7,3,1,12
13042,435,206,140,12,77,358
13043,59,24,23,1,11,48
13044,193,89,53,11,40,153
13045,32,14,9,1,8,24
13046,31,14,11,0,6,25
13047,64,33,14,0,17,47
13048,219,51,28,103,37,182
13049,43,27,7,0,9,34
13050,166,107,25,5,29,137
13051,52,28,14,0,10,42
13052,35,14,13,1,7,28
13053,452,206,152,11,83,369
13054,159,109,36,3,11,148
13055,272,18,201,0,53,219
13056,2,1,0,0,1,1
13057,51,17,22,2,10,41
13058,99,92,0,7,0,99
13059,28,16,7,0,5,23
13060,172,6,135,0,31,141
13061,35,16,10,1,8,27
13062,68,5,45,5,13,55
13063,47,28,2,11,6,41
13064,655,387,137,17,114,541
13065,25,3,12,1,9,16
13066,127,40,57,0,30,97
13067,91,53,17,5,16,75
13068,9,6,0,0,3,6
13069,227,167,14,0,46,181
13070,143,59,32,23,29,114
13071,73,33,27,0,13,60
13072,36,7,26,0,3,33
13073,28,15,8,1,4,24
13074,566,328,114,18,106,460
13075,424,203,142,7,72,352
13076,11,5,4,0,2,9
13077,44,11,23,0,10,34
13078,204,114,39,13,38,166
13079,110,56,33,4,17,93
13080,219,148,30,0,41,178
13081,49,34,4,4,7,42
13082,15,2,10,0,3,12
13083,46,11,24,0,11,35
13084,13,3,6,0,4,9
13085,220,52,31,98,39,181
13086,43,16,4,15,8,35
13087,123,100,3,3,17,106
13088,46,18,20,0,8,38
13089,138,72,35,0,31,107
13090,31,0,10,16,5,26
13091,23,10,7,0,6,17
13092,90,29,38,6,17,73
13093,32,9,19,0,4,28
13094,369,279,20,0,70,299
13095,124,83,14,2,25,99
13096,92,29,47,0,16,76
13097,51,29,13,1,8,43
13098,48,21,19,0,8,40
13099,114,32,44,19,19,95
13100,105,71,11,0,23,82
13101,46,27,9,4,6,40
13102,157,53,52,22,30,127
13103,104,43,38,3,20,84
13104,106,30,53,4,19,87
13105,29,21,6,0,2,27
13106,38,25,5,1,7,31
13107,111,31,40,14,26,85
13108,22,0,18,2,2,20
13109,102,36,37,9,20,82
13110,44,14,20,2,8,36
13111,42,2,8,23,9,33
13112,201,85,32,37,47,154
13113,491,341,42,1,107,384
13114,12,6,4,0,2,10
13115,182,58,74,13,37,145
13116,45,27,17,0,1,44
13117,72,25,13,24,10,62
13118,132,38,69,0,25,107
13119,269,107,101,16,45,224
13120,55,24,21,2,8,47
13121,114,67,17,5,25,89
13122,15,2,12,0,1,14
13123,334,144,115,6,69,265
13124,21,11,7,1,2,19
13125,20,10,8,0,2,18
13126,46,18,20,0,8,38
13127,34,10,18,0,6,28
13128,50,11,30,0,9,41
13129,36,31,3,0,2,34
13130,80,41,27,0,12,68
13131,387,223,85,0,79,308
13132,262,193,15,0,54,208
13133,84,58,5,0,21,63
13134,160,78,48,1,33,127
13135,8,7,1,0,0,8
13136,88,33,33,9,13,75
13137,32,9,11,4,8,24
13138,96,48,15,2,31,65
13139,151,71,29,18,33,118
13140,85,46,14,8,17,68
13141,1,1,0,0,0,1
13142,467,247,120,20,80,387
13143,15,13,0,0,2,13
13144,95,75,3,0,17,78
13145,55,38,6,1,10,45
13146,121,73,27,0,21,100
13147,145,52,46,17,30,115
13148,97,27,21,28,21,76
13149,118,57,20,15,26,92
13150,282,93,133,5,51,231
13151,57,28,6,4,19,38
13152,27,0,23,2,2,25
13153,32,21,9,0,2,30
13154,36,12,15,0,9,27
13155,37,28,2,2,5,32
13156,362,190,89,20,63,299
13157,46,18,20,0,8,38
13158,68,36,16,1,15,53
13159,197,80,50,22,45,152
13160,82,67,3,0,12,70
13161,397,203,117,3,74,323
13162,161,108,26,0,27,134
13163,51,33,5,2,11,40
13164,17,2,8,0,7,10
13165,38,13,20,1,4,34
13166,22,8,10,0,4,18
13167,21,8,11,0,2,19
13168,44,10,19,6,9,35
13169,240,136,23,30,51,189
13170,446,206,149,11,80,366
13171,46,33,0,2,11,35
13172,42,27,5,1,9,33
13173,3,0,2,1,0,3
13174,25,11,8,0,6,19
13175,200,108,49,8,35,165
13176,27,8,5,7,7,20
13177,109,39,40,8,22,87
13178,92,20,31,22,19,73
13179,78,39,25,3,11,67
13180,14,10,2,0,2,12
13181,35,19,13,1,2,33
13182,36,18,5,2,11,25
13183,58,41,3,1,13,45
13184,17,15,0,0,2,15
13185,17,1,13,0,3,14
13186,57,39,11,5,2,55
13187,30,3,14,7,6,24
13188,57,20,25,0,12,45
13189,96,29,44,2,21,75
13190,47,22,10,4,11,36
13191,33,16,8,3,6,27
13192,172,99,18,19,36,136
13193,21,12,5,2,2,19
13194,68,16,41,0,11,57
13195,72,36,19,3,14,58
13196,67,24,6,21,16,51
13197,204,84,61,18,41,163
13198,5,0,4,0,1,4
13199,52,30,13,1,8,44
13200,79,40,17,3,19,60
13201,14,4,6,2,2,12
13202,14,5,3,1,5,9
13203,4,1,1,0,2,2
13204,471,215,158,10,88,383
13205,13,0,11,1,1,12
13206,88,52,15,3,18,70
13207,38,21,3,0,14,24
13208,47,26,16,0,5,42
13209,46,14,25,0,7,39
13210,639,373,137,17,112,527
13211,163,73,52,6,32,131
13212,113,75,9,13,16,97
13213,110,66,22,0,22,88
13214,58,19,22,4,13,45
13215,58,15,33,3,7,51
13216,80,45,18,3,14,66
13217,451,241,107,14,89,362
13218,14,1,6,4,3,11
13219,71,46,11,1,13,58
13220,67,36,15,2,14,53
13221,67,15,27,8,17,50
13222,6,0,6,0,0,6
13223,79,23,40,2,14,65
13224,46,23,13,1,9,37
13225,45,8,22,0,15,30
13226,35,21,8,0,6,29
13227,46,18,20,0,8,38
13228,115,54,31,6,24,91
13229,160,51,83,4,22,138
13230,29,2,21,1,5,24
13231,47,20,16,0,11,36
13232,39,22,10,0,7,32
13233,124,42,54,0,28,96
13234,46,28,8,4,6,40
13235,100,47,35,1,17,83
13236,31,4,24,0,3,28
13237,64,36,16,0,12,52
13238,11,3,8,0,0,11
13239,110,69,20,2,19,91
13240,38,18,9,1,10,28
13241,31,12,13,0,6,25
13242,31,2,23,0,6,25
13243,1,1,0,0,0,1
13244,88,25,46,0,17,71
13245,592,406,58,1,127,465
13246,19,10,9,0,0,19
13247,46,30,8,0,8,38
13248,44,6,28,2,8,36
13249,42,22,8,2,10,32
13250,359,197,90,15,57,302
13251,43,38,0,0,5,38
13252,15,4,9,0,2,13
13253,29,5,17,1,6,23
13254,112,81,7,0,24,88
13255,48,34,1,0,13,35
13256,668,384,157,21,106,562
13257,508,261,92,51,104,404
13258,77,10,43,5,19,58
13259,90,47,11,2,30,60
13260,24,3,19,0,2,22
13261,63,47,12,0,4,59
13262,4,1,3,0,0,4
13263,131,51,47,11,22,109
13264,2,2,0,0,0,2
13265,49,32,6,2,9,40
13266,145,62,51,7,25,120
13267,68,43,14,1,10,58
13268,38,24,11,0,3,35
13269,40,18,14,0,8,32
13270,64,23,22,3,16,48
13271,66,30,22,1,13,53
13272,274,90,126,14,44,230
13273,394,224,89,0,81,313
13274,358,192,92,15,59,299
13275,30,10,15,1,4,26
13276,12,5,3,1,3,9
13277,131,42,36,29,24,107
13278,29,5,19,0,5,24
13279,216,51,124,2,39,177
13280,28,16,7,0,5,23
13281,6,1,3,0,2,4
13282,24,7,7,3,7,17
13283,540,383,38,1,118,422
13284,41,15,13,5,8,33
13285,45,16,23,2,4,41
13286,77,31,27,2,17,60
13287,60,15,25,11,9,51
13288,42,33,2,0,7,35
13289,361,100,169,7,85,276
13290,90,28,19,23,20,70
13291,8,5,1,0,2,6
13292,82,43,10,9,20,62
13293,117,24,39,26,28,89
13294,36,15,15,1,5,31
13295,25,1,19,3,2,23
13296,109,51,38,0,20,89
13297,87,45,18,9,15,72
13298,37,9,24,1,3,34
13299,29,21,2,0,6,23
13300,1306,527,183,337,259,1047
13301,43,32,5,0,6,37
13302,11,2,5,0,4,7
13303,135,91,11,5,28,107
13304,31,15,10,0,6,25
13305,380,200,104,4,72,308
13306,93,19,40,12,22,71
13307,7,1,4,0,2,5
13308,33,11,4,10,8,25
13309,28,19,6,0,3,25
13310,333,251,19,2,61,272
13311,26,2,19,0,5,21
13312,107,74,19,2,12,95
13313,25,5,9,4,7,18
13314,120,35,62,0,23,97
13315,44,35,2,0,7,37
13316,574,423,36,1,114,460
13317,459,221,145,13,80,379
13318,34,20,7,0,7,27
13319,67,49,8,3,7,60
13320,118,58,20,15,25,93
13321,14,0,7,4,3,11
13322,32,21,9,0,2,30
13323,7,4,3,0,0,7
13324,117,49,29,17,22,95
13325,29,18,5,0,6,23
13326,429,313,23,0,93,336
13327,26,17,3,0,6,20
13328,80,37,24,0,19,61
13329,79,42,9,17,11,68
13330,105,50,31,4,20,85
13331,87,32,27,9,19,68
13332,32,21,9,0,2,30
13333,60,41,5,1,13,47
13334,43,7,24,3,9,34
13335,28,16,7,0,5,23
13336,46,18,20,0,8,38
13337,47,24,12,0,11,36
13338,55,5,34,6,10,45
13339,48,11,15,11,11,37
13340,167,73,52,3,39,128
13341,110,20,54,15,21,89
13342,11,3,5,0,3,8
13343,15,2,9,1,3,12
13344,41,24,9,0,8,33
13345,81,61,8,0,12,69
13346,13,3,5,1,4,9
13347,252,134,77,0,41,211
13348,150,49,52,18,31,119
13349,161,108,27,0,26,135
13350,487,337,42,1,107,380
13351,56,14,27,0,15,41
13352,22,12,10,0,0,22
13353,61,14,18,16,13,48
13354,17,5,4,5,3,14
13355,46,18,20,0,8,38
13356,215,59,108,1,47,168
13357,12,3,6,1,2,10
13358,28,9,14,0,5,23
13359,222,150,31,0,41,181
13360,32,21,9,0,2,30
13361,20,9,5,0,6,14
13362,129,95,6,0,28,101
13363,76,46,17,1,12,64
13364,4,2,2,0,0,4
13365,46,18,20,0,8,38
13366,140,80,22,3,35,105
13367,45,30,6,4,5,40
13368,27,2,18,2,5,22
13369,51,11,29,1,10,41
13370,30,22,0,0,8,22
13371,155,66,32,20,37,118
13372,127,74,22,3,28,99
13373,8,0,5,0,3,5
13374,61,37,13,1,10,51
13375,130,52,40,13,25,105
13376,16,7,6,0,3,13
13377,5,0,5,0,0,5
13378,94,34,36,10,14,80
13379,379,184,100,18,77,302
13380,41,20,10,2,9,32
13381,159,71,52,5,31,128
13382,43,35,2,0,6,37
13383,322,183,59,12,68,254
13384,114,42,29,13,30,84
13385,95,50,14,8,23,72
13386,8,3,1,0,4,4
13387,47,7,31,0,9,38
13388,69,8,47,3,11,58
13389,42,19,14,0,9,33
13390,51,20,10,16,5,46
13391,89,46,12,2,29,60
13392,52,20,22,0,10,42
13393,30,7,9,4,10,20
13394,235,161,29,2,43,192
13395,109,47,30,12,20,89
13396,32,21,9,0,2,30
13397,84,29,24,17,14,70
13398,5,5,0,0,0,5
13399,671,395,139,20,117,554
13400,214,52,40,83,39,175
13401,119,66,20,4,29,90
13402,101,50,24,0,27,74
13403,9,4,2,3,0,9
13404,352,186,91,15,60,292
13405,78,9,49,3,17,61
13406,6,3,0,0,3,3
13407,160,5,130,0,25,135
13408,176,127,7,3,39,137
13409,21,18,2,0,1,20
13410,76,11,50,0,15,61
13411,48,34,3,5,6,42
13412,466,239,107,18,102,364
13413,80,54,7,1,18,62
13414,18,9,5,0,4,14
13415,31,15,8,0,8,23
13416,193,147,6,3,37,156
13417,41,16,16,0,9,32
13418,63,41,14,5,3,60
13419,36,7,14,5,10,26
13420,80,56,4,0,20,60
13421,174,122,14,1,37,137
13422,5,3,1,0,1,4
13423,46,18,20,0,8,38
13424,27,19,4,3,1,26
13425,17,8,4,2,3,14
13426,57,21,20,4,12,45
13427,8,7,1,0,0,8
13428,147,104,16,1,26,121
13429,72,42,18,0,12,60
13430,62,18,33,1,10,52
13431,42,1,34,0,7,35
13432,36,24,6,0,6,30
13433,30,19,4,0,7,23
13434,77,54,12,1,10,67
13435,78,26,8,28,16,62
13436,63,48,6,0,9,54
13437,36,15,9,3,9,27
13438,39,9,22,0,8,31
13439,37,17,12,0,8,29
13440,39,20,11,0,8,31
13441,239,130,35,28,46,193
13442,23,11,5,0,7,16
13443,6,1,4,0,1,5
13444,4,1,1,0,2,2
13445,52,35,4,1,12,40
13446,52,7,31,8,6,46
13447,171,54,91,4,22,149
13448,141,85,28,0,28,113
13449,21,15,3,0,3,18
13450,29,4,21,2,2,27
13451,43,31,3,2,7,36
13452,29,12,13,1,3,26
13453,6,4,0,1,1,5
13454,11,8,0,0,3,8
13455,37,13,11,3,10,27
13456,347,150,123,6,68,279
13457,118,42,40,12,24,94
13458,30,16,8,0,6,24
13459,56,36,7,1,12,44
13460,1070,389,434,46,201,869
13461,29,7,12,1,9,20
13462,49,28,6,4,11,38
13463,105,31,43,10,21,84
13464,68,36,16,0,16,52
13465,55,34,9,0,12,43
13466,65,41,13,1,10,55
13467,664,393,131,22,118,546
13468,13,2,8,0,3,10
13469,23,6,10,3,4,19
13470,51,33,9,0,9,42
13471,133,50,40,6,37,96
13472,46,35,1,2,8,38
13473,39,10,19,2,8,31
13474,12,8,1,0,3,9
13475,34,6,22,0,6,28
13476,22,11,2,3,6,16
13477,32,21,9,0,2,30
13478,24,1,19,0,4,20
13479,72,35,9,17,11,61
13480,151,24,98,1,28,123
13481,76,38,25,0,13,63
13482,50,13,20,5,12,38
13483,55,11,26,4,14,41
13484,5,0,3,0,2,3
13485,77,38,16,6,17,60
13486,128,66,12,22,28,100
13487,192,13,142,0,37,155
13488,75,33,19,12,11,64
13489,266,64,149,5,48,218
13490,76,45,19,0,12,64
13491,67,26,26,4,11,56
13492,61,28,15,9,9,52
13493,61,17,32,3,9,52
13494,53,34,9,0,10,43
13495,157,91,37,1,28,129
13496,23,3,16,0,4,19
13497,166,123,3,1,39,127
13498,149,96,26,1,26,123
13499,16,4,4,0,8,8
13500,93,43,37,2,11,82
13501,45,17,9,8,11,34
13502,11,5,3,0,3,8
13503,70,28,27,2,13,57
13504,113,25,38,27,23,90
13505,59,22,25,0,12,47
13506,9,1,6,0,2,7
13507,53,21,22,0,10,43
13508,97,48,27,5,17,80
13509,24,5,18,0,1,23
13510,475,265,101,14,95,380
13511,33,6,6,10,11,22
13512,69,49,8,1,11,58
13513,213,97,59,13,44,169
13514,130,33,48,16,33,97
13515,61,45,4,0,12,49
13516,125,73,20,3,29,96
13517,110,40,5,51,14,96
13518,69,15,42,0,12,57
13519,8,4,3,0,1,7
13520,33,12,13,2,6,27
13521,61,24,30,0,7,54
13522,76,56,8,3,9,67
13523,34,32,0,0,2,32
13524,33,7,18,4,4,29
13525,15,9,6,0,0,15
13526,48,18,16,4,10,38
13527,105,29,54,4,18,87
13528,39,2,19,12,6,33
13529,153,64,36,18,35,118
13530,30,14,9,0,7,23
13531,80,35,22,0,23,57
13532,35,2,30,0,3,32
13533,39,6,5,19,9,30
13534,28,11,10,0,7,21
13535,65,41,13,1,10,55
13536,76,13,48,0,15,61
13537,37,10,13,7,7,30
13538,478,227,97,49,105,373
13539,73,44,11,3,15,58
13540,79,45,14,2,18,61
13541,25,9,11,0,5,20
13542,97,50,29,1,17,80
13543,40,22,11,1,6,34
13544,5,3,2,0,0,5
13545,60,29,6,10,15,45
13546,42,25,8,2,7,35
13547,46,8,23,5,10,36
13548,86,52,16,0,18,68
13549,38,1,31,0,6,32
13550,68,42,19,4,3,65
13551,60,35,8,7,10,50
13552,9,0,6,0,3,6
13553,76,14,44,7,11,65
13554,50,19,13,9,9,41
13555,46,18,20,0,8,38
13556,17,6,5,0,6,11
13557,19,8,8,2,1,18
13558,52,18,26,0,8,44
13559,40,16,17,2,5,35
13560,12,7,4,0,1,11
13561,113,45,38,6,24,89
13562,281,160,30,33,58,223
13563,34,21,2,2,9,25
13564,44,23,16,0,5,39
13565,77,48,13,8,8,69
13566,46,18,20,0,8,38
13567,379,220,82,15,62,317
13568,33,8,17,4,4,29
13569,86,44,24,0,18,68
13570,30,11,10,1,8,22
13571,15,6,1,3,5,10
13572,454,232,114,12,96,358
13573,450,212,139,12,87,363
13574,27,16,8,0,3,24
13575,83,55,8,0,20,63
13576,204,97,61,1,45,159
13577,7,1,3,2,1,6
13578,27,7,10,1,9,18
13579,107,69,23,3,12,95
13580,189,152,12,1,24,165
13581,41,10,21,0,10,31
13582,31,2,23,2,4,27
13583,28,12,13,0,3,25
13584,45,23,16,0,6,39
13585,72,44,17,0,11,61
13586,144,109,3,3,29,115
13587,46,18,20,0,8,38
13588,20,10,3,1,6,14
13589,572,404,46,1,121,451
13590,63,20,27,2,14,49
13591,446,331,20,0,95,351
13592,22,7,11,0,4,18
13593,34,8,21,0,5,29
13594,20,10,4,1,5,15
13595,52,30,10,2,10,42
13596,237,111,74,0,52,185
13597,5,1,2,0,2,3
13598,16,8,7,0,1,15
13599,80,36,26,5,13,67
13600,16,4,9,0,3,13
13601,34,10,21,0,3,31
13602,287,153,68,14,52,235
13603,21,8,7,0,6,15
13604,23,1,17,0,5,18
13605,77,18,31,0,28,49
13606,344,185,80,7,72,272
13607,30,22,0,0,8,22
13608,279,90,128,15,46,233
13609,90,37,27,0,26,64
13610,18,9,4,1,4,14
13611,169,93,22,18,36,133
13612,59,5,41,1,12,47
13613,36,15,12,0,9,27
13614,102,51,24,0,27,75
13615,53,27,6,4,16,37
13616,104,43,14,24,23,81
13617,83,21,47,0,15,68
13618,61,47,1,0,13,48
13619,28,15,6,0,7,21
13620,38,3,29,1,5,33
13621,50,35,0,0,15,35
13622,13,3,7,1,2,11
13623,76,39,13,9,15,61
13624,150,50,48,20,32,118
13625,106,72,11,2,21,85
13626,19,9,3,1,6,13
13627,77,45,20,0,12,65
13628,89,43,29,1,16,73
13629,343,143,127,6,67,276
13630,104,54,23,7,20,84
13631,25,5,15,0,5,20
13632,117,42,48,7,20,97
13633,43,27,8,0,8,35
13634,44,3,29,7,5,39
13635,85,44,26,0,15,70
13636,211,114,63,0,34,177
13637,399,186,136,7,70,329
13638,33,18,6,0,9,24
13639,67,39,2,13,13,54
13640,95,40,38,4,13,82
13641,87,32,18,8,29,58
13642,22,9,4,2,7,15
13643,44,22,11,4,7,37
13644,45,16,15,1,13,32
13645,46,21,17,1,7,39
13646,59,14,27,2,16,43
13647,47,20,13,4,10,37
13648,143,77,13,23,30,113
13649,141,48,44,17,32,109
13650,120,50,33,14,23,97
13651,100,27,53,0,20,80
13652,39,20,15,0,4,35
13653,73,35,19,3,16,57
13654,53,20,19,1,13,40
13655,136,81,11,17,27,109
13656,50,0,44,0,6,44
13657,57,26,21,1,9,48
13658,63,31,21,0,11,52
13659,3,0,3,0,0,3
13660,248,183,12,1,52,196
13661,64,41,5,0,18,46
13662,45,28,11,0,6,39
13663,118,68,12,12,26,92
13664,20,3,12,0,5,15
13665,3,1,1,0,1,2
13666,125,54,32,14,25,100
13667,108,45,17,23,23,85
13668,32,21,9,0,2,30
13669,28,8,0,9,11,17
13670,212,52,121,2,37,175
13671,74,44,18,0,12,62
13672,143,40,46,22,35,108
13673,12,10,1,0,1,11
13674,194,114,13,22,45,149
13675,183,11,138,0,34,149
13676,45,25,8,4,8,37
13677,68,8,6,35,19,49
13678,46,18,20,0,8,38
13679,168,129,6,0,33,135
13680,19,7,9,1,2,17
13681,56,18,27,2,9,47
13682,53,32,13,0,8,45
13683,28,14,12,0,2,26
13684,171,83,56,4,28,143
13685,170,47,96,4,23,147
13686,49,17,23,0,9,40
13687,94,45,33,3,13,81
13688,265,144,76,0,45,220
13689,75,46,8,5,16,59
13690,74,23,36,0,15,59
13691,65,43,8,0,14,51
13692,30,14,9,0,7,23
13693,73,52,4,0,17,56
13694,82,57,8,1,16,66
13695,41,20,11,2,8,33
13696,17,9,2,1,5,12
13697,430,212,105,28,85,345
13698,53,27,10,7,9,44
13699,81,32,33,1,15,66
13700,126,106,2,0,18,108
13701,2,1,0,0,1,1
13702,169,87,56,0,26,143
13703,266,198,16,0,52,214
13704,52,17,25,0,10,42
13705,49,9,28,4,8,41
13706,47,24,6,3,14,33
13707,37,22,6,1,8,29
13708,60,22,14,13,11,49
13709,59,34,15,0,10,49
13710,103,74,6,1,22,81
13711,63,41,10,2,10,53
13712,30,2,21,1,6,24
13713,40,21,13,0,6,34
13714,218,166,8,0,44,174
13715,8,0,8,0,0,8
13716,220,149,30,0,41,179
13717,20,9,4,0,7,13
13718,73,35,17,12,9,64
13719,63,26,20,5,12,51
13720,17,3,11,0,3,14
13721,5,2,1,0,2,3
13722,21,0,19,0,2,19
13723,17,7,5,2,3,14
13724,198,107,30,23,38,160
13725,441,260,97,6,78,363
13726,64,25,6,18,15,49
13727,425,134,172,27,92,333
13728,28,5,15,4,4,24
13729,10,3,4,0,3,7
13730,90,41,25,1,23,67
13731,5,2,2,0,1,4
13732,51,16,25,3,7,44
13733,203,54,23,94,32,171
13734,75,47,18,1,9,66
13735,25,9,12,0,4,21
13736,273,74,148,1,50,223
13737,389,224,86,0,79,310
13738,0,0,0,0,0,0
13739,132,79,30,0,23,109
13740,56,28,14,3,11,45
13741,15,0,11,0,4,11
13742,85,33,35,2,15,70
13743,29,14,12,2,1,28
13744,140,66,42,10,22,118
13745,9,3,3,1,2,7
13746,33,6,16,0,11,22
13747,206,110,62,0,34,172
13748,84,39,28,4,13,71
13749,27,10,11,0,6,21
13750,42,12,15,8,7,35
13751,38,10,21,1,6,32
13752,75,18,42,4,11,64
13753,36,19,11,0,6,30
13754,33,10,6,10,7,26
13755,31,24,4,0,3,28
13756,54,26,13,4,11,43
13757,127,99,6,0,22,105
13758,27,13,6,0,8,19
13759,29,6,16,0,7,22
13760,189,137,15,2,35,154
13761,17,3,4,0,10,7
13762,111,64,10,12,25,86
13763,9,0,8,0,1,8
13764,77,17,47,6,7,70
13765,156,75,49,1,31,125
13766,211,96,59,13,43,168
13767,55,5,38,0,12,43
13768,13,7,0,1,5,8
13769,129,77,30,0,22,107
13770,112,65,24,6,17,95
13771,122,64,38,1,19,103
13772,599,414,56,1,128,471
13773,80,43,10,7,20,60
13774,12,5,4,0,3,9
13775,34,16,13,0,5,29
13776,33,9,11,6,7,26
13777,49,40,3,0,6,43
13778,612,349,144,17,102,510
13779,3,3,0,0,0,3
13780,30,11,13,0,6,24
13781,40,9,23,0,8,32
13782,11,3,5,0,3,8
13783,45,2,27,7,9,36
13784,13,8,3,1,1,12
13785,31,19,9,0,3,28
13786,529,290,104,13,122,407
13787,15,14,0,0,1,14
13788,376,195,106,4,71,305
13789,84,44,19,0,21,63
13790,34,16,8,1,9,25
13791,19,7,7,0,5,14
13792,95,55,24,3,13,82
13793,46,18,20,0,8,38
13794,159,108,26,0,25,134
13795,62,43,8,4,7,55
13796,220,150,29,0,41,179
13797,240,127,70,0,43,197
13798,53,10,28,5,10,43
13799,11,2,6,1,2,9
13800,14,5,8,0,1,13
13801,5,0,3,0,2,3
13802,73,32,23,3,15,58
13803,198,42,55,61,40,158
13804,106,48,34,5,19,87
13805,65,13,35,1,16,49
13806,29,11,12,0,6,23
13807,91,26,38,9,18,73
13808,121,81,21,9,10,111
13809,151,60,36,19,36,115
13810,33,14,14,0,5,28
13811,49,31,5,6,7,42
13812,180,141,12,1,26,154
13813,26,16,6,0,4,22
13814,151,74,48,0,29,122
13815,241,160,20,3,58,183
13816,20,12,3,0,5,15
13817,37,17,7,5,8,29
13818,29,8,13,2,6,23
13819,24,16,4,0,4,20
13820,118,81,15,2,20,98
13821,108,48,31,2,27,81
13822,129,79,20,5,25,104
13823,46,18,20,0,8,38
13824,48,15,20,0,13,35
13825,58,46,2,0,10,48
13826,361,112,146,27,76,285
13827,58,35,9,4,10,48
13828,6,0,4,0,2,4
13829,44,26,12,0,6,38
13830,32,21,9,0,2,30
13831,93,20,31,24,18,75
13832,114,37,39,10,28,86
13833,693,395,160,23,115,578
13834,20,7,9,0,4,16
13835,58,13,5,28,12,46
13836,101,78,3,0,20,81
13837,97,65,11,1,20,77
13838,35,12,13,0,10,25
13839,47,18,22,1,6,41
13840,141,10,82,18,31,110
13841,11,4,2,2,3,8
13842,55,15,31,0,9,46
13843,73,23,24,14,12,61
13844,19,6,10,0,3,16
13845,67,52,2,0,13,54
13846,38,10,17,0,11,27
13847,138,106,7,3,22,116
13848,54,22,13,4,15,39
13849,76,44,13,3,16,60
13850,28,0,24,0,4,24
13851,53,29,13,2,9,44
13852,200,102,49,0,49,151
13853,21,6,10,0,5,16
13854,30,15,6,1,8,22
13855,35,16,10,0,9,26
13856,31,4,21,0,6,25
13857,127,67,13,20,27,100
13858,141,79,40,13,9,132
13859,34,24,6,4,0,34
13860,155,62,37,18,38,117
13861,20,7,9,1,3,17
13862,147,68,48,5,26,121
13863,27,5,20,0,2,25
13864,77,21,35,7,14,63
13865,24,17,1,0,6,18
13866,74,36,20,0,18,56
13867,76,38,24,0,14,62
13868,80,1,59,0,20,60
13869,146,45,75,3,23,123
13870,137,73,30,7,27,110
13871,471,272,87,9,103,368
13872,224,132,19,26,47,177
13873,222,74,84,15,49,173
13874,55,27,17,1,10,45
13875,127,102,5,0,20,107
13876,43,15,14,0,14,29
13877,3,1,2,0,0,3
13878,19,6,7,0,6,13
13879,104,38,42,9,15,89
13880,137,59,38,18,22,115
13881,152,116,4,2,30,122
13882,76,26,39,0,11,65
13883,16,2,7,0,7,9
13884,397,151,116,42,88,309
13885,11,3,7,1,0,11
13886,6,1,5,0,0,6
13887,45,10,23,4,8,37
13888,86,46,20,0,20,66
13889,94,57,19,4,14,80
13890,100,62,11,2,25,75
13891,175,84,40,14,37,138
13892,44,36,2,0,6,38
13893,189,122,24,6,37,152
13894,8,6,2,0,0,8
13895,107,84,3,0,20,87
13896,31,16,6,0,9,22
13897,153,100,21,3,29,124
13898,264,17,196,2,49,215
13899,81,32,32,4,13,68
13900,19,5,11,0,3,16
13901,580,359,99,7,115,465
13902,12,4,2,0,6,6
13903,46,27,7,1,11,35
13904,15,5,4,2,4,11
13905,66,35,18,0,13,53
13906,10,6,3,0,1,9
13907,128,67,36,13,12,116
13908,609,363,118,16,112,497
13909,45,16,23,2,4,41
13910,23,9,4,6,4,19
13911,183,69,47,27,40,143
13912,111,36,53,1,21,90
13913,49,32,6,2,9,40
13914,247,103,15,82,47,200
13915,19,6,10,0,3,16
13916,58,25,27,0,6,52
13917,94,19,30,25,20,74
13918,34,25,4,5,0,34
13919,112,43,39,7,23,89
13920,59,46,5,0,8,51
13921,347,149,124,6,68,279
13922,353,188,91,15,59,294
13923,67,46,1,4,16,51
13924,115,84,13,9,9,106
13925,125,63,37,0,25,100
13926,28,15,7,0,6,22
13927,142,27,49,25,41,101
13928,1,1,0,0,0,1
13929,187,126,11,11,39,148
13930,33,15,7,0,11,22
13931,25,10,9,0,6,19
13932,18,7,6,0,5,13
13933,25,12,6,1,6,19
13934,31,14,10,2,5,26
13935,47,32,7,2,6,41
13936,148,84,34,0,30,118
13937,38,21,8,2,7,31
13938,7,0,5,0,2,5
13939,56,22,27,0,7,49
13940,3,1,2,0,0,3
13941,161,25,105,1,30,131
13942,327,197,60,0,70,257
13943,64,26,12,10,16,48
13944,12,5,3,0,4,8
13945,2,2,0,0,0,2
13946,133,44,31,23,35,98
13947,59,11,21,15,12,47
13948,448,155,152,48,93,355
13949,327,139,113,6,69,258
13950,29,14,12,0,3,26
13951,69,44,12,1,12,57
13952,12,9,2,0,1,11
13953,154,76,39,7,32,122
13954,17,10,1,1,5,12
13955,8,0,6,0,2,6
13956,118,45,29,15,29,89
13957,141,66,42,11,22,119
13958,239,171,14,2,52,187
13959,74,32,29,3,10,64
13960,79,21,42,2,14,65
13961,33,9,16,0,8,25
13962,46,18,20,0,8,38
13963,25,9,12,0,4,21
13964,46,15,19,4,8,38
13965,115,51,41,4,19,96
13966,34,2,24,0,8,26
13967,32,21,9,0,2,30
13968,103,65,10,5,23,80
13969,24,8,12,1,3,21
13970,63,21,27,1,14,49
13971,74,4,52,0,18,56
13972,100,36,40,10,14,86
13973,40,25,8,4,3,37
13974,105,83,4,12,6,99
13975,201,107,61,0,33,168
13976,141,91,29,0,21,120
13977,31,14,8,1,8,23
13978,38,18,15,0,5,33
13979,261,102,55,39,65,196
13980,39,11,23,0,5,34
13981,54,32,14,1,7,47
13982,44,11,19,0,14,30
13983,72,29,28,1,14,58
13984,31,16,6,1,8,23
13985,50,16,22,4,8,42
13986,50,19,19,0,12,38
13987,53,31,16,0,6,47
13988,12,4,6,0,2,10
13989,38,24,6,0,8,30
13990,206,87,43,27,49,157
13991,78,22,41,2,13,65
13992,13,4,6,0,3,10
13993,206,50,50,69,37,169
13994,76,5,54,1,16,60
13995,64,31,17,2,14,50
13996,154,96,17,11,30,124
13997,73,50,13,0,10,63
13998,52,25,15,1,11,41
13999,73,12,48,0,13,60
14000,41,16,5,5,15,26
14001,76,45,21,0,10,66
14002,52,12,23,8,9,43
14003,107,37,39,9,22,85
14004,160,71,50,3,36,124
14005,15,7,1,5,2,13
14006,142,25,54,23,40,102
14007,96,27,20,28,21,75
14008,127,63,16,17,31,96
14009,78,38,16,5,19,59
14010,75,22,36,3,14,61
14011,196,73,53,27,43,153
14012,113,40,32,13,28,85
14013,141,95,21,0,25,116
14014,67,14,39,0,14,53
14015,91,42,13,12,24,67
14016,84,26,43,0,15,69
14017,22,5,16,1,0,22
14018,72,17,42,6,7,65
14019,30,16,6,2,6,24
14020,162,114,24,0,24,138
14021,188,127,19,1,41,147
14022,59,19,16,13,11,48
14023,110,31,57,0,22,88
14024,44,8,28,1,7,37
14025,5,2,0,3,0,5
14026,71,45,12,2,12,59
14027,225,97,14,76,38,187
14028,64,23,28,0,13,51
14029,32,21,9,0,2,30
14030,151,64,32,20,35,116
14031,233,132,22,29,50,183
14032,20,9,4,2,5,15
14033,20,0,15,2,3,17
14034,2,2,0,0,0,2
14035,115,48,29,16,22,93
14036,22,11,1,7,3,19
14037,480,224,156,11,89,391
14038,220,150,29,0,41,179
14039,238,150,41,3,44,194
14040,74,37,26,0,11,63
14041,105,38,25,19,23,82
14042,518,211,150,45,112,406
14043,693,409,141,20,123,570
14044,50,5,32,1,12,38
14045,234,124,55,13,42,192
14046,18,6,9,0,3,15
14047,16,8,3,1,4,12
14048,138,96,15,2,25,113
14049,60,31,7,5,17,43
14050,55,24,13,6,12,43
14051,22,1,17,0,4,18
14052,45,30,6,3,6,39
14053,189,56,101,4,28,161
14054,75,25,36,1,13,62
14055,17,4,6,2,5,12
14056,116,41,47,0,28,88
14057,32,21,9,0,2,30
14058,80,36,22,3,19,61
14059,32,21,9,0,2,30
14060,31,13,13,0,5,26
14061,6,3,2,0,1,5
14062,107,70,23,0,14,93
14063,90,42,13,11,24,66
14064,103,45,34,5,19,84
14065,4,1,2,0,1,3
14066,35,15,10,0,10,25
14067,82,43,21,0,18,64
14068,10,5,4,0,1,9
14069,171,113,27,1,30,141
14070,23,16,2,0,5,18
14071,24,6,13,1,4,20
14072,50,17,23,2,8,42
14073,44,30,5,4,5,39
14074,205,110,62,0,33,172
14075,19,10,5,0,4,15
14076,21,9,6,0,6,15
14077,266,178,34,3,51,215
14078,64,30,14,8,12,52
14079,85,56,14,0,15,70
14080,18,10,4,2,2,16
14081,51,0,34,2,15,36
14082,7,3,1,2,1,6
14083,35,5,23,2,5,30
14084,42,4,29,0,9,33
14085,95,26,35,13,21,74
14086,17,1,13,0,3,14
14087,2,1,1,0,0,2
14088,13,3,7,0,3,10
14089,50,28,12,2,8,42
14090,17,2,14,0,1,16
14091,164,9,94,28,33,131
14092,641,355,157,24,105,536
14093,39,3,24,0,12,27
14094,50,19,15,8,8,42
14095,26,4,16,0,6,20
14096,6,1,5,0,0,6
14097,102,44,12,16,30,72
14098,60,41,5,1,13,47
14099,13,1,8,0,4,9
14100,46,18,20,0,8,38
14101,373,209,90,15,59,314
14102,248,125,66,0,57,191
14103,9,7,0,0,2,7
14104,114,45,34,10,25,89
14105,83,26,29,9,19,64
14106,29,9,11,0,9,20
14107,327,195,61,0,71,256
14108,46,18,20,0,8,38
14109,76,1,55,1,19,57
14110,39,6,25,1,7,32
14111,26,8,12,0,6,20
14112,161,68,34,20,39,122
14113,69,26,6,21,16,53
14114,97,57,23,3,14,83
14115,82,41,28,1,12,70
14116,127,88,11,2,26,101
14117,16,11,3,0,2,14
14118,71,45,15,0,11,60
14119,35,15,10,0,10,25
14120,70,39,15,0,16,54
14121,25,14,7,0,4,21
14122,106,37,46,10,13,93
14123,68,16,32,3,17,51
14124,36,25,3,4,4,32
14125,99,30,40,10,19,80
14126,70,39,16,0,15,55
14127,190,75,44,30,41,149
14128,117,48,30,18,21,96
14129,16,8,7,0,1,15
14130,53,30,11,0,12,41
14131,21,1,12,1,7,14
14132,32,21,9,0,2,30
14133,4,3,0,0,1,3
14134,405,99,174,41,91,314
14135,3,2,0,0,1,2
14136,32,21,9,0,2,30
14137,220,63,21,101,35,185
14138,13,7,1,5,0,13
14139,46,18,20,0,8,38
14140,66,26,26,3,11,55
14141,77,49,11,3,14,63
14142,258,192,13,0,53,205
14143,294,96,127,10,61,233
14144,49,1,37,0,11,38
14145,357,254,30,0,73,284
14146,85,57,18,1,9,76
14147,54,33,4,3,14,40
14148,77,41,10,3,23,54
14149,39,22,9,0,8,31
14150,145,36,77,1,31,114
14151,29,5,18,0,6,23
14152,156,56,37,30,33,123
14153,58,17,32,0,9,49
14154,131,85,15,6,25,106
14155,208,125,34,2,47,161
14156,64,44,8,0,12,52
14157,54,9,28,3,14,40
14158,155,41,73,4,37,118
14159,13,1,9,0,3,10
14160,70,29,27,1,13,57
14161,42,14,8,15,5,37
14162,4,0,2,2,0,4
14163,583,329,115,13,126,457
14164,130,52,45,18,15,115
14165,40,0,35,1,4,36
14166,159,54,45,32,28,131
14167,78,52,10,0,16,62
14168,31,15,5,0,11,20
14169,204,77,39,38,50,154
14170,38,21,3,0,14,24
14171,51,18,18,2,13,38
14172,162,114,23,0,25,137
14173,477,223,158,13,83,394
14174,90,44,19,4,23,67
14175,42,25,7,0,10,32
14176,148,58,45,9,36,112
14177,55,38,6,1,10,45
14178,31,14,9,3,5,26
14179,42,27,3,0,12,30
14180,159,108,26,0,25,134
14181,45,21,15,1,8,37
14182,82,16,31,17,18,64
14183,225,88,14,81,42,183
14184,56,28,17,0,11,45
14185,13,2,9,0,2,11
14186,30,9,14,0,7,23
14187,254,51,154,1,48,206
14188,181,120,13,9,39,142
14189,84,17,41,9,17,67
14190,118,57,31,8,22,96
14191,347,149,124,6,68,279
14192,43,23,10,3,7,36
14193,121,50,40,3,28,93
14194,157,71,51,6,29,128
14195,440,200,147,11,82,358
14196,11,0,7,0,4,7
14197,103,45,34,5,19,84
14198,46,18,20,0,8,38
14199,75,25,28,9,13,62
14200,40,13,19,1,7,33
14201,67,10,49,0,8,59
14202,369,187,98,19,65,304
14203,16,12,3,0,1,15
14204,48,13,16,12,7,41
14205,46,18,20,0,8,38
14206,32,21,9,0,2,30
14207,127,49,30,15,33,94
14208,38,20,12,0,6,32
14209,65,23,33,0,9,56
14210,150,99,28,0,23,127
14211,35,15,10,0,10,25
14212,17,8,5,1,3,14
14213,112,74,23,3,12,100
14214,87,46,27,1,13,74
14215,46,27,10,0,9,37
14216,11,5,3,0,3,8
14217,56,37,12,0,7,49
14218,15,7,4,2,2,13
14219,31,6,14,1,10,21
14220,42,29,10,3,0,42
14221,31,10,11,3,7,24
14222,148,67,47,5,29,119
14223,62,13,43,0,6,56
14224,35,19,12,0,4,31
14225,172,121,13,1,37,135
14226,132,100,4,2,26,106
14227,164,113,24,0,27,137
14228,14,3,8,0,3,11
14229,93,47,13,2,31,62
14230,64,40,13,1,10,54
14231,10,1,8,0,1,9
14232,62,29,15,5,13,49
14233,13,9,2,0,2,11
14234,63,23,21,7,12,51
14235,17,1,13,0,3,14
14236,22,6,9,1,6,16
14237,595,342,125,18,110,485
14238,38,16,16,0,6,32
14239,23,5,7,4,7,16
14240,277,161,70,0,46,231
14241,92,57,12,2,21,71
14242,41,13,13,6,9,32
14243,101,38,32,7,24,77
14244,34,12,8,11,3,31
14245,67,17,40,0,10,57
14246,31,11,15,1,4,27
14247,32,21,9,0,2,30
14248,11,7,3,0,1,10
14249,151,59,47,9,36,115
14250,241,134,35,30,42,199
14251,37,23,4,4,6,31
14252,34,16,7,3,8,26
14253,25,7,13,0,5,20
14254,126,46,42,13,25,101
14255,68,32,22,2,12,56
14256,10,8,2,0,0,10
14257,176,132,5,1,38,138
14258,46,18,20,0,8,38
14259,16,9,4,0,3,13
14260,90,63,6,8,13,77
14261,32,4,19,2,7,25
14262,56,27,13,6,10,46
14263,622,366,139,18,99,523
14264,26,13,8,0,5,21
14265,52,7,30,1,14,38
14266,55,16,33,0,6,49
14267,48,20,15,6,7,41
14268,422,113,199,9,101,321
14269,47,14,11,11,11,36
14270,5,3,1,1,0,5
14271,33,9,16,0,8,25
14272,58,37,7,0,14,44
14273,71,32,28,0,11,60
14274,61,32,19,2,8,53
14275,16,6,3,1,6,10
14276,72,61,3,0,8,64
14277,6,1,5,0,0,6
14278,7,4,1,0,2,5
14279,32,23,0,2,7,25
14280,17,6,4,4,3,14
14281,62,41,13,5,3,59
14282,206,89,62,19,36,170
14283,21,8,9,0,4,17
14284,17,8,2,2,5,12
14285,102,19,60,1,22,80
14286,92,40,12,19,21,71
14287,78,9,50,3,16,62
14288,39,4,30,0,5,34
14289,76,34,18,12,12,64
14290,115,28,62,1,24,91
14291,27,14,8,0,5,22
14292,46,18,20,0,8,38
14293,129,78,27,0,24,105
14294,118,59,22,11,26,92
14295,109,48,29,12,20,89
14296,178,136,7,0,35,143
14297,35,13,14,2,6,29
14298,51,16,22,3,10,41
14299,15,0,11,0,4,11
14300,49,19,23,1,6,43
14301,33,2,23,0,8,25
14302,536,389,31,1,115,421
14303,51,25,21,0,5,46
14304,139,22,60,24,33,106
14305,99,35,39,10,15,84
14306,105,37,25,20,23,82
14307,168,125,3,2,38,130
14308,2,0,2,0,0,2
14309,32,15,14,1,2,30
14310,466,220,145,13,88,378
14311,22,4,5,10,3,19
14312,33,9,11,6,7,26
14313,76,18,46,0,12,64
14314,32,21,9,0,2,30
14315,35,19,5,1,10,25
14316,439,108,184,46,101,338
14317,71,33,27,0,11,60
14318,179,83,67,8,21,158
14319,38,3,25,0,10,28
14320,658,363,163,23,109,549
14321,22,2,14,2,4,18
14322,59,26,14,10,9,50
14323,110,79,5,1,25,85
14324,21,5,7,2,7,14
14325,62,7,50,0,5,57
14326,37,27,5,0,5,32
14327,274,136,76,0,62,212
14328,7,2,2,2,1,6
14329,102,67,1,12,22,80
14330,10,0,8,0,2,8
14331,114,30,54,5,25,89
14332,311,172,68,0,71,240
14333,4,1,3,0,0,4
14334,30,22,0,0,8,22
14335,55,13,23,9,10,45
14336,3,1,2,0,0,3
14337,59,34,17,0,8,51
14338,75,38,16,2,19,56
14339,13,7,4,0,2,11
14340,59,19,29,0,11,48
14341,19,2,14,0,3,16
14342,334,146,113,6,69,265
14343,171,113,27,1,30,141
14344,6,4,0,0,2,4
14345,19,5,1,8,5,14
14346,95,53,25,5,12,83
14347,508,243,109,56,100,408
14348,204,28,95,35,46,158
14349,9,2,3,0,4,5
14350,110,37,50,0,23,87
14351,34,11,14,0,9,25
14352,38,6,27,0,5,33
14353,81,23,38,5,15,66
14354,18,7,8,0,3,15
14355,16,0,14,0,2,14
14356,14,8,4,0,2,12
14357,479,333,43,1,102,377
14358,76,46,17,0,13,63
14359,89,53,23,1,12,77
14360,50,26,10,2,12,38
14361,24,18,2,4,0,24
14362,56,9,19,20,8,48
14363,32,5,23,1,3,29
14364,78,42,23,0,13,65
14365,27,4,5,10,8,19
14366,117,64,31,0,22,95
14367,218,116,34,25,43,175
14368,104,66,26,0,12,92
14369,148,37,76,1,34,114
14370,8,7,1,0,0,8
14371,37,16,14,0,7,30
14372,75,36,14,7,18,57
14373,81,39,26,1,15,66
14374,28,11,14,0,3,25
14375,145,95,28,0,22,123
14376,78,15,45,1,17,61
14377,6,3,1,0,2,4
14378,140,63,32,11,34,106
14379,164,31,102,1,30,134
14380,20,11,6,1,2,18
14381,101,51,24,0,26,75
14382,26,4,19,0,3,23
14383,630,370,140,18,102,528
14384,7,0,5,0,2,5
14385,5,3,1,1,0,5
14386,204,109,50,0,45,159
14387,46,18,20,0,8,38
14388,47,19,21,1,6,41
14389,36,14,13,2,7,29
14390,122,57,33,0,32,90
14391,107,62,16,4,25,82
14392,350,86,150,30,84,266
14393,453,230,118,12,93,360
14394,140,79,22,3,36,104
14395,252,188,12,1,51,201
14396,57,17,30,0,10,47
14397,169,124,11,2,32,137
14398,118,51,41,0,26,92
14399,24,8,9,2,5,19
14400,90,50,17,1,22,68
14401,4,1,3,0,0,4
14402,16,4,9,0,3,13
14403,50,16,15,3,16,34
14404,22,5,14,0,3,19
14405,25,14,6,2,3,22
14406,394,194,94,19,87,307
14407,518,257,100,54,107,411
14408,53,27,15,1,10,43
14409,16,7,6,0,3,13
14410,4,3,0,0,1,3
14411,1308,530,183,338,257,1051
14412,184,145,11,0,28,156
14413,225,90,42,38,55,170
14414,14,3,9,0,2,12
14415,112,84,7,14,7,105
14416,64,33,22,0,9,55
14417,1,0,1,0,0,1
14418,67,36,14,0,17,50
14419,461,117,198,43,103,358
14420,130,29,49,21,31,99
14421,6,3,1,0,2,4
14422,39,15,16,0,8,31
14423,16,6,9,0,1,15
14424,14,7,3,0,4,10
14425,64,37,5,8,14,50
14426,402,129,174,11,88,314
14427,10,3,4,1,2,8
14428,130,46,27,25,32,98
14429,49,23,13,2,11,38
14430,42,29,3,3,7,35
14431,135,58,53,1,23,112
14432,46,33,4,3,6,40
14433,63,41,13,0,9,54
14434,49,23,11,0,15,34
14435,121,50,30,18,23,98
14436,63,39,11,2,11,52
14437,149,62,32,21,34,115
14438,50,36,4,2,8,42
14439,167,128,3,1,35,132
14440,119,86,5,2,26,93
14441,104,50,31,2,21,83
14442,39,10,16,0,13,26
14443,61,23,21,5,12,49
14444,76,27,32,3,14,62
14445,76,28,28,4,16,60
14446,78,39,27,0,12,66
14447,94,64,7,4,19,75
14448,7,0,5,0,2,5
14449,49,1,43,0,5,44
14450,10,0,9,0,1,9
14451,64,35,16,0,13,51
14452,89,61,6,9,13,76
14453,158,92,37,1,28,130
14454,82,63,1,0,18,64
14455,54,30,12,2,10,44
14456,46,15,16,12,3,43
14457,61,19,17,16,9,52
14458,33,2,6,17,8,25
14459,106,84,3,0,19,87
14460,60,21,17,14,8,52
14461,56,40,1,0,15,41
14462,15,4,10,0,1,14
14463,20,5,0,8,7,13
14464,408,135,166,19,88,320
14465,9,4,3,0,2,7
14466,52,31,11,0,10,42
14467,72,24,31,1,16,56
14468,72,45,8,0,19,53
14469,81,57,5,5,14,67
14470,283,118,108,8,49,234
14471,50,19,16,3,12,38
14472,35,16,9,0,10,25
14473,43,13,19,4,7,36
14474,163,111,26,0,26,137
14475,263,195,15,0,53,210
14476,359,199,88,15,57,302
14477,48,35,0,0,13,35
14478,47,36,1,0,10,37
14479,199,148,13,1,37,162
14480,77,46,19,0,12,65
14481,239,21,171,2,45,194
14482,664,387,148,16,113,551
14483,23,17,4,0,2,21
14484,44,12,26,0,6,38
14485,115,52,30,8,25,90
14486,54,33,13,0,8,46
14487,37,15,3,10,9,28
14488,89,38,37,0,14,75
14489,47,3,34,6,4,43
14490,12,7,2,2,1,11
14491,28,6,17,0,5,23
14492,116,62,10,21,23,93
14493,32,21,9,0,2,30
14494,22,12,6,0,4,18
14495,85,60,4,1,20,65
14496,154,75,51,5,23,131
14497,24,5,15,3,1,23
14498,38,8,21,2,7,31
14499,8,5,3,0,0,8
14500,42,11,14,7,10,32
14501,36,9,16,3,8,28
14502,50,7,30,0,13,37
14503,51,22,6,15,8,43
14504,46,18,20,0,8,38
14505,57,26,20,1,10,47
14506,40,5,18,5,12,28
14507,73,38,14,8,13,60
14508,225,153,31,0,41,184
14509,153,47,81,4,21,132
14510,55,22,17,2,14,41
14511,181,74,38,26,43,138
14512,51,32,7,1,11,40
14513,17,11,3,0,3,14
14514,59,33,15,1,10,49
14515,47,33,4,0,10,37
14516,30,8,15,0,7,23
14517,669,393,140,18,118,551
14518,86,39,21,8,18,68
14519,311,142,100,12,57,254
14520,209,108,35,31,35,174
14521,71,46,12,3,10,61
14522,34,22,4,0,8,26
14523,464,136,188,37,103,361
14524,59,22,4,23,10,49
14525,62,45,7,0,10,52
14526,63,42,11,0,10,53
14527,107,89,3,3,12,95
14528,680,382,163,23,112,568
14529,447,241,104,14,88,359
14530,11,8,3,0,0,11
14531,19,8,7,0,4,15
14532,28,4,20,0,4,24
14533,23,2,4,13,4,19
14534,50,22,13,3,12,38
14535,37,21,6,2,8,29
14536,45,21,14,0,10,35
14537,55,28,10,5,12,43
14538,246,60,133,7,46,200
14539,76,27,35,1,13,63
14540,222,119,67,0,36,186
14541,56,25,14,5,12,44
14542,28,10,13,0,5,23
14543,125,52,54,1,18,107
14544,117,63,34,2,18,99
14545,35,7,25,0,3,32
14546,30,0,24,0,6,24
14547,202,52,39,76,35,167
14548,113,42,42,10,19,94
14549,46,18,20,0,8,38
14550,224,113,58,12,41,183
14551,126,41,43,18,24,102
14552,63,41,4,0,18,45
14553,162,112,24,0,26,136
14554,78,28,22,9,19,59
14555,27,7,9,0,11,16
14556,32,21,9,0,2,30
14557,282,148,75,13,46,236
14558,91,48,11,2,30,61
14559,121,63,17,13,28,93
14560,173,48,49,41,35,138
14561,40,21,14,0,5,35
14562,15,3,8,0,4,11
14563,36,14,15,0,7,29
14564,33,14,10,2,7,26
14565,39,9,13,10,7,32
14566,25,5,11,5,4,21
14567,43,29,1,2,11,32
14568,10,0,6,0,4,6
14569,39,23,8,0,8,31
14570,20,2,16,0,2,18
14571,50,9,29,0,12,38
14572,50,10,29,1,10,40
14573,92,65,7,0,20,72
14574,51,19,4,18,10,41
14575,103,67,1,13,22,81
14576,213,58,21,102,32,181
14577,17,2,14,0,1,16
14578,129,65,13,23,28,101
14579,61,35,14,0,12,49
14580,88,46,16,3,23,65
14581,4,1,1,0,2,2
14582,111,51,24,15,21,90
14583,63,41,13,0,9,54
14584,31,14,13,0,4,27
14585,148,81,30,1,36,112
14586,22,7,12,0,3,19
14587,142,98,13,1,30,112
14588,129,41,47,17,24,105
14589,49,23,3,14,9,40
14590,15,7,4,0,4,11
14591,142,64,43,6,29,113
14592,42,26,10,0,6,36
14593,19,8,10,0,1,18
14594,16,1,12,1,2,14
14595,31,13,10,2,6,25
14596,61,31,14,4,12,49
14597,72,50,7,0,15,57
14598,50,29,13,0,8,42
14599,25,4,15,0,6,19
14600,38,20,12,0,6,32
14601,119,60,25,12,22,97
14602,91,18,48,10,15,76
14603,446,240,104,14,88,358
14604,18,1,11,1,5,13
14605,27,6,9,3,9,18
14606,23,9,10,0,4,19
14607,62,22,24,4,12,50
14608,2,0,1,0,1,1
14609,187,130,43,2,12,175
14610,97,31,40,9,17,80
14611,204,77,39,38,50,154
14612,51,40,1,0,10,41
14613,37,2,25,0,10,27
14614,200,49,26,89,36,164
14615,87,45,12,2,28,59
14616,21,11,8,1,1,20
14617,518,222,140,43,113,405
14618,92,49,17,3,23,69
14619,10,5,0,2,3,7
14620,35,15,16,1,3,32
14621,73,21,40,1,11,62
14622,89,45,17,7,20,69
14623,270,182,64,3,21,249
14624,137,102,14,0,21,116
14625,70,25,32,5,8,62
14626,14,2,7,3,2,12
14627,153,49,51,22,31,122
14628,127,74,22,3,28,99
14629,16,5,6,1,4,12
14630,188,28,112,5,43,145
14631,169,112,26,1,30,139
14632,48,17,21,2,8,40
14633,37,7,18,3,9,28
14634,439,217,138,7,77,362
14635,32,13,14,0,5,27
14636,128,41,53,7,27,101
14637,94,60,9,3,22,72
14638,242,55,128,3,56,186
14639,64,25,14,13,12,52
14640,39,16,20,0,3,36
14641,247,49,150,2,46,201
14642,581,367,77,7,130,451
14643,83,31,33,4,15,68
14644,57,15,30,5,7,50
14645,38,18,9,1,10,28
14646,5,5,0,0,0,5
14647,7,1,3,1,2,5
14648,7,5,1,0,1,6
14649,22,10,4,2,6,16
14650,46,18,20,0,8,38
14651,56,26,21,0,9,47
14652,101,19,50,13,19,82
14653,176,79,56,5,36,140
14654,30,12,12,0,6,24
14655,18,9,8,0,1,17
14656,109,63,27,6,13,96
14657,50,37,9,2,2,48
14658,98,46,33,0,19,79
14659,446,330,20,0,96,350
14660,69,48,9,1,11,58
14661,81,25,34,2,20,61
14662,504,270,82,45,107,397
14663,91,59,21,0,11,80
14664,75,36,15,0,24,51
14665,40,14,20,1,5,35
14666,36,20,13,0,3,33
14667,97,50,19,12,16,81
14668,181,133,13,1,34,147
14669,23,15,5,1,2,21
14670,100,78,8,0,14,86
14671,16,8,2,0,6,10
14672,32,21,9,0,2,30
14673,11,10,0,0,1,10
14674,42,17,14,0,11,31
14675,74,16,51,2,5,69
14676,138,92,28,3,15,123
14677,104,58,24,3,19,85
14678,100,56,26,2,16,84
14679,33,12,10,1,10,23
14680,46,25,6,5,10,36
14681,6,1,3,0,2,4
14682,100,66,1,12,21,79
14683,43,20,14,1,8,35
14684,32,30,0,0,2,30
14685,397,204,117,2,74,323
14686,94,50,30,1,13,81
14687,62,14,32,1,15,47
14688,64,41,5,0,18,46
14689,191,90,58,1,42,149
14690,16,5,9,1,1,15
14691,2,0,2,0,0,2
14692,71,35,14,7,15,56
14693,464,131,196,38,99,365
14694,336,159,84,25,68,268
14695,32,14,11,0,7,25
14696,27,12,10,0,5,22
14697,49,15,25,1,8,41
14698,65,41,13,1,10,55
14699,21,5,9,0,7,14
14700,14,3,3,2,6,8
14701,344,186,88,15,55,289
14702,138,59,27,24,28,110
14703,210,154,12,1,43,167
14704,17,9,0,3,5,12
14705,10,4,5,0,1,9
14706,402,212,93,19,78,324
14707,36,31,3,0,2,34
14708,405,300,20,0,85,320
14709,40,6,26,1,7,33
14710,53,23,12,3,15,38
14711,35,0,30,0,5,30
14712,73,30,20,1,22,51
14713,79,41,9,18,11,68
14714,71,45,15,0,11,60
14715,29,7,13,0,9,20
14716,192,61,79,13,39,153
14717,23,13,0,5,5,18
14718,168,86,38,6,38,130
14719,27,6,19,0,2,25
14720,19,9,5,0,5,14
14721,79,32,21,12,14,65
14722,4,2,0,1,1,3
14723,24,5,13,0,6,18
14724,664,388,141,18,117,547
14725,44,25,11,2,6,38
14726,41,9,14,6,12,29
14727,420,139,144,48,89,331
14728,41,9,9,16,7,34
14729,15,4,7,0,4,11
14730,43,25,10,0,8,35
14731,244,77,116,12,39,205
14732,8,0,5,1,2,6
14733,46,28,9,1,8,38
14734,295,148,85,12,50,245
14735,166,127,13,1,25,141
14736,49,34,2,1,12,37
14737,135,76,30,5,24,111
14738,264,196,15,0,53,211
14739,5,4,0,0,1,4
14740,72,40,18,0,14,58
14741,533,233,132,49,119,414
14742,449,256,101,0,92,357
14743,141,44,73,3,21,120
14744,75,37,19,0,19,56
14745,64,34,11,6,13,51
14746,11,3,5,0,3,8
14747,15,0,11,0,4,11
14748,4,0,2,0,2,2
14749,101,67,1,12,21,80
14750,71,42,15,0,14,57
14751,389,224,86,0,79,310
14752,50,20,16,4,10,40
14753,141,101,18,0,22,119
14754,71,5,50,1,15,56
14755,34,5,13,10,6,28
14756,454,334,21,0,99,355
14757,56,3,40,1,12,44
14758,87,32,5,37,13,74
14759,31,13,12,0,6,25
14760,125,56,33,12,24,101
14761,27,3,20,1,3,24
14762,180,87,33,27,33,147
14763,27,6,18,0,3,24
14764,17,3,11,0,3,14
14765,103,38,28,13,24,79
14766,84,35,33,0,16,68
14767,50,25,17,0,8,42
14768,63,33,14,0,16,47
14769,36,27,2,0,7,29
14770,29,7,12,3,7,22
14771,130,24,50,21,35,95
14772,220,51,50,81,38,182
14773,35,18,8,1,8,27
14774,29,13,5,0,11,18
14775,429,231,125,0,73,356
14776,103,13,50,18,22,81
14777,91,22,49,0,20,71
14778,177,52,91,0,34,143
14779,190,145,18,0,27,163
14780,171,129,3,1,38,133
14781,49,23,17,0,9,40
14782,10,4,4,1,1,9
14783,6,4,0,2,0,6
14784,219,67,106,11,35,184
14785,39,2,26,2,9,30
14786,65,43,7,1,14,51
14787,60,25,5,15,15,45
14788,114,61,33,2,18,96
14789,19,3,15,0,1,18
14790,30,18,2,0,10,20
14791,122,57,26,4,35,87
14792,31,5,18,0,8,23
14793,82,39,23,0,20,62
14794,59,18,24,5,12,47
14795,112,49,30,12,21,91
14796,134,44,50,8,32,102
14797,47,18,19,0,10,37
14798,498,362,31,0,105,393
14799,436,134,194,12,96,340
14800,37,28,2,2,5,32
14801,65,41,3,10,11,54
14802,17,10,5,0,2,15
14803,134,102,11,0,21,113
14804,73,12,31,12,18,55
14805,9,0,4,2,3,6
14806,19,8,7,1,3,16
14807,45,27,10,0,8,37
14808,39,9,16,5,9,30
14809,20,6,9,0,5,15
14810,64,43,5,0,16,48
14811,53,27,15,1,10,43
14812,50,31,11,0,8,42
14813,50,11,30,0,9,41
14814,19,4,11,0,4,15
14815,243,101,14,83,45,198
14816,14,2,11,0,1,13
14817,38,25,5,4,4,34
14818,53,30,7,0,16,37
14819,69,39,10,2,18,51
14820,17,14,1,0,2,15
14821,42,9,14,8,11,31
14822,53,24,12,5,12,41
14823,395,131,158,17,89,306
14824,57,36,7,0,14,43
14825,171,113,27,1,30,141
14826,280,188,22,2,68,212
14827,114,52,37,6,19,95
14828,102,47,26,2,27,75
14829,60,45,4,4,7,53
14830,59,22,25,0,12,47
14831,32,11,3,14,4,28
14832,100,48,14,11,27,73
14833,84,52,9,4,19,65
14834,16,4,7,1,4,12
14835,46,32,2,0,12,34
14836,82,40,16,4,22,60
14837,124,26,76,1,21,103
14838,47,8,29,0,10,37
14839,3,0,1,0,2,1
14840,48,21,19,0,8,40
14841,32,0,28,1,3,29
14842,27,5,19,0,3,24
14843,57,14,23,10,10,47
14844,32,6,20,1,5,27
14845,3,1,1,0,1,2
14846,145,62,54,8,21,124
14847,139,51,53,0,35,104
14848,641,393,103,8,137,504
14849,20,15,3,0,2,18
14850,80,23,48,2,7,73
14851,9,3,5,0,1,8
14852,70,20,32,1,17,53
14853,91,19,40,9,23,68
14854,45,27,8,2,8,37
14855,112,14,56,19,23,89
14856,86,38,32,1,15,71
14857,90,56,20,0,14,76
14858,17,7,6,0,4,13
14859,40,11,17,1,11,29
14860,46,18,20,0,8,38
14861,60,15,22,10,13,47
14862,64,37,17,0,10,54
14863,11,8,0,0,3,8
14864,90,30,18,22,20,70
14865,208,42,127,2,37,171
14866,76,32,8,16,20,56
14867,66,26,23,3,14,52
14868,23,7,8,2,6,17
14869,143,66,45,11,21,122
14870,26,9,10,1,6,20
14871,8,1,5,0,2,6
14872,72,19,22,16,15,57
14873,39,21,13,0,5,34
14874,17,15,0,0,2,15
14875,91,36,37,0,18,73
14876,482,241,89,50,102,380
14877,45,24,14,0,7,38
14878,34,19,4,2,9,25
14879,41,24,5,6,6,35
14880,103,29,40,13,21,82
14881,21,1,16,1,3,18
14882,84,41,4,26,13,71
14883,284,194,67,3,20,264
14884,35,8,15,3,9,26
14885,158,82,45,5,26,132
14886,20,6,11,0,3,17
14887,206,139,27,4,36,170
14888,64,29,21,1,13,51
14889,130,84,16,3,27,103
14890,98,38,34,9,17,81
14891,76,38,23,2,13,63
14892,455,337,21,0,97,358
14893,15,5,10,0,0,15
14894,36,19,6,2,9,27
14895,69,47,8,4,10,59
14896,103,65,23,3,12,91
14897,88,45,24,2,17,71
14898,82,31,28,2,21,61
14899,69,40,3,13,13,56
14900,111,73,13,3,22,89
14901,72,46,12,2,12,60
14902,82,56,6,0,20,62
14903,137,81,19,2,35,102
14904,45,24,13,1,7,38
14905,74,27,15,20,12,62
14906,201,132,22,0,47,154
14907,75,26,22,10,17,58
14908,23,1,19,1,2,21
14909,98,35,34,7,22,76
14910,78,25,34,0,19,59
14911,101,35,23,24,19,82
14912,128,37,53,8,30,98
14913,175,119,17,0,39,136
14914,95,43,26,11,15,80
14915,33,10,17,1,5,28
14916,84,43,13,6,22,62
14917,31,12,14,1,4,27
14918,137,53,44,9,31,106
14919,124,22,56,16,30,94
14920,4,0,4,0,0,4
14921,31,5,18,0,8,23
14922,245,157,30,3,55,190
14923,16,0,14,0,2,14
14924,53,29,10,2,12,41
14925,115,44,41,9,21,94
14926,154,55,37,30,32,122
14927,145,64,44,0,37,108
14928,93,41,27,1,24,69
14929,4,1,3,0,0,4
14930,64,31,18,1,14,50
14931,468,218,149,13,88,380
14932,137,72,27,10,28,109
14933,272,55,161,2,54,218
14934,60,31,18,0,11,49
14935,351,188,93,15,55,296
14936,103,60,23,3,17,86
14937,132,103,8,0,21,111
14938,26,1,16,0,9,17
14939,129,67,11,23,28,101
14940,48,8,31,0,9,39
14941,44,8,25,2,9,35
14942,47,17,21,2,7,40
14943,40,21,13,0,6,34
14944,85,38,30,1,16,69
14945,31,12,7,6,6,25
14946,79,40,20,6,13,66
14947,6,0,5,0,1,5
14948,350,147,105,18,80,270
14949,128,77,26,0,25,103
14950,48,17,17,1,13,35
14951,30,23,2,0,5,25
14952,64,42,4,0,18,46
14953,85,38,27,2,18,67
14954,62,7,6,32,17,45
14955,342,146,120,6,70,272
14956,20,9,6,1,4,16
14957,57,14,24,1,18,39
14958,30,22,0,0,8,22
14959,46,18,20,0,8,38
14960,284,114,110,8,52,232
14961,97,69,13,0,15,82
14962,91,22,47,1,21,70
14963,29,9,8,9,3,26
14964,102,67,1,12,22,80
14965,72,27,19,9,17,55
14966,76,36,28,1,11,65
14967,13,6,1,2,4,9
14968,55,24,14,2,15,40
14969,77,30,23,9,15,62
14970,80,55,6,0,19,61
14971,284,68,162,1,53,231
14972,266,57,57,96,56,210
14973,28,8,17,0,3,25
14974,5,4,1,0,0,5
14975,62,43,8,4,7,55
14976,62,32,14,4,12,50
14977,69,47,8,4,10,59
14978,119,58,22,16,23,96
14979,40,3,29,2,6,34
14980,98,45,24,12,17,81
14981,73,46,11,0,16,57
14982,19,2,12,0,5,14
14983,32,21,9,0,2,30
14984,144,16,98,1,29,115
14985,45,7,30,0,8,37
14986,204,84,14,67,39,165
14987,147,50,74,0,23,124
14988,466,346,24,0,96,370
14989,25,5,1,15,4,21
14990,171,69,37,23,42,129
14991,21,8,11,0,2,19
14992,56,24,19,2,11,45
14993,4,1,2,0,1,3
14994,5,2,1,0,2,3
14995,106,50,16,16,24,82
14996,160,111,23,0,26,134
14997,43,4,28,0,11,32
14998,9,0,8,0,1,8
14999,14,7,2,2,3,11
15000,34,12,8,7,7,27
15001,17,0,16,0,1,16
15002,38,14,14,0,10,28
15003,51,30,9,0,12,39
15004,99,25,46,9,19,80
15005,27,17,2,0,8,19
15006,84,50,18,0,16,68
15007,24,0,20,0,4,20
15008,34,6,7,10,11,23
15009,34,13,10,1,10,24
15010,32,15,8,0,9,23
15011,32,21,9,0,2,30
15012,42,36,0,0,6,36
15013,87,58,8,0,21,66
15014,539,258,112,57,112,427
15015,88,9,47,12,20,68
15016,602,416,55,1,130,472
15017,5,1,3,0,1,4
15018,80,34,9,17,20,60
15019,0,0,0,0,0,0
15020,55,46,3,0,6,49
15021,409,98,176,44,91,318
15022,24,13,7,0,4,20
15023,57,15,19,7,16,41
15024,138,78,21,2,37,101
15025,76,41,14,4,17,59
15026,76,38,26,0,12,64
15027,453,310,43,1,99,354
15028,100,45,17,19,19,81
15029,15,10,2,1,2,13
15030,18,10,6,0,2,16
15031,35,19,12,0,4,31
15032,46,18,14,0,14,32
15033,516,360,48,1,107,409
15034,30,9,11,2,8,22
15035,56,38,7,1,10,46
15036,47,21,18,0,8,39
15037,76,40,16,8,12,64
15038,87,43,4,27,13,74
15039,4,0,2,0,2,2
15040,28,12,11,0,5,23
15041,266,166,38,12,50,216
15042,89,47,12,1,29,60
15043,142,109,6,0,27,115
15044,27,6,15,0,6,21
15045,4,0,4,0,0,4
15046,37,5,23,0,9,28
15047,207,153,17,2,35,172
15048,49,22,19,0,8,41
15049,506,273,96,36,101,405
15050,26,5,17,0,4,22
15051,120,48,18,18,36,84
15052,53,29,6,8,10,43
15053,90,43,14,14,19,71
15054,28,16,7,0,5,23
15055,59,27,20,0,12,47
15056,22,11,9,1,1,21
15057,24,4,14,0,6,18
15058,180,102,39,6,33,147
15059,322,195,56,0,71,251
15060,609,359,129,16,105,504
15061,61,27,23,3,8,53
15062,58,19,12,15,12,46
15063,18,13,0,0,5,13
15064,32,21,9,0,2,30
15065,140,85,25,1,29,111
15066,55,27,22,1,5,50
15067,52,36,4,1,11,41
15068,89,40,26,11,12,77
15069,19,3,15,0,1,18
15070,17,15,0,0,2,15
15071,10,3,7,0,0,10
15072,117,38,36,16,27,90
15073,56,28,11,3,14,42
15074,112,25,47,13,27,85
15075,86,65,1,0,20,66
15076,19,1,13,1,4,15
15077,31,9,14,2,6,25
15078,190,131,11,9,39,151
15079,46,27,10,0,9,37
15080,17,3,11,0,3,14
15081,42,23,9,0,10,32
15082,32,21,9,0,2,30
15083,524,326,86,3,109,415
15084,370,182,102,14,72,298
15085,56,6,15,23,12,44
15086,77,40,28,1,8,69
15087,60,23,26,0,11,49
15088,37,7,19,0,11,26
15089,81,28,35,0,18,63
15090,63,23,24,4,12,51
15091,590,332,146,21,91,499
15092,354,153,126,6,69,285
15093,26,13,11,1,1,25
15094,8,2,4,1,1,7
15095,16,9,2,2,3,13
15096,48,15,23,0,10,38
15097,46,18,20,0,8,38
15098,171,119,15,0,37,134
15099,4,2,2,0,0,4
15100,101,65,9,2,25,76
15101,60,29,22,2,7,53
15102,404,229,92,0,83,321
15103,51,7,28,4,12,39
15104,58,42,10,5,1,57
15105,104,57,26,0,21,83
15106,173,136,15,1,21,152
15107,155,89,37,1,28,127
15108,275,90,126,14,45,230
15109,35,7,19,0,9,26
15110,85,40,22,1,22,63
15111,52,41,1,0,10,42
15112,15,5,4,0,6,9
15113,207,101,65,0,41,166
15114,559,371,71,4,113,446
15115,40,17,9,6,8,32
15116,155,67,56,1,31,124
15117,36,4,24,0,8,28
15118,39,18,5,7,9,30
15119,478,226,151,11,90,388
15120,42,29,0,0,13,29
15121,38,12,20,1,5,33
15122,20,7,8,0,5,15
15123,34,9,20,0,5,29
15124,0,0,0,0,0,0
15125,47,20,19,0,8,39
15126,46,31,8,1,6,40
15127,35,21,9,0,5,30
15128,14,7,7,0,0,14
15129,206,105,34,33,34,172
15130,15,5,4,0,6,9
15131,35,21,4,4,6,29
15132,45,33,8,4,0,45
15133,68,26,21,5,16,52
15134,38,27,0,1,10,28
15135,100,33,41,1,25,75
15136,39,16,18,0,5,34
15137,210,125,35,3,47,163
15138,99,35,39,10,15,84
15139,61,24,20,3,14,47
15140,523,270,110,37,106,417
15141,128,82,33,0,13,115
15142,81,40,26,0,15,66
15143,33,12,9,7,5,28
15144,56,16,25,0,15,41
15145,21,0,19,0,2,19
15146,9,4,4,0,1,8
15147,224,129,26,25,44,180
15148,73,29,7,21,16,57
15149,4,0,1,0,3,1
15150,53,22,16,5,10,43
15151,663,395,130,23,115,548
15152,35,12,13,0,10,25
15153,21,15,4,0,2,19
15154,67,16,24,18,9,58
15155,95,67,11,0,17,78
15156,46,25,3,10,8,38
15157,27,19,4,1,3,24
15158,36,14,11,4,7,29
15159,19,7,9,0,3,16
15160,183,24,93,27,39,144
15161,1067,391,427,46,203,864
15162,18,5,8,0,5,13
15163,173,69,40,21,43,130
15164,121,67,34,1,19,102
15165,44,22,14,0,8,36
15166,67,42,8,2,15,52
15167,76,10,51,0,15,61
15168,73,26,27,8,12,61
15169,240,176,14,0,50,190
15170,46,18,20,0,8,38
15171,37,13,15,2,7,30
15172,20,5,0,8,7,13
15173,45,22,16,0,7,38
15174,80,21,40,2,17,63
15175,495,261,84,45,105,390
15176,37,14,14,0,9,28
15177,273,131,82,0,60,213
15178,64,41,12,1,10,54
15179,36,17,16,0,3,33
15180,31,15,4,0,12,19
15181,85,34,35,1,15,70
15182,34,25,4,5,0,34
15183,178,100,33,0,45,133
15184,234,20,168,2,44,190
15185,36,16,14,0,6,30
15186,139,102,9,0,28,111
15187,40,11,22,1,6,34
15188,194,77,33,34,50,144
15189,40,3,29,2,6,34
15190,58,37,6,4,11,47
15191,46,28,5,7,6,40
15192,125,60,43,1,21,104
15193,151,37,78,1,35,116
15194,179,129,35,2,13,166
15195,31,9,10,4,8,23
15196,38,18,9,1,10,28
15197,34,6,20,0,8,26
15198,46,31,6,1,8,38
15199,43,21,11,1,10,33
15200,213,105,56,0,52,161
15201,143,10,82,19,32,111
15202,27,11,11,0,5,22
15203,197,76,36,34,51,146
15204,15,2,9,0,4,11
15205,103,29,55,0,19,84
15206,179,66,55,26,32,147
15207,109,58,25,4,22,87
15208,12,5,2,1,4,8
15209,55,33,16,1,5,50
15210,37,21,3,0,13,24
15211,14,3,6,1,4,10
15212,20,1,8,8,3,17
15213,54,22,20,0,12,42
15214,59,32,18,2,7,52
15215,73,43,14,3,13,60
15216,99,31,37,10,21,78
15217,46,11,24,0,11,35
15218,0,0,0,0,0,0
15219,32,21,9,0,2,30
15220,15,11,2,0,2,13
15221,37,21,6,2,8,29
15222,36,5,23,0,8,28
15223,39,1,26,5,7,32
15224,141,47,45,22,27,114
15225,45,20,13,1,11,34
15226,152,112,17,0,23,129
15227,30,9,12,0,9,21
15228,116,68,18,3,27,89
15229,7,1,5,0,1,6
15230,78,58,7,0,13,65
15231,10,1,8,0,1,9
15232,34,12,13,0,9,25
15233,65,24,14,14,13,52
15234,46,26,12,0,8,38
15235,401,130,163,17,91,310
15236,12,2,9,0,1,11
15237,33,0,26,1,6,27
15238,8,2,4,1,1,7
15239,45,7,21,9,8,37
15240,44,15,22,0,7,37
15241,42,19,12,2,9,33
15242,81,39,28,4,10,71
15243,56,12,36,0,8,48
15244,436,200,146,9,81,355
15245,118,64,14,13,27,91
15246,77,31,20,12,14,63
15247,62,34,14,3,11,51
15248,147,47,76,3,21,126
15249,50,32,10,0,8,42
15250,65,2,43,14,6,59
15251,674,403,131,23,117,557
15252,80,50,10,0,20,60
15253,143,67,48,4,24,119
15254,32,12,6,7,7,25
15255,18,5,12,0,1,17
15256,244,102,14,83,45,199
15257,71,26,17,14,14,57
15258,21,9,11,0,1,20
15259,75,37,19,2,17,58
15260,20,8,7,0,5,15
15261,49,30,5,7,7,42
15262,244,102,15,82,45,199
15263,18,14,0,0,4,14
15264,66,32,23,3,8,58
15265,35,3,12,13,7,28
15266,106,43,38,2,23,83
15267,37,20,9,0,8,29
15268,32,21,9,0,2,30
15269,34,16,13,0,5,29
15270,10,2,5,0,3,7
15271,67,35,14,4,14,53
15272,59,45,2,2,10,49
15273,155,113,8,5,29,126
15274,55,13,37,0,5,50
15275,281,175,43,0,63,218
15276,152,109,12,2,29,123
15277,17,4,9,0,4,13
15278,56,9,37,0,10,46
15279,40,17,16,0,7,33
15280,45,15,20,2,8,37
15281,15,8,2,2,3,12
15282,542,388,44,1,109,433
15283,15,3,10,0,2,13
15284,60,34,10,5,11,49
15285,656,383,142,17,114,542
15286,26,8,12,0,6,20
15287,87,45,5,24,13,74
15288,35,13,16,0,6,29
15289,131,48,53,13,17,114
15290,34,0,28,0,6,28
15291,75,43,16,2,14,61
15292,67,44,10,1,12,55
15293,88,45,23,0,20,68
15294,100,67,8,6,19,81
15295,46,18,20,0,8,38
15296,40,7,23,0,10,30
15297,85,59,5,0,21,64
15298,243,100,15,83,45,198
15299,279,94,126,14,45,234
15300,31,16,9,0,6,25
15301,533,298,116,17,102,431
15302,162,67,43,23,29,133
15303,48,16,10,16,6,42
15304,58,29,17,0,12,46
15305,418,137,168,21,92,326
15306,98,57,20,0,21,77
15307,60,9,30,5,16,44
15308,143,14,95,1,33,110
15309,46,18,20,0,8,38
15310,14,6,2,0,6,8
15311,1,1,0,0,0,1
15312,88,7,60,5,16,72
15313,22,5,11,1,5,17
15314,32,8,19,0,5,27
15315,81,39,14,7,21,60
15316,22,11,6,0,5,17
15317,88,63,13,0,12,76
15318,58,45,6,3,4,54
15319,10,4,4,0,2,8
15320,98,48,32,0,18,80
15321,107,48,27,6,26,81
15322,46,18,20,0,8,38
15323,179,126,34,2,17,162
15324,92,36,18,14,24,68
15325,194,61,80,14,39,155
15326,142,56,31,22,33,109
15327,58,25,18,4,11,47
15328,31,14,12,0,5,26
15329,76,36,25,0,15,61
15330,66,6,45,0,15,51
15331,140,57,52,3,28,112
15332,115,47,28,16,24,91
15333,66,26,14,14,12,54
15334,210,128,37,6,39,171
15335,468,339,33,1,95,373
15336,46,18,20,0,8,38
15337,102,75,13,3,11,91
15338,10,6,2,0,2,8
15339,169,23,104,3,39,130
15340,0,0,0,0,0,0
15341,211,113,48,0,50,161
15342,40,0,35,1,4,36
15343,46,18,20,0,8,38
15344,31,12,7,0,12,19
15345,188,53,48,50,37,151
15346,10,5,5,0,0,10
15347,46,18,20,0,8,38
15348,44,19,15,2,8,36
15349,39,23,7,0,9,30
15350,247,189,18,2,38,209
15351,44,36,1,0,7,37
15352,183,117,25,8,33,150
15353,52,7,34,0,11,41
15354,85,36,23,0,26,59
15355,53,24,19,0,10,43
15356,20,5,12,0,3,17
15357,106,71,6,0,29,77
15358,304,127,110,10,57,247
15359,29,4,16,2,7,22
15360,21,2,15,0,4,17
15361,147,61,56,6,24,123
15362,153,109,18,0,26,127
15363,68,45,5,3,15,53
15364,69,46,9,0,14,55
15365,46,18,20,0,8,38
15366,27,12,7,0,8,19
15367,17,9,2,1,5,12
15368,4,1,1,0,2,2
15369,344,186,88,15,55,289
15370,167,120,21,0,26,141
15371,404,193,114,13,84,320
15372,105,51,35,0,19,86
15373,130,47,25,23,35,95
15374,55,25,12,6,12,43
15375,36,16,6,4,10,26
15376,136,92,19,1,24,112
15377,87,54,17,4,12,75
15378,81,34,21,12,14,67
15379,11,6,3,0,2,9
15380,122,54,18,18,32,90
15381,66,25,19,8,14,52
15382,148,81,14,25,28,120
15383,40,8,24,0,8,32
15384,339,94,160,6,79,260
15385,49,17,17,2,13,36
15386,54,43,1,0,10,44
15387,88,39,30,12,7,81
15388,85,40,26,2,17,68
15389,33,2,28,0,3,30
15390,157,91,25,11,30,127
15391,23,1,13,1,8,15
15392,41,15,13,5,8,33
15393,30,10,15,0,5,25
15394,81,36,26,0,19,62
15395,11,5,3,2,1,10
15396,63,43,5,2,13,50
15397,272,181,65,5,21,251
15398,476,196,125,49,106,370
15399,47,18,19,0,10,37
15400,12,1,6,1,4,8
15401,347,182,92,14,59,288
15402,70,46,7,0,17,53
15403,320,159,96,5,60,260
15404,27,8,11,1,7,20
15405,34,24,2,0,8,26
15406,58,22,22,1,13,45
15407,30,12,14,0,4,26
15408,77,45,13,3,16,61
15409,58,34,15,0,9,49
15410,50,13,25,3,9,41
15411,38,17,16,0,5,33
15412,29,2,21,1,5,24
15413,48,15,16,1,16,32
15414,32,21,9,0,2,30
15415,147,62,30,21,34,113
15416,243,101,15,82,45,198
15417,97,26,21,29,21,76
15418,90,64,6,0,20,70
15419,169,72,54,3,40,129
15420,2,1,0,0,1,1
15421,58,18,24,8,8,50
15422,23,3,16,0,4,19
15423,89,28,19,22,20,69
15424,44,12,19,3,10,34
15425,34,8,20,0,6,28
15426,94,23,51,0,20,74
15427,397,115,146,46,90,307
15428,220,149,30,0,41,179
15429,108,53,29,6,20,88
15430,83,26,33,10,14,69
15431,83,68,1,0,14,69
15432,519,361,49,1,108,411
15433,30,5,17,0,8,22
15434,28,9,17,0,2,26
15435,78,36,25,3,14,64
15436,13,5,8,0,0,13
15437,109,104,0,5,0,109
15438,139,64,37,0,38,101
15439,41,12,10,7,12,29
15440,377,194,106,16,61,316
15441,45,13,24,0,8,37
15442,201,107,61,0,33,168
15443,26,14,9,2,1,25
15444,119,52,26,20,21,98
15445,46,20,9,8,9,37
15446,134,96,7,4,27,107
15447,52,12,20,11,9,43
15448,117,57,28,7,25,92
15449,64,48,12,0,4,60
15450,337,189,74,17,57,280
15451,92,74,0,4,14,78
15452,456,137,189,30,100,356
15453,57,15,27,0,15,42
15454,32,21,9,0,2,30
15455,71,36,24,0,11,60
15456,369,267,19,2,81,288
15457,52,37,5,1,9,43
15458,43,18,15,3,7,36
15459,26,11,10,0,5,21
15460,31,19,5,2,5,26
15461,27,12,6,0,9,18
15462,87,71,3,2,11,76
15463,40,11,18,0,11,29
15464,175,97,33,0,45,130
15465,74,26,31,0,17,57
15466,32,25,3,0,4,28
15467,68,38,18,1,11,57
15468,136,80,28,0,28,108
15469,10,5,1,0,4,6
15470,9,8,0,0,1,8
15471,191,87,57,14,33,158
15472,10,2,6,0,2,8
15473,21,13,1,3,4,17
15474,205,136,22,0,47,158
15475,166,98,38,1,29,137
15476,31,21,2,0,8,23
15477,18,13,4,0,1,17
15478,129,44,49,11,25,104
15479,48,0,38,2,8,40
15480,34,10,11,3,10,24
15481,42,9,19,2,12,30
15482,26,2,21,0,3,23
15483,69,36,12,6,15,54
15484,21,9,6,2,4,17
15485,438,115,179,44,100,338
15486,77,54,12,1,10,67
15487,107,46,14,26,21,86
15488,53,22,16,5,10,43
15489,81,40,25,0,16,65
15490,447,222,121,12,92,355
15491,38,19,11,1,7,31
15492,247,187,18,2,40,207
15493,52,11,32,0,9,43
15494,25,10,8,5,2,23
15495,19,9,5,1,4,15
15496,49,29,7,3,10,39
15497,147,62,32,18,35,112
15498,194,129,21,0,44,150
15499,97,79,3,0,15,82
15500,336,143,117,6,70,266
15501,63,34,14,3,12,51
15502,87,54,17,4,12,75
15503,67,16,38,7,6,61
15504,161,48,87,4,22,139
15505,86,18,43,8,17,69
15506,34,12,12,3,7,27
15507,109,41,39,6,23,86
15508,31,8,15,1,7,24
15509,18,11,5,0,2,16
15510,13,3,6,0,4,9
15511,116,57,27,8,24,92
15512,539,251,130,39,119,420
15513,5,1,1,0,3,2
15514,95,29,39,9,18,77
15515,31,14,8,3,6,25
15516,59,37,9,0,13,46
15517,48,12,30,1,5,43
15518,30,10,12,0,8,22
15519,90,38,22,19,11,79
15520,235,110,73,3,49,186
15521,37,12,17,0,8,29
15522,19,14,1,0,4,15
15523,4,1,3,0,0,4
15524,13,8,1,3,1,12
15525,25,21,1,3,0,25
15526,15,5,5,1,4,11
15527,28,12,7,2,7,21
15528,303,122,117,7,57,246
15529,71,43,12,2,14,57
15530,21,1,4,12,4,17
15531,161,108,27,0,26,135
15532,129,58,45,4,22,107
15533,82,20,47,0,15,67
15534,44,9,20,0,15,29
15535,81,13,46,4,18,63
15536,34,20,7,0,7,27
15537,95,25,54,2,14,81
15538,1,0,1,0,0,1
15539,47,18,22,1,6,41
15540,334,130,115,22,67,267
15541,141,64,44,7,26,115
15542,29,7,11,3,8,21
15543,276,92,125,14,45,231
15544,40,12,9,14,5,35
15545,10,7,2,0,1,9
15546,38,12,15,0,11,27
15547,21,7,12,1,1,20
15548,52,30,13,0,9,43
15549,7,0,7,0,0,7
15550,81,32,32,1,16,65
15551,118,41,48,0,29,89
15552,1,0,1,0,0,1
15553,51,18,23,2,8,43
15554,15,4,8,0,3,12
15555,142,87,30,0,25,117
15556,72,35,26,0,11,61
15557,46,18,20,0,8,38
15558,98,40,22,17,19,79
15559,37,19,8,1,9,28
15560,32,21,9,0,2,30
15561,36,13,14,1,8,28
15562,21,2,14,0,5,16
15563,30,13,0,10,7,23
15564,18,2,7,0,9,9
15565,158,51,46,33,28,130
15566,27,9,9,6,3,24
15567,7,1,5,1,0,7
15568,19,5,8,2,4,15
15569,51,34,5,3,9,42
15570,13,3,6,2,2,11
15571,40,28,4,0,8,32
15572,243,100,15,83,45,198
15573,103,32,50,0,21,82
15574,87,44,25,2,16,71
15575,346,261,19,2,64,282
15576,21,10,6,0,5,16
15577,56,35,7,0,14,42
15578,45,25,8,4,8,37
15579,198,98,50,0,50,148
15580,100,58,23,5,14,86
15581,108,22,46,17,23,85
15582,39,8,25,4,2,37
15583,124,96,4,0,24,100
15584,361,163,123,6,69,292
15585,162,114,11,0,37,125
15586,74,57,2,0,15,59
15587,68,45,11,0,12,56
15588,11,8,0,0,3,8
15589,52,29,10,0,13,39
15590,59,47,2,0,10,49
15591,43,10,24,0,9,34
15592,52,8,33,1,10,42
15593,111,21,54,15,21,90
15594,16,7,3,0,6,10
15595,73,30,24,3,16,57
15596,156,101,24,4,27,129
15597,50,33,10,1,6,44
15598,20,2,10,0,8,12
15599,79,39,20,2,18,61
15600,17,2,13,0,2,15
15601,130,64,22,16,28,102
15602,354,206,74,0,74,280
15603,54,22,20,1,11,43
15604,47,29,10,0,8,39
15605,24,10,10,1,3,21
15606,65,20,28,4,13,52
15607,116,73,9,10,24,92
15608,2,0,2,0,0,2
15609,109,50,40,1,18,91
15610,77,61,2,1,13,64
15611,33,8,17,4,4,29
15612,50,23,8,6,13,37
15613,96,25,55,2,14,82
15614,50,30,6,2,12,38
15615,6,2,1,1,2,4
15616,36,6,19,4,7,29
15617,190,63,89,0,38,152
15618,264,54,158,4,48,216
15619,138,103,6,0,29,109
15620,50,14,24,0,12,38
15621,161,108,27,0,26,135
15622,15,11,0,0,4,11
15623,6,1,3,0,2,4
15624,87,37,8,25,17,70
15625,110,38,43,11,18,92
15626,56,3,40,1,12,44
15627,79,27,25,10,17,62
15628,58,16,29,0,13,45
15629,104,56,29,1,18,86
15630,32,21,9,0,2,30
15631,22,8,10,0,4,18
15632,188,144,8,0,36,152
15633,211,116,45,13,37,174
15634,68,29,24,4,11,57
15635,446,311,41,1,93,353
15636,32,21,9,0,2,30
15637,45,21,15,2,7,38
15638,75,23,27,10,15,60
15639,506,274,112,12,108,398
15640,73,57,1,0,15,58
15641,38,18,15,0,5,33
15642,19,17,0,0,2,17
15643,13,10,1,2,0,13
15644,197,141,15,2,39,158
15645,142,84,22,8,28,114
15646,564,330,115,17,102,462
15647,27,3,20,1,3,24
15648,47,14,16,8,9,38
15649,42,7,24,2,9,33
15650,57,33,12,0,12,45
15651,465,136,189,35,105,360
15652,32,21,9,0,2,30
15653,85,52,19,0,14,71
15654,72,37,14,8,13,59
15655,38,8,20,0,10,28
15656,59,43,5,4,7,52
15657,10,3,4,0,3,7
15658,74,31,10,18,15,59
15659,34,8,4,16,6,28
15660,46,26,7,1,12,34
15661,59,34,16,1,8,51
15662,91,69,8,1,13,78
15663,82,30,28,2,22,60
15664,35,20,9,0,6,29
15665,16,1,10,1,4,12
15666,46,18,20,0,8,38
15667,7,1,3,2,1,6
15668,32,20,8,0,4,28
15669,79,51,5,10,13,66
15670,59,28,9,8,14,45
15671,150,54,37,28,31,119
15672,92,61,7,4,20,72
15673,42,11,20,1,10,32
15674,166,77,32,28,29,137
15675,109,103,0,6,0,109
15676,275,90,126,14,45,230
15677,17,11,3,1,2,15
15678,80,34,3,30,13,67
15679,56,1,49,0,6,50
15680,32,14,8,2,8,24
15681,164,122,4,1,37,127
15682,80,38,28,0,14,66
15683,52,26,15,1,10,42
15684,11,6,3,0,2,9
15685,28,10,11,0,7,21
15686,141,82,12,18,29,112
15687,122,44,42,12,24,98
15688,51,35,2,1,13,38
15689,60,45,1,0,14,46
15690,137,70,17,21,29,108
15691,27,10,11,0,6,21
15692,22,1,13,4,4,18
15693,262,135,92,0,35,227
15694,127,56,23,20,28,99
15695,13,3,7,1,2,11
15696,41,19,13,3,6,35
15697,76,33,28,1,14,62
15698,30,15,5,2,8,22
15699,128,49,37,12,30,98
15700,688,387,164,23,114,574
15701,94,46,25,3,20,74
15702,25,12,9,0,4,21
15703,209,116,43,13,37,172
15704,95,27,45,5,18,77
15705,53,33,8,0,12,41
15706,134,73,28,5,28,106
15707,43,15,18,2,8,35
15708,198,121,11,23,43,155
15709,21,1,16,0,4,17
15710,99,74,4,2,19,80
15711,1071,394,434,46,197,874
15712,39,16,16,0,7,32
15713,32,21,9,0,2,30
15714,25,14,7,0,4,21
15715,67,35,19,0,13,54
15716,57,41,7,2,7,50
15717,33,18,6,0,9,24
15718,37,22,6,1,8,29
15719,27,15,9,0,3,24
15720,24,10,7,1,6,18
15721,20,7,7,2,4,16
15722,77,10,44,4,19,58
15723,18,10,7,0,1,17
15724,32,12,6,7,7,25
15725,53,20,17,8,8,45
15726,54,43,1,0,10,44
15727,61,36,8,6,11,50
15728,64,34,13,9,8,56
15729,27,8,15,0,4,23
15730,45,11,15,11,8,37
15731,7,3,1,2,1,6
15732,59,28,18,0,13,46
15733,15,5,8,0,2,13
15734,47,11,27,1,8,39
15735,38,3,27,1,7,31
15736,42,21,17,0,4,38
15737,25,4,17,0,4,21
15738,68,35,18,1,14,54
15739,188,102,23,25,38,150
15740,46,18,20,0,8,38
15741,5,3,1,0,1,4
15742,40,21,10,0,9,31
15743,6,5,0,1,0,6
15744,327,140,112,6,69,258
15745,43,25,11,0,7,36
15746,30,10,16,0,4,26
15747,142,97,21,0,24,118
15748,58,2,39,4,13,45
15749,45,19,16,0,10,35
15750,88,44,25,2,17,71
15751,37,10,19,1,7,30
15752,10,3,5,0,2,8
15753,22,16,3,0,3,19
15754,28,8,12,0,8,20
15755,427,203,137,12,75,352
15756,134,39,62,3,30,104
15757,16,0,11,0,5,11
15758,1270,509,175,336,250,1020
15759,20,9,5,0,6,14
15760,430,115,174,44,97,333
15761,39,26,1,1,11,28
15762,32,21,9,0,2,30
15763,54,14,26,2,12,42
15764,70,11,25,17,17,53
15765,59,43,5,4,7,52
15766,58,36,6,5,11,47
15767,22,0,20,0,2,20
15768,86,35,29,6,16,70
15769,39,13,16,0,10,29
15770,79,43,16,4,16,63
15771,22,12,8,0,2,20
15772,38,25,1,0,12,26
15773,142,63,50,3,26,116
15774,36,21,7,1,7,29
15775,148,108,6,0,34,114
15776,55,32,15,2,6,49
15777,58,35,10,0,13,45
15778,121,98,4,2,17,104
15779,39,11,20,0,8,31
15780,19,6,5,1,7,12
15781,21,11,6,1,3,18
15782,81,1,62,0,18,63
15783,60,43,4,0,13,47
15784,99,47,31,5,16,83
15785,76,51,14,1,10,66
15786,42,14,14,3,11,31
15787,88,56,11,2,19,69
15788,83,27,29,8,19,64
15789,34,16,10,1,7,27
15790,285,161,34,32,58,227
15791,64,40,11,3,10,54
15792,90,36,27,11,16,74
15793,61,30,13,5,13,48
15794,40,18,15,1,6,34
15795,64,43,9,1,11,53
15796,85,25,34,6,20,65
15797,42,18,18,0,6,36
15798,29,2,21,1,5,24
15799,111,45,44,0,22,89
15800,85,43,27,0,15,70
15801,135,55,39,15,26,109
15802,235,135,45,10,45,190
15803,61,19,17,16,9,52
15804,16,9,4,0,3,13
15805,72,18,41,0,13,59
15806,167,86,20,28,33,134
15807,389,123,138,46,82,307
15808,153,66,47,9,31,122
15809,33,19,6,1,7,26
15810,119,39,31,20,29,90
15811,27,5,14,0,8,19
15812,37,29,3,1,4,33
15813,3,3,0,0,0,3
15814,5,3,2,0,0,5
15815,160,59,69,0,32,128
15816,99,26,57,2,14,85
15817,174,8,134,0,32,142
15818,57,15,29,0,13,44
15819,37,10,19,1,7,30
15820,21,7,10,0,4,17
15821,68,27,26,4,11,57
15822,257,174,61,4,18,239
15823,66,47,8,0,11,55
15824,6,3,2,0,1,5
15825,480,226,153,11,90,390
15826,76,25,24,14,13,63
15827,505,344,48,1,112,393
15828,112,68,16,4,24,88
15829,47,10,5,23,9,38
15830,93,35,43,1,14,79
15831,111,37,44,11,19,92
15832,80,38,30,1,11,69
15833,46,18,20,0,8,38
15834,195,75,36,34,50,145
15835,41,14,15,6,6,35
15836,37,24,7,0,6,31
15837,60,27,23,0,10,50
15838,13,8,2,0,3,10
15839,71,47,10,2,12,59
15840,44,27,7,0,10,34
15841,221,89,83,14,35,186
15842,132,61,37,0,34,98
15843,636,385,103,9,139,497
15844,16,4,9,2,1,15
15845,101,37,37,5,22,79
15846,59,23,15,6,15,44
15847,61,33,12,0,16,45
15848,32,12,15,1,4,28
15849,43,27,8,0,8,35
15850,60,30,11,2,17,43
15851,62,44,7,4,7,55
15852,92,47,28,3,14,78
15853,49,32,6,2,9,40
15854,97,65,9,5,18,79
15855,24,10,6,0,8,16
15856,8,3,3,0,2,6
15857,124,46,31,19,28,96
15858,129,29,60,17,23,106
15859,35,15,14,0,6,29
15860,39,12,7,11,9,30
15861,67,45,2,2,18,49
15862,31,13,12,0,6,25
15863,111,67,33,0,11,100
15864,124,5,64,27,28,96
15865,12,10,1,0,1,11
15866,12,2,6,0,4,8
15867,61,32,19,1,9,52
15868,35,2,22,5,6,29
15869,84,59,4,0,21,63
15870,63,39,14,10,0,63
15871,70,40,5,8,17,53
15872,53,11,29,3,10,43
15873,10,3,5,1,1,9
15874,94,56,19,5,14,80
15875,49,21,17,2,9,40
15876,38,4,29,0,5,33
15877,333,140,118,6,69,264
15878,146,82,26,10,28,118
15879,32,21,9,0,2,30
15880,110,30,41,10,29,81
15881,42,20,10,3,9,33
15882,20,15,0,0,5,15
15883,9,2,4,0,3,6
15884,28,9,13,3,3,25
15885,42,20,6,7,9,33
15886,35,18,12,0,5,30
15887,75,20,22,14,19,56
15888,37,19,8,1,9,28
15889,22,16,2,1,3,19
15890,262,20,191,2,49,213
15891,12,3,1,1,7,5
15892,21,2,15,0,4,17
15893,95,24,55,2,14,81
15894,39,3,29,2,5,34
15895,25,16,5,1,3,22
15896,226,128,28,25,45,181
15897,42,17,17,0,8,34
15898,19,8,9,0,2,17
15899,18,11,3,0,4,14
15900,119,53,50,3,13,106
15901,63,28,15,2,18,45
15902,44,21,11,1,11,33
15903,16,1,10,1,4,12
15904,55,22,5,18,10,45
15905,80,13,49,5,13,67
15906,86,46,6,17,17,69
15907,141,25,89,1,26,115
15908,32,21,9,0,2,30
15909,32,13,8,6,5,27
15910,59,19,27,4,9,50
15911,17,15,0,0,2,15
15912,97,53,22,4,18,79
15913,658,385,142,17,114,544
15914,10,5,5,0,0,10
15915,62,19,13,19,11,51
15916,564,324,118,18,104,460
15917,10,4,3,0,3,7
15918,32,21,9,0,2,30
15919,86,30,31,4,21,65
15920,60,26,19,3,12,48
15921,27,8,14,2,3,24
15922,231,154,35,0,42,189
15923,160,10,91,27,32,128
15924,32,21,9,0,2,30
15925,2,1,1,0,0,2
15926,5,1,4,0,0,5
15927,233,79,89,15,50,183
15928,11,8,3,0,0,11
15929,150,60,36,19,35,115
15930,172,92,26,23,31,141
15931,28,6,17,0,5,23
15932,21,10,8,0,3,18
15933,128,37,66,0,25,103
15934,45,11,20,0,14,31
15935,23,14,3,0,6,17
15936,37,16,9,2,10,27
15937,204,117,44,8,35,169
15938,107,50,25,6,26,81
15939,95,35,41,0,19,76
15940,5,3,1,0,1,4
15941,53,5,37,0,11,42
15942,58,5,41,1,11,47
15943,41,22,14,0,5,36
15944,56,37,12,0,7,49
15945,401,183,119,11,88,313
15946,39,23,8,0,8,31
15947,36,22,6,2,6,30
15948,13,1,11,0,1,12
15949,101,66,1,12,22,79
15950,94,23,12,33,26,68
15951,22,5,11,1,5,17
15952,166,74,54,7,31,135
15953,126,69,11,20,26,100
15954,50,34,2,1,13,37
15955,33,13,14,0,6,27
15956,136,80,23,2,31,105
15957,22,15,1,6,0,22
15958,10,1,7,0,2,8
15959,24,11,11,0,2,22
15960,46,25,3,10,8,38
15961,128,51,34,16,27,101
15962,31,11,14,0,6,25
15963,77,37,25,0,15,62
15964,84,40,25,4,15,69
15965,41,35,1,0,5,36
15966,101,77,9,0,15,86
15967,51,24,11,4,12,39
15968,70,27,23,5,15,55
15969,28,13,10,0,5,23
15970,45,24,13,1,7,38
15971,75,51,9,0,15,60
15972,42,21,9,1,11,31
15973,32,21,9,0,2,30
15974,278,94,126,14,44,234
15975,19,1,15,0,3,16
15976,129,27,46,30,26,103
15977,138,59,49,3,27,111
15978,25,6,14,1,4,21
15979,159,81,38,0,40,119
15980,472,218,157,12,85,387
15981,7,2,3,0,2,5
15982,41,30,2,0,9,32
15983,55,32,15,2,6,49
15984,120,35,48,10,27,93
15985,38,10,16,5,7,31
15986,191,102,57,0,32,159
15987,28,6,11,2,9,19
15988,57,12,30,0,15,42
15989,311,189,55,0,67,244
15990,78,4,55,1,18,60
15991,139,48,32,23,36,103
15992,170,68,36,26,40,130
15993,107,53,34,0,20,87
15994,19,3,15,0,1,18
15995,73,33,24,2,14,59
15996,29,14,8,4,3,26
15997,43,23,11,0,9,34
15998,77,24,26,9,18,59
15999,74,34,23,0,17,57
16000,64,23,28,1,12,52
16001,100,66,17,0,17,83
16002,52,26,15,2,9,43
16003,99,46,12,21,20,79
16004,30,8,14,0,8,22
16005,63,28,24,0,11,52
16006,69,25,25,7,12,57
16007,78,49,18,0,11,67
16008,110,31,51,0,28,82
16009,13,5,3,0,5,8
16010,35,14,17,0,4,31
16011,64,13,24,3,24,40
16012,7,4,1,1,1,6
16013,231,109,75,2,45,186
16014,18,8,4,1,5,13
16015,46,15,24,0,7,39
16016,55,24,13,6,12,43
16017,42,26,7,4,5,37
16018,71,42,16,0,13,58
16019,160,114,11,0,35,125
16020,279,95,126,14,44,235
16021,129,41,50,13,25,104
16022,17,9,4,1,3,14
16023,87,21,49,8,9,78
16024,62,44,7,4,7,55
16025,32,2,22,0,8,24
16026,54,37,6,1,10,44
16027,44,14,19,0,11,33
16028,32,8,17,0,7,25
16029,16,2,11,0,3,13
16030,19,12,4,0,3,16
16031,4,3,0,0,1,3
16032,19,6,8,3,2,17
16033,43,15,16,6,6,37
16034,102,57,8,18,19,83
16035,90,43,30,1,16,74
16036,24,5,16,0,3,21
16037,284,18,209,2,55,229
16038,2,1,1,0,0,2
16039,103,48,15,13,27,76
16040,97,65,11,0,21,76
16041,64,27,14,13,10,54
16042,38,5,28,1,4,34
16043,204,123,45,0,36,168
16044,178,99,25,21,33,145
16045,171,120,15,2,34,137
16046,44,35,2,0,7,37
16047,219,148,30,0,41,178
16048,24,15,4,0,5,19
16049,20,1,12,1,6,14
16050,82,34,23,7,18,64
16051,13,2,9,0,2,11
16052,8,3,2,1,2,6
16053,59,41,9,0,9,50
16054,51,24,3,14,10,41
16055,32,15,13,0,4,28
16056,64,14,23,12,15,49
16057,107,52,29,6,20,87
16058,115,66,17,8,24,91
16059,261,137,87,0,37,224
16060,76,10,42,5,19,57
16061,47,24,12,0,11,36
16062,33,10,15,0,8,25
16063,85,22,41,2,20,65
16064,46,18,20,0,8,38
16065,86,38,28,5,15,71
16066,41,4,28,0,9,32
16067,49,18,16,2,13,36
16068,32,21,9,0,2,30
16069,64,41,5,0,18,46
16070,58,32,17,0,9,49
16071,35,13,16,0,6,29
16072,104,55,16,12,21,83
16073,57,27,21,0,9,48
16074,62,39,14,0,9,53
16075,26,13,11,1,1,25
16076,29,11,11,0,7,22
16077,46,18,20,0,8,38
16078,122,74,28,0,20,102
16079,8,3,3,0,2,6
16080,73,23,28,9,13,60
16081,20,8,3,3,6,14
16082,17,5,11,0,1,16
16083,95,50,16,12,17,78
16084,32,21,9,0,2,30
16085,155,71,49,5,30,125
16086,137,62,43,5,27,110
16087,59,43,5,4,7,52
16088,5,0,3,0,2,3
16089,122,64,34,0,24,98
16090,11,3,1,3,4,7
16091,352,184,110,0,58,294
16092,24,13,4,0,7,17
16093,13,8,3,0,2,11
16094,66,9,49,0,8,58
16095,32,21,9,0,2,30
16096,43,10,22,0,11,32
16097,46,24,17,0,5,41
16098,90,69,1,0,20,70
16099,25,16,3,1,5,20
16100,135,50,39,17,29,106
16101,11,3,5,0,3,8
16102,52,23,21,0,8,44
16103,81,38,25,0,18,63
16104,46,18,20,0,8,38
16105,313,160,103,0,50,263
16106,9,2,3,0,4,5
16107,12,5,4,0,3,9
16108,352,187,90,15,60,292
16109,7,7,0,0,0,7
16110,10,1,7,0,2,8
16111,38,15,11,3,9,29
16112,283,101,122,16,44,239
16113,396,291,20,0,85,311
16114,50,20,20,0,10,40
16115,132,102,7,2,21,111
16116,11,5,3,1,2,9
16117,76,38,24,0,14,62
16118,58,18,23,3,14,44
16119,123,67,33,12,11,112
16120,105,83,7,2,13,92
16121,32,21,9,0,2,30
16122,141,97,17,2,25,116
16123,12,6,2,1,3,9
16124,29,10,10,2,7,22
16125,101,70,12,3,16,85
16126,55,35,9,0,11,44
16127,125,69,35,1,20,105
16128,78,35,5,16,22,56
16129,136,43,63,4,26,110
16130,58,33,17,0,8,50
16131,81,27,32,9,13,68
16132,58,40,7,1,10,48
16133,31,11,13,0,7,24
16134,100,64,13,0,23,77
16135,370,280,20,0,70,300
16136,9,1,4,1,3,6
16137,65,53,1,0,11,54
16138,228,163,13,0,52,176
16139,229,90,14,81,44,185
16140,80,37,5,15,23,57
16141,242,55,25,122,40,202
16142,130,41,48,17,24,106
16143,52,37,8,1,6,46
16144,42,28,6,1,7,35
16145,26,13,5,2,6,20
16146,403,183,132,7,81,322
16147,32,21,9,0,2,30
16148,368,220,70,13,65,303
16149,63,11,34,5,13,50
16150,83,35,24,3,21,62
16151,68,30,25,4,9,59
16152,110,48,30,12,20,90
16153,35,17,9,3,6,29
16154,120,91,1,1,27,93
16155,79,23,39,3,14,65
16156,69,26,23,2,18,51
16157,39,6,23,1,9,30
16158,131,90,17,2,22,109
16159,68,46,7,0,15,53
16160,57,32,16,0,9,48
16161,262,135,92,0,35,227
16162,191,146,14,1,30,161
16163,35,13,16,0,6,29
16164,502,234,111,52,105,397
16165,31,13,10,1,7,24
16166,170,72,52,6,40,130
16167,117,50,41,0,26,91
16168,41,12,7,12,10,31
16169,141,50,35,20,36,105
16170,25,16,5,0,4,21
16171,234,155,33,0,46,188
16172,29,17,7,0,5,24
16173,105,46,39,1,19,86
16174,150,24,97,1,28,122
16175,19,5,12,1,1,18
16176,57,14,33,0,10,47
16177,24,5,11,1,7,17
16178,40,8,17,0,15,25
16179,84,56,8,0,20,64
16180,95,55,16,7,17,78
16181,67,36,9,2,20,47
16182,65,15,23,3,24,41
16183,29,9,13,0,7,22
16184,46,18,20,0,8,38
16185,167,46,13,80,28,139
16186,25,14,5,2,4,21
16187,157,81,38,0,38,119
16188,95,49,24,4,18,77
16189,35,13,16,0,6,29
16190,10,7,1,0,2,8
16191,16,12,3,0,1,15
16192,27,9,15,1,2,25
16193,156,80,44,1,31,125
16194,71,48,11,12,0,71
16195,351,253,18,2,78,273
16196,74,28,27,5,14,60
16197,33,11,14,0,8,25
16198,81,47,17,0,17,64
16199,133,99,6,0,28,105
16200,33,17,10,0,6,27
16201,193,66,61,26,40,153
16202,74,34,20,3,17,57
16203,358,182,110,5,61,297
16204,59,47,2,0,10,49
16205,32,15,13,0,4,28
16206,35,25,8,2,0,35
16207,95,39,38,1,17,78
16208,208,93,59,13,43,165
16209,50,22,15,3,10,40
16210,46,18,20,0,8,38
16211,46,18,20,0,8,38
16212,92,33,21,11,27,65
16213,17,9,3,0,5,12
16214,456,336,23,0,97,359
16215,40,1,34,0,5,35
16216,144,80,13,24,27,117
16217,68,32,18,0,18,50
16218,8,2,4,0,2,6
16219,7,4,0,2,1,6
16220,37,19,11,0,7,30
16221,52,2,36,11,3,49
16222,154,49,78,4,23,131
16223,197,143,11,2,41,156
16224,25,17,1,0,7,18
16225,64,20,27,4,13,51
16226,67,9,50,0,8,59
16227,26,11,12,1,2,24
16228,17,3,14,0,0,17
16229,72,46,9,0,17,55
16230,126,100,6,0,20,106
16231,26,5,16,0,5,21
16232,117,55,32,6,24,93
16233,18,2,15,0,1,17
16234,29,3,20,0,6,23
16235,69,48,14,4,3,66
16236,151,63,58,6,24,127
16237,192,110,26,21,35,157
16238,29,7,11,3,8,21
16239,444,224,114,12,94,350
16240,71,53,6,1,11,60
16241,20,8,5,1,6,14
16242,92,26,31,14,21,71
16243,8,3,3,0,2,6
16244,53,31,3,10,9,44
16245,20,5,10,1,4,16
16246,6,2,2,0,2,4
16247,447,326,29,0,92,355
16248,94,43,31,4,16,78
16249,70,26,16,6,22,48
16250,41,14,21,0,6,35
16251,119,49,39,10,21,98
16252,106,66,20,2,18,88
16253,8,3,4,0,1,7
16254,29,11,3,4,11,18
16255,55,21,21,4,9,46
16256,20,11,5,1,3,17
16257,71,40,12,2,17,54
16258,29,14,8,0,7,22
16259,17,4,6,2,5,12
16260,672,391,144,17,120,552
16261,199,106,49,0,44,155
16262,10,6,3,1,0,10
16263,68,24,28,3,13,55
16264,45,22,7,3,13,32
16265,77,47,17,1,12,65
16266,202,33,87,32,50,152
16267,184,120,28,5,31,153
16268,31,15,2,5,9,22
16269,27,1,16,2,8,19
16270,67,29,21,6,11,56
16271,99,58,21,0,20,79
16272,127,71,22,3,31,96
16273,382,218,85,0,79,303
16274,28,7,11,5,5,23
16275,95,39,35,1,20,75
16276,10,6,2,0,2,8
16277,59,31,10,3,15,44
16278,12,8,1,0,3,9
16279,92,22,46,7,17,75
16280,114,35,55,1,23,91
16281,99,31,43,4,21,78
16282,14,4,8,0,2,12
16283,48,26,12,1,9,39
16284,247,103,97,2,45,202
16285,92,40,32,4,16,76
16286,46,18,20,0,8,38
16287,108,76,10,1,21,87
16288,161,48,84,0,29,132
16289,443,188,110,46,99,344
16290,35,2,25,0,8,27
16291,122,65,29,6,22,100
16292,145,58,53,3,31,114
16293,105,36,38,5,26,79
16294,111,39,42,11,19,92
16295,24,18,2,0,4,20
16296,38,12,21,1,4,34
16297,7,1,3,2,1,6
16298,18,8,6,0,4,14
16299,32,21,9,0,2,30
16300,90,27,45,2,16,74
16301,15,4,6,1,4,11
16302,47,8,29,0,10,37
16303,161,116,9,5,31,130
16304,278,141,83,0,54,224
16305,8,4,2,1,1,7
16306,20,5,8,2,5,15
16307,177,122,15,0,40,137
16308,3,0,3,0,0,3
16309,32,10,16,0,6,26
16310,23,4,14,0,5,18
16311,60,33,9,1,17,43
16312,342,146,120,6,70,272
16313,24,9,12,1,2,22
16314,149,91,30,0,28,121
16315,71,38,18,0,15,56
16316,47,29,10,0,8,39
16317,25,8,13,0,4,21
16318,373,281,16,0,76,297
16319,124,83,19,0,22,102
16320,210,107,33,33,37,173
16321,46,18,20,0,8,38
16322,58,27,24,1,6,52
16323,88,61,5,9,13,75
16324,202,76,40,38,48,154
16325,16,3,11,0,2,14
16326,144,35,77,1,31,113
16327,242,163,33,2,44,198
16328,28,11,6,2,9,19
16329,77,13,41,6,17,60
16330,667,390,142,18,117,550
16331,55,32,16,0,7,48
16332,228,94,45,29,60,168
16333,352,192,89,15,56,296
16334,46,18,20,0,8,38
16335,41,13,17,1,10,31
16336,82,48,16,2,16,66
16337,218,60,109,1,48,170
16338,42,5,28,0,9,33
16339,66,43,13,0,10,56
16340,28,6,7,5,10,18
16341,55,32,15,2,6,49
16342,62,32,18,1,11,51
16343,30,10,7,6,7,23
16344,17,2,12,0,3,14
16345,167,128,2,2,35,132
16346,48,39,1,0,8,40
16347,59,41,7,0,11,48
16348,58,29,14,3,12,46
16349,83,45,15,0,23,60
16350,49,11,29,0,9,40
16351,655,386,136,18,115,540
16352,193,61,80,13,39,154
16353,23,5,13,0,5,18
16354,32,12,17,1,2,30
16355,78,42,23,0,13,65
16356,139,88,13,10,28,111
16357,81,30,6,25,20,61
16358,42,9,21,3,9,33
16359,33,10,16,3,4,29
16360,149,51,39,32,27,122
16361,46,31,1,2,12,34
16362,36,3,24,0,9,27
16363,5,3,2,0,0,5
16364,38,22,5,3,8,30
16365,21,18,0,0,3,18
16366,13,1,8,0,4,9
16367,77,51,9,0,17,60
16368,164,98,34,5,27,137
16369,142,65,44,11,22,120
16370,137,82,29,0,26,111
16371,54,10,28,5,11,43
16372,77,31,20,12,14,63
16373,87,53,18,4,12,75
16374,39,22,6,3,8,31
16375,70,32,28,0,10,60
16376,34,23,4,2,5,29
16377,57,25,10,13,9,48
16378,200,53,99,14,34,166
16379,109,35,53,1,20,89
16380,21,3,11,0,7,14
16381,31,21,4,1,5,26
16382,119,43,31,21,24,95
16383,69,40,3,14,12,57
16384,134,75,23,7,29,105
16385,52,20,19,2,11,41
16386,115,84,8,4,19,96
16387,21,8,7,1,5,16
16388,182,103,31,1,47,135
16389,32,21,9,0,2,30
16390,68,22,27,4,15,53
16391,10,3,4,0,3,7
16392,34,25,2,0,7,27
16393,567,405,47,1,114,453
16394,127,75,21,3,28,99
16395,124,83,19,0,22,102
16396,48,17,21,1,9,39
16397,70,34,24,1,11,59
16398,55,32,15,2,6,49
16399,32,22,0,0,10,22
16400,328,178,90,0,60,268
16401,50,29,13,0,8,42
16402,100,33,45,0,22,78
16403,245,101,53,36,55,190
16404,95,64,6,0,25,70
16405,18,4,8,0,6,12
16406,118,50,51,3,14,104
16407,14,4,5,0,5,9
16408,35,21,7,0,7,28
16409,433,211,106,31,85,348
16410,58,35,6,4,13,45
16411,327,155,94,15,63,264
16412,64,29,17,5,13,51
16413,19,6,5,1,7,12
16414,29,5,10,7,7,22
16415,35,4,21,4,6,29
16416,14,8,3,2,1,13
16417,68,43,11,3,11,57
16418,228,62,122,5,39,189
16419,166,110,25,1,30,136
16420,104,36,43,11,14,90
16421,22,8,7,0,7,15
16422,73,31,22,3,17,56
16423,67,44,13,0,10,57
16424,155,23,102,1,29,126
16425,192,74,45,31,42,150
16426,70,23,26,2,19,51
16427,192,74,35,33,50,142
16428,141,67,45,5,24,117
16429,153,53,37,31,32,121
16430,484,258,102,25,99,385
16431,439,212,145,6,76,363
16432,67,30,16,7,14,53
16433,71,35,24,1,11,60
16434,30,13,9,0,8,22
16435,12,7,4,0,1,11
16436,69,36,12,6,15,54
16437,76,58,2,0,16,60
16438,210,132,61,4,13,197
16439,32,21,9,0,2,30
16440,32,0,26,0,6,26
16441,410,183,99,39,89,321
16442,36,9,19,0,8,28
16443,53,27,17,0,9,44
16444,155,120,6,0,29,126
16445,68,30,11,7,20,48
16446,12,3,4,0,5,7
16447,84,20,25,26,13,71
16448,28,17,4,0,7,21
16449,49,16,18,0,15,34
16450,72,55,1,0,16,56
16451,139,75,38,2,24,115
16452,147,58,54,0,35,112
16453,60,28,15,0,17,43
16454,35,16,16,0,3,32
16455,21,1,4,12,4,17
16456,197,119,13,23,42,155
16457,86,49,21,4,12,74
16458,45,11,23,0,11,34
16459,75,36,16,0,23,52
16460,64,29,15,9,11,53
16461,216,150,17,2,47,169
16462,81,40,15,11,15,66
16463,0,0,0,0,0,0
16464,458,211,144,12,91,367
16465,200,102,49,0,49,151
16466,87,44,24,2,17,70
16467,106,68,11,4,23,83
16468,15,11,0,1,3,12
16469,40,11,20,0,9,31
16470,114,38,51,1,24,90
16471,136,91,21,1,23,113
16472,77,15,38,10,14,63
16473,67,38,19,0,10,57
16474,72,5,20,34,13,59
16475,43,7,28,4,4,39
16476,59,27,20,4,8,51
16477,26,6,16,0,4,22
16478,107,86,2,3,16,91
16479,52,36,4,3,9,43
16480,49,24,3,14,8,41
16481,32,21,9,0,2,30
16482,79,39,21,3,16,63
16483,244,17,184,0,43,201
16484,183,13,136,0,34,149
16485,60,31,9,0,20,40
16486,47,30,7,0,10,37
16487,328,169,76,13,70,258
16488,21,0,19,0,2,19
16489,59,33,15,2,9,50
16490,409,115,156,47,91,318
16491,80,19,43,7,11,69
16492,544,268,119,40,117,427
16493,41,17,11,1,12,29
16494,71,14,31,11,15,56
16495,55,22,4,19,10,45
16496,481,257,122,20,82,399
16497,32,16,7,3,6,26
16498,38,6,10,16,6,32
16499,1283,519,169,337,258,1025
16500,31,21,2,0,8,23
16501,64,27,21,2,14,50
16502,79,52,8,3,16,63
16503,48,15,25,0,8,40
16504,179,87,58,2,32,147
16505,464,230,90,50,94,370
16506,51,35,6,0,10,41
16507,45,29,5,0,11,34
16508,2,0,1,0,1,1
16509,39,9,23,1,6,33
16510,675,391,142,20,122,553
16511,191,55,100,2,34,157
16512,68,46,9,1,12,56
16513,50,35,0,0,15,35
16514,106,25,56,3,22,84
16515,7,3,2,0,2,5
16516,32,21,9,0,2,30
16517,438,143,178,19,98,340
16518,146,81,18,23,24,122
16519,89,30,25,12,22,67
16520,125,45,53,0,27,98
16521,47,17,15,0,15,32
16522,55,40,4,1,10,45
16523,66,29,20,2,15,51
16524,62,29,19,5,9,53
16525,29,14,9,0,6,23
16526,36,14,14,1,7,29
16527,101,51,24,5,21,80
16528,36,23,3,4,6,30
16529,94,21,40,11,22,72
16530,66,36,12,0,18,48
16531,213,60,21,100,32,181
16532,17,10,3,0,4,13
16533,44,7,27,3,7,37
16534,333,254,19,0,60,273
16535,25,14,6,2,3,22
16536,33,23,2,0,8,25
16537,235,135,45,8,47,188
16538,49,32,1,4,12,37
16539,82,55,7,1,19,63
16540,37,27,6,1,3,34
16541,17,0,15,0,2,15
16542,111,94,1,1,15,96
16543,60,41,10,0,9,51
16544,3,0,1,0,2,1
16545,133,102,5,6,20,113
16546,46,18,20,0,8,38
16547,26,9,15,0,2,24
16548,11,4,4,2,1,10
16549,53,26,2,15,10,43
16550,105,47,14,21,23,82
16551,32,16,10,0,6,26
16552,27,4,20,0,3,24
16553,30,20,2,0,8,22
16554,223,124,41,12,46,177
16555,137,61,52,6,18,119
16556,38,17,4,4,13,25
16557,34,0,27,2,5,29
16558,27,2,7,14,4,23
16559,10,6,2,0,2,8
16560,115,48,27,15,25,90
16561,103,37,26,21,19,84
16562,50,15,8,21,6,44
16563,4,1,1,0,2,2
16564,380,286,20,0,74,306
16565,13,11,1,0,1,12
16566,27,12,5,4,6,21
16567,16,6,8,0,2,14
16568,43,7,24,2,10,33
16569,49,16,21,1,11,38
16570,77,34,30,0,13,64
16571,428,105,183,46,94,334
16572,67,20,20,9,18,49
16573,18,6,10,1,1,17
16574,67,35,3,17,12,55
16575,267,113,97,9,48,219
16576,11,6,4,1,0,11
16577,427,198,144,9,76,351
16578,33,13,11,0,9,24
16579,128,53,47,4,24,104
16580,42,10,27,0,5,37
16581,45,29,1,3,12,33
16582,34,15,12,1,6,28
16583,438,208,109,32,89,349
16584,32,21,9,0,2,30
16585,41,3,32,1,5,36
16586,33,24,5,0,4,29
16587,46,18,20,0,8,38
16588,12,2,4,0,6,6
16589,64,33,9,9,13,51
16590,19,14,3,0,2,17
16591,409,124,171,29,85,324
16592,22,12,2,0,8,14
16593,161,4,132,0,25,136
16594,14,6,3,2,3,11
16595,129,88,9,5,27,102
16596,46,18,20,0,8,38
16597,69,18,27,9,15,54
16598,6,4,0,0,2,4
16599,224,150,33,0,41,183
16600,103,75,7,0,21,82
16601,41,6,24,4,7,34
16602,114,73,28,0,13,101
16603,176,46,57,38,35,141
16604,149,109,6,0,34,115
16605,123,76,34,0,13,110
16606,26,16,7,0,3,23
16607,159,100,3,18,38,121
16608,84,43,17,6,18,66
16609,64,18,34,0,12,52
16610,122,38,43,11,30,92
16611,244,101,15,83,45,199
16612,132,65,28,15,24,108
16613,185,124,20,0,41,144
16614,275,140,53,30,52,223
16615,79,15,39,6,19,60
16616,195,52,107,2,34,161
16617,200,13,148,0,39,161
16618,34,17,12,0,5,29
16619,199,88,53,20,38,161
16620,284,160,32,33,59,225
16621,10,0,9,0,1,9
16622,24,4,17,0,3,21
16623,63,36,16,1,10,53
16624,61,29,16,4,12,49
16625,87,23,40,8,16,71
16626,468,330,40,1,97,371
16627,75,23,31,3,18,57
16628,27,12,11,0,4,23
16629,39,5,27,1,6,33
16630,67,36,12,0,19,48
16631,444,137,191,16,100,344
16632,90,27,37,6,20,70
16633,66,39,6,9,12,54
16634,17,4,9,0,4,13
16635,93,61,13,0,19,74
16636,3,1,2,0,0,3
16637,71,20,39,1,11,60
16638,89,31,5,39,14,75
16639,627,350,155,23,99,528
16640,28,14,4,5,5,23
16641,444,331,20,0,93,351
16642,46,18,20,0,8,38
16643,242,61,37,103,41,201
16644,21,13,5,1,2,19
16645,22,16,0,0,6,16
16646,69,18,33,1,17,52
16647,42,33,2,0,7,35
16648,161,65,54,16,26,135
16649,41,21,15,0,5,36
16650,457,223,126,13,95,362
16651,32,21,9,0,2,30
16652,197,126,14,16,41,156
16653,470,218,156,12,84,386
16654,46,18,20,0,8,38
16655,42,32,5,0,5,37
16656,105,29,57,0,19,86
16657,46,9,29,0,8,38
16658,82,43,17,3,19,63
16659,178,85,33,26,34,144
16660,42,5,28,0,9,33
16661,6,4,0,1,1,5
16662,57,22,24,0,11,46
16663,9,5,4,0,0,9
16664,14,10,2,0,2,12
16665,13,11,1,0,1,12
16666,96,16,53,7,20,76
16667,32,21,9,0,2,30
16668,59,7,35,7,10,49
16669,226,75,85,15,51,175
16670,21,13,2,1,5,16
16671,6,1,2,0,3,3
16672,9,5,2,0,2,7
16673,75,47,18,0,10,65
16674,32,24,7,1,0,32
16675,197,62,81,14,40,157
16676,121,40,54,6,21,100
16677,146,62,30,20,34,112
16678,53,35,6,0,12,41
16679,22,12,4,0,6,16
16680,40,29,6,5,0,40
16681,23,8,10,0,5,18
16682,55,25,17,1,12,43
16683,234,153,31,4,46,188
16684,337,187,76,7,67,270
16685,62,27,17,4,14,48
16686,227,77,88,14,48,179
16687,123,69,27,3,24,99
16688,84,47,24,1,12,72
16689,10,3,3,0,4,6
16690,133,85,30,3,15,118
16691,31,3,20,3,5,26
16692,80,56,8,3,13,67
16693,463,339,26,1,97,366
16694,62,23,20,1,18,44
16695,77,57,7,0,13,64
16696,55,20,23,2,10,45
16697,38,18,10,3,7,31
16698,92,28,42,7,15,77
16699,39,6,24,0,9,30
16700,29,2,22,1,4,25
16701,21,6,9,0,6,15
16702,212,113,48,0,51,161
16703,46,18,20,0,8,38
16704,122,65,38,9,10,112
16705,75,34,20,0,21,54
16706,5,5,0,0,0,5
16707,42,25,10,0,7,35
16708,178,112,45,13,8,170
16709,55,15,20,10,10,45
16710,65,32,20,3,10,55
16711,263,102,106,7,48,215
16712,160,52,53,23,32,128
16713,75,49,5,9,12,63
16714,60,31,15,0,14,46
16715,667,389,149,18,111,556
16716,30,6,18,1,5,25
16717,86,55,16,0,15,71
16718,53,17,17,3,16,37
16719,346,186,90,15,55,291
16720,22,14,3,4,1,21
16721,68,15,39,1,13,55
16722,176,47,53,40,36,140
16723,49,18,19,0,12,37
16724,62,18,32,1,11,51
16725,42,13,22,0,7,35
16726,55,37,11,0,7,48
16727,236,92,25,76,43,193
16728,148,85,17,22,24,124
16729,71,32,17,6,16,55
16730,22,0,16,0,6,16
16731,74,46,19,0,9,65
16732,36,17,13,0,6,30
16733,122,93,3,1,25,97
16734,105,32,52,1,20,85
16735,47,14,24,1,8,39
16736,82,52,12,4,14,68
16737,28,6,12,1,9,19
16738,32,21,9,0,2,30
16739,49,32,6,2,9,40
16740,87,34,25,9,19,68
16741,12,2,6,0,4,8
16742,70,48,9,3,10,60
16743,160,51,83,4,22,138
16744,55,24,19,2,10,45
16745,92,10,50,8,24,68
16746,5,4,0,1,0,5
16747,3,1,1,0,1,2
16748,53,37,4,1,11,42
16749,45,19,10,5,11,34
16750,87,44,22,4,17,70
16751,101,29,39,13,20,81
16752,23,2,15,1,5,18
16753,218,128,63,7,20,198
16754,28,24,0,1,3,25
16755,144,102,18,1,23,121
16756,105,50,36,0,19,86
16757,55,30,14,2,9,46
16758,18,1,10,5,2,16
16759,97,66,5,0,26,71
16760,60,42,8,0,10,50
16761,8,2,3,0,3,5
16762,11,6,4,0,1,10
16763,484,263,79,42,100,384
16764,20,13,4,0,3,17
16765,57,19,31,0,7,50
16766,151,60,50,16,25,126
16767,25,14,7,0,4,21
16768,44,35,2,0,7,37
16769,23,0,20,0,3,20
16770,130,52,39,9,30,100
16771,66,20,20,12,14,52
16772,56,3,40,1,12,44
16773,86,25,47,7,7,79
16774,35,22,3,4,6,29
16775,459,338,21,0,100,359
16776,42,21,5,7,9,33
16777,120,37,45,13,25,95
16778,45,23,11,1,10,35
16779,200,132,21,0,47,153
16780,28,15,6,0,7,21
16781,99,51,28,0,20,79
16782,27,10,12,0,5,22
16783,76,52,10,0,14,62
16784,85,64,1,0,20,65
16785,51,25,10,7,9,42
16786,20,18,0,0,2,18
16787,70,19,29,8,14,56
16788,42,4,28,0,10,32
16789,41,20,2,12,7,34
16790,148,83,17,20,28,120
16791,71,7,46,5,13,58
16792,15,7,2,4,2,13
16793,56,12,23,8,13,43
16794,11,2,4,1,4,7
16795,233,155,32,0,46,187
16796,61,21,32,0,8,53
16797,66,30,15,12,9,57
16798,57,15,26,0,16,41
16799,22,11,4,0,7,15
16800,305,134,104,4,63,242
16801,75,23,35,4,13,62
16802,25,5,1,15,4,21
16803,39,16,13,1,9,30
16804,71,41,9,9,12,59
16805,113,48,39,0,26,87
16806,52,29,11,0,12,40
16807,12,5,3,0,4,8
16808,47,34,3,0,10,37
16809,39,9,14,10,6,33
16810,17,3,11,0,3,14
16811,199,52,38,75,34,165
16812,33,22,3,1,7,26
16813,15,12,0,0,3,12
16814,64,19,32,1,12,52
16815,46,18,20,0,8,38
16816,470,178,147,44,101,369
16817,14,6,2,3,3,11
16818,131,67,24,16,24,107
16819,13,2,11,0,0,13
16820,50,8,31,3,8,42
16821,38,24,5,4,5,33
16822,21,1,17,0,3,18
16823,32,21,9,0,2,30
16824,26,9,10,1,6,20
16825,60,30,11,2,17,43
16826,75,40,18,0,17,58
16827,83,41,25,0,17,66
16828,4,4,0,0,0,4
16829,27,20,1,0,6,21
16830,53,36,3,1,13,40
16831,90,68,3,0,19,71
16832,95,42,27,1,25,70
16833,617,364,129,16,108,509
16834,90,43,30,1,16,74
16835,67,37,16,0,14,53
16836,443,328,20,0,95,348
16837,309,231,12,2,64,245
16838,47,17,13,6,11,36
16839,31,16,8,0,7,24
16840,137,72,34,0,31,106
16841,111,39,40,6,26,85
16842,80,35,19,17,9,71
16843,112,66,18,8,20,92
16844,127,51,50,12,14,113
16845,223,149,33,0,41,182
16846,91,65,6,0,20,71
16847,100,66,8,5,21,79
16848,98,41,24,22,11,87
16849,32,16,6,5,5,27
16850,40,17,12,1,10,30
16851,50,13,28,0,9,41
16852,503,346,48,1,108,395
16853,3,2,0,0,1,2
16854,122,65,31,3,23,99
16855,1078,387,440,46,205,873
16856,42,27,8,3,4,38
16857,14,10,2,0,2,12
16858,31,4,24,0,3,28
16859,81,26,42,0,13,68
16860,139,100,9,0,30,109
16861,50,23,3,14,10,40
16862,32,21,9,0,2,30
16863,29,10,15,0,4,25
16864,33,1,25,1,6,27
16865,8,2,3,0,3,5
16866,92,66,6,0,20,72
16867,406,303,20,0,83,323
16868,37,14,11,2,10,27
16869,158,81,51,0,26,132
16870,62,13,43,0,6,56
16871,107,51,32,0,24,83
16872,29,7,16,0,6,23
16873,16,2,9,1,4,12
16874,141,108,13,0,20,121
16875,209,89,61,20,39,170
16876,121,93,9,1,18,103
16877,74,37,21,3,13,61
16878,110,83,2,0,25,85
16879,27,9,13,1,4,23
16880,232,78,89,15,50,182
16881,106,57,29,0,20,86
16882,37,8,17,4,8,29
16883,79,35,19,12,13,66
16884,124,47,46,0,31,93
16885,339,203,57,12,67,272
16886,44,19,15,0,10,34
16887,60,14,40,0,6,54
16888,61,5,16,28,12,49
16889,25,3,16,2,4,21
16890,40,25,3,2,10,30
16891,82,34,19,12,17,65
16892,120,50,10,30,30,90
16893,71,7,46,5,13,58
16894,141,82,22,3,34,107
16895,37,25,3,3,6,31
16896,23,2,16,0,5,18
16897,135,54,40,15,26,109
16898,82,20,45,10,7,75
16899,3,1,2,0,0,3
16900,85,38,25,0,22,63
16901,48,20,13,1,14,34
16902,63,11,22,18,12,51
16903,166,115,25,0,26,140
16904,56,12,28,10,6,50
16905,1062,390,425,46,201,861
16906,64,41,5,0,18,46
16907,43,5,29,0,9,34
16908,114,49,35,18,12,102
16909,278,85,132,17,44,234
16910,54,5,34,1,14,40
16911,56,13,32,0,11,45
16912,442,138,190,14,100,342
16913,362,208,74,19,61,301
16914,76,40,12,9,15,61
16915,46,18,20,0,8,38
16916,33,14,5,3,11,22
16917,106,57,29,0,20,86
16918,169,51,92,4,22,147
16919,33,6,19,0,8,25
16920,85,34,14,18,19,66
16921,60,21,31,0,8,52
16922,92,63,7,2,20,72
16923,47,2,36,0,9,38
16924,30,7,16,0,7,23
16925,88,44,25,2,17,71
16926,46,18,20,0,8,38
16927,103,67,1,13,22,81
16928,32,21,9,0,2,30
16929,13,4,8,0,1,12
16930,203,91,57,12,43,160
16931,24,5,13,2,4,20
16932,70,47,13,0,10,60
16933,20,8,12,0,0,20
16934,78,25,32,9,12,66
16935,27,10,12,0,5,22
16936,122,67,34,11,10,112
16937,49,15,23,1,10,39
16938,38,7,23,1,7,31
16939,588,409,51,1,127,461
16940,169,71,54,3,41,128
16941,12,2,7,0,3,9
16942,29,6,17,2,4,25
16943,26,8,6,6,6,20
16944,85,21,37,9,18,67
16945,28,15,8,0,5,23
16946,1,0,1,0,0,1
16947,628,364,145,16,103,525
16948,63,11,37,0,15,48
16949,26,1,19,1,5,21
16950,29,15,4,0,10,19
16951,61,15,31,6,9,52
16952,8,0,5,1,2,6
16953,44,20,17,1,6,38
16954,13,6,4,0,3,10
16955,29,10,12,1,6,23
16956,174,85,53,3,33,141
16957,73,40,19,3,11,62
16958,415,115,162,46,92,323
16959,30,8,7,5,10,20
16960,36,16,8,5,7,29
16961,551,395,37,1,118,433
16962,46,18,20,0,8,38
16963,11,8,1,0,2,9
16964,40,9,24,1,6,34
16965,90,35,36,2,17,73
16966,98,34,39,11,14,84
16967,451,247,102,14,88,363
16968,21,15,4,0,2,19
16969,31,19,3,0,9,22
16970,60,6,16,25,13,47
16971,116,52,26,19,19,97
16972,13,9,2,2,0,13
16973,250,160,37,9,44,206
16974,44,37,1,0,6,38
16975,44,21,13,0,10,34
16976,47,33,2,0,12,35
16977,15,3,10,0,2,13
16978,240,129,68,0,43,197
16979,22,4,14,0,4,18
16980,94,24,51,0,19,75
16981,43,3,32,0,8,35
16982,47,24,19,0,4,43
16983,20,1,13,3,3,17
16984,19,14,0,1,4,15
16985,44,16,11,6,11,33
16986,49,23,14,0,12,37
16987,127,92,6,3,26,101
16988,32,21,9,0,2,30
16989,150,24,97,1,28,122
16990,162,115,11,0,36,126
16991,65,34,13,1,17,48
16992,65,36,12,2,15,50
16993,32,21,9,0,2,30
16994,26,18,4,0,4,22
16995,50,5,37,0,8,42
16996,26,19,3,1,3,23
16997,137,77,23,3,34,103
16998,77,39,18,8,12,65
16999,107,33,37,13,24,83
17000,62,48,5,0,9,53
17001,46,18,20,0,8,38
17002,1,0,1,0,0,1
17003,5,3,1,0,1,4
17004,100,45,34,4,17,83
17005,295,123,110,10,52,243
17006,12,1,9,0,2,10
17007,33,22,8,1,2,31
17008,84,50,18,4,12,72
17009,368,157,130,11,70,298
17010,32,21,9,0,2,30
17011,86,52,15,0,19,67
17012,111,49,32,0,30,81
17013,43,26,5,6,6,37
17014,118,33,61,0,24,94
17015,85,40,19,8,18,67
17016,57,33,8,6,10,47
17017,51,34,3,1,13,38
17018,19,6,11,0,2,17
17019,58,10,33,4,11,47
17020,22,15,5,1,1,21
17021,77,44,3,15,15,62
17022,38,13,20,1,4,34
17023,70,35,23,1,11,59
17024,104,44,28,6,26,78
17025,97,51,28,1,17,80
17026,53,20,19,1,13,40
17027,106,25,57,3,21,85
17028,218,75,80,15,48,170
17029,133,41,64,7,21,112
17030,70,25,20,5,20,50
17031,58,24,29,0,5,53
17032,41,19,17,0,5,36
17033,190,52,51,50,37,153
17034,33,8,18,3,4,29
17035,17,12,2,0,3,14
17036,48,34,8,0,6,42
17037,201,95,70,1,35,166
17038,78,14,49,0,15,63
17039,169,82,52,3,32,137
17040,19,11,4,0,4,15
17041,77,54,2,0,21,56
17042,51,21,18,0,12,39
17043,227,153,56,2,16,211
17044,510,227,121,46,116,394
17045,9,3,4,1,1,8
17046,50,29,7,0,14,36
17047,57,34,12,2,9,48
17048,46,18,20,0,8,38
17049,116,42,48,12,14,102
17050,104,41,37,9,17,87
17051,100,80,3,0,17,83
17052,132,50,36,11,35,97
17053,38,15,14,0,9,29
17054,92,56,16,5,15,77
17055,6,3,2,0,1,5
17056,109,66,16,3,24,85
17057,21,9,6,2,4,17
17058,155,51,50,21,33,122
17059,54,29,8,7,10,44
17060,13,12,0,0,1,12
17061,99,50,21,4,24,75
17062,82,15,44,4,19,63
17063,68,51,6,0,11,57
17064,106,39,39,5,23,83
17065,16,1,8,1,6,10
17066,425,311,28,0,86,339
17067,1063,393,427,46,197,866
17068,73,30,23,7,13,60
17069,89,41,34,0,14,75
17070,80,55,6,0,19,61
17071,14,0,8,0,6,8
17072,157,76,49,1,31,126
17073,29,2,21,1,5,24
17074,41,14,14,5,8,33
17075,105,40,30,9,26,79
17076,60,17,25,3,15,45
17077,88,27,30,11,20,68
17078,83,23,39,12,9,74
17079,7,2,2,2,1,6
17080,52,27,16,0,9,43
17081,108,35,43,11,19,89
17082,24,13,6,1,4,20
17083,55,12,25,9,9,46
17084,41,14,18,0,9,32
17085,224,132,18,26,48,176
17086,112,19,52,18,23,89
17087,287,157,67,0,63,224
17088,20,11,6,1,2,18
17089,107,38,25,25,19,88
17090,8,1,5,0,2,6
17091,476,219,158,11,88,388
17092,35,13,10,3,9,26
17093,28,7,6,6,9,19
17094,498,266,85,43,104,394
17095,79,50,20,6,3,76
17096,67,17,36,1,13,54
17097,10,3,6,0,1,9
17098,67,10,42,0,15,52
17099,102,27,48,8,19,83
17100,42,22,10,0,10,32
17101,114,32,59,0,23,91
17102,10,1,6,0,3,7
17103,26,7,16,0,3,23
17104,15,8,4,0,3,12
17105,59,28,20,0,11,48
17106,34,7,17,2,8,26
17107,117,56,41,1,19,98
17108,63,39,7,6,11,52
17109,61,27,25,0,9,52
17110,187,123,25,5,34,153
17111,76,30,17,7,22,54
17112,79,22,41,2,14,65
17113,73,41,7,6,19,54
17114,14,6,7,0,1,13
17115,87,36,26,0,25,62
17116,70,4,53,1,12,58
17117,17,2,13,0,2,15
17118,73,4,51,0,18,55
17119,73,36,18,0,19,54
17120,12,2,5,0,5,7
17121,96,34,37,10,15,81
17122,138,90,22,1,25,113
17123,24,8,13,0,3,21
17124,64,33,11,0,20,44
17125,8,1,6,0,1,7
17126,112,48,46,3,15,97
17127,100,42,32,10,16,84
17128,76,5,53,1,17,59
17129,143,47,48,19,29,114
17130,230,156,32,0,42,188
17131,52,23,13,3,13,39
17132,106,82,3,0,21,85
17133,46,18,20,0,8,38
17134,44,21,10,1,12,32
17135,68,25,6,22,15,53
17136,62,41,11,1,9,53
17137,56,41,5,1,9,47
17138,46,18,20,0,8,38
17139,88,43,5,27,13,75
17140,182,98,31,23,30,152
17141,325,243,18,1,63,262
17142,54,9,38,1,6,48
17143,109,20,54,15,20,89
17144,12,1,9,0,2,10
17145,35,7,16,1,11,24
17146,41,17,15,0,9,32
17147,213,112,59,0,42,171
17148,21,3,12,0,6,15
17149,28,8,16,0,4,24
17150,46,30,9,3,4,42
17151,93,38,34,1,20,73
17152,87,44,30,0,13,74
17153,238,72,112,2,52,186
17154,90,58,9,2,21,69
17155,19,6,10,0,3,16
17156,163,113,24,0,26,137
17157,37,12,10,5,10,27
17158,37,14,11,3,9,28
17159,128,53,33,18,24,104
17160,682,378,166,24,114,568
17161,163,110,27,0,26,137
17162,14,1,6,4,3,11
17163,389,225,85,0,79,310
17164,52,13,25,1,13,39
17165,366,196,76,17,77,289
17166,63,41,14,5,3,60
17167,53,31,3,11,8,45
17168,195,120,35,5,35,160
17169,48,20,19,0,9,39
17170,54,18,10,16,10,44
17171,134,52,34,15,33,101
17172,74,5,52,1,16,58
17173,40,20,13,0,7,33
17174,561,317,108,13,123,438
17175,46,9,29,0,8,38
17176,39,20,10,1,8,31
17177,156,55,51,24,26,130
17178,339,141,126,6,66,273
17179,49,16,15,3,15,34
17180,53,16,28,0,9,44
17181,34,25,4,0,5,29
17182,93,48,17,11,17,76
17183,67,27,7,17,16,51
17184,293,215,19,2,57,236
17185,140,84,30,0,26,114
17186,54,7,30,4,13,41
17187,34,8,19,2,5,29
17188,46,28,9,0,9,37
17189,179,55,90,0,34,145
17190,12,1,9,0,2,10
17191,27,1,22,1,3,24
17192,33,5,7,10,11,22
17193,111,37,44,11,19,92
17194,194,88,48,20,38,156
17195,321,192,58,0,71,250
17196,47,9,29,0,9,38
17197,128,65,12,23,28,100
17198,140,46,71,3,20,120
17199,69,17,34,4,14,55
17200,29,11,2,13,3,26
17201,38,19,13,0,6,32
17202,30,3,21,0,6,24
17203,49,13,24,3,9,40
17204,69,67,0,2,0,69
17205,13,6,5,0,2,11
17206,40,25,5,1,9,31
17207,37,4,25,0,8,29
17208,36,0,29,0,7,29
17209,411,185,98,39,89,322
17210,32,21,9,0,2,30
17211,36,23,6,0,7,29
17212,44,10,5,21,8,36
17213,28,12,10,0,6,22
17214,20,13,2,1,4,16
17215,40,10,19,5,6,34
17216,130,93,18,0,19,111
17217,117,50,31,14,22,95
17218,271,163,50,0,58,213
17219,56,29,10,4,13,43
17220,31,3,22,0,6,25
17221,32,4,22,0,6,26
17222,59,35,10,4,10,49
17223,55,18,21,2,14,41
17224,78,29,26,8,15,63
17225,165,72,53,3,37,128
17226,48,24,18,1,5,43
17227,60,34,16,0,10,50
17228,9,6,3,0,0,9
17229,449,142,184,21,102,347
17230,48,16,14,1,17,31
17231,109,59,33,1,16,93
17232,71,54,6,0,11,60
17233,263,116,84,18,45,218
17234,56,37,3,5,11,45
17235,163,83,40,0,40,123
17236,14,5,7,0,2,12
17237,46,18,20,0,8,38
17238,407,232,93,0,82,325
17239,60,27,24,2,7,53
17240,56,11,26,4,15,41
17241,56,37,12,0,7,49
17242,46,18,20,0,8,38
17243,38,4,29,1,4,34
17244,125,51,38,21,15,110
17245,57,28,9,6,14,43
17246,115,26,54,2,33,82
17247,47,25,8,3,11,36
17248,78,12,54,0,12,66
17249,199,96,60,0,43,156
17250,179,39,21,88,31,148
17251,29,22,1,0,6,23
17252,170,80,32,29,29,141
17253,97,54,18,10,15,82
17254,46,26,9,3,8,38
17255,101,55,26,3,17,84
17256,279,16,209,0,54,225
17257,62,37,9,3,13,49
17258,32,13,12,1,6,26
17259,22,8,10,0,4,18
17260,32,21,9,0,2,30
17261,52,25,18,0,9,43
17262,100,67,1,12,20,80
17263,27,10,6,7,4,23
17264,73,29,6,22,16,57
17265,10,4,1,2,3,7
17266,7,0,5,0,2,5
17267,46,18,20,0,8,38
17268,105,41,43,10,11,94
17269,396,227,88,0,81,315
17270,268,60,140,7,61,207
17271,150,117,5,0,28,122
17272,196,109,28,23,36,160
17273,7,2,3,0,2,5
17274,190,106,53,0,31,159
17275,79,17,44,1,17,62
17276,17,10,6,1,0,17
17277,58,14,34,1,9,49
17278,46,18,20,0,8,38
17279,431,229,109,19,74,357
17280,210,53,108,5,44,166
17281,35,23,5,0,7,28
17282,141,64,45,2,30,111
17283,670,391,150,16,113,557
17284,56,28,10,8,10,46
17285,13,9,3,0,1,12
17286,47,11,7,20,9,38
17287,199,109,28,23,39,160
17288,48,14,24,4,6,42
17289,43,11,15,6,11,32
17290,45,32,3,0,10,35
17291,80,61,1,0,18,62
17292,84,56,8,0,20,64
17293,32,21,9,0,2,30
17294,85,23,36,9,17,68
17295,43,5,32,0,6,37
17296,16,8,5,0,3,13
17297,61,38,10,0,13,48
17298,14,5,4,0,5,9
17299,78,28,37,3,10,68
17300,130,32,41,31,26,104
17301,136,76,23,3,34,102
17302,281,19,207,2,53,228
17303,32,21,9,0,2,30
17304,191,55,21,83,32,159
17305,73,31,26,7,9,64
17306,15,2,6,0,7,8
17307,37,7,10,15,5,32
17308,138,78,21,2,37,101
17309,80,28,33,1,18,62
17310,14,0,12,0,2,12
17311,39,23,8,0,8,31
17312,48,28,14,0,6,42
17313,237,155,36,0,46,191
17314,132,68,30,6,28,104
17315,40,7,24,2,7,33
17316,156,65,31,24,36,120
17317,29,19,6,1,3,26
17318,233,155,32,0,46,187
17319,37,12,10,6,9,28
17320,178,51,48,42,37,141
17321,152,103,27,0,22,130
17322,37,9,15,2,11,26
17323,471,237,89,45,100,371
17324,79,20,17,30,12,67
17325,84,32,28,4,20,64
17326,21,0,19,0,2,19
17327,32,9,18,0,5,27
17328,22,10,9,0,3,19
17329,86,32,32,4,18,68
17330,47,14,20,2,11,36
17331,11,6,2,1,2,9
17332,444,242,98,14,90,354
17333,9,0,8,0,1,8
17334,32,13,11,0,8,24
17335,50,2,38,2,8,42
17336,50,25,11,0,14,36
17337,138,74,33,0,31,107
17338,192,123,50,3,16,176
17339,10,2,3,0,5,5
17340,140,75,35,16,14,126
17341,75,44,12,3,16,59
17342,83,48,18,4,13,70
17343,200,81,25,58,36,164
17344,32,21,9,0,2,30
17345,16,8,4,0,4,12
17346,98,26,56,2,14,84
17347,153,65,47,8,33,120
17348,31,0,11,15,5,26
17349,672,393,142,18,119,553
17350,31,4,13,6,8,23
17351,43,8,22,0,13,30
17352,586,372,90,5,119,467
17353,32,21,9,0,2,30
17354,13,8,4,0,1,12
17355,36,26,4,0,6,30
17356,32,21,9,0,2,30
17357,71,35,12,7,17,54
17358,54,17,18,8,11,43
17359,150,51,37,30,32,118
17360,35,19,11,0,5,30
17361,69,36,17,3,13,56
17362,192,55,19,87,31,161
17363,44,16,25,0,3,41
17364,31,9,15,1,6,25
17365,11,6,0,0,5,6
17366,295,74,162,4,55,240
17367,216,157,13,2,44,172
17368,151,37,81,1,32,119
17369,1,1,0,0,0,1
17370,21,11,8,0,2,19
17371,346,158,84,35,69,277
17372,48,21,16,3,8,40
17373,242,72,116,2,52,190
17374,4,1,0,2,1,3
17375,82,29,29,4,20,62
17376,53,20,27,0,6,47
17377,21,7,7,0,7,14
17378,13,8,1,0,4,9
17379,51,20,19,1,11,40
17380,114,43,46,9,16,98
17381,357,100,165,8,84,273
17382,97,50,18,12,17,80
17383,34,9,19,0,6,28
17384,100,61,24,12,3,97
17385,51,17,21,4,9,42
17386,23,8,10,1,4,19
17387,65,39,13,0,13,52
17388,128,23,71,0,34,94
17389,292,63,173,1,55,237
17390,52,22,18,0,12,40
17391,139,53,58,5,23,116
17392,64,24,14,11,15,49
17393,210,107,66,0,37,173
17394,199,78,37,33,51,148
17395,41,14,14,5,8,33
17396,70,42,18,0,10,60
17397,93,40,28,0,25,68
17398,61,31,10,0,20,41
17399,81,36,19,12,14,67
17400,26,5,13,4,4,22
17401,14,10,1,1,2,12
17402,86,51,19,4,12,74
17403,98,53,29,1,15,83
17404,46,6,28,0,12,34
17405,244,186,11,2,45,199
17406,46,15,13,5,13,33
17407,31,21,2,0,8,23
17408,123,93,4,2,24,99
17409,54,31,14,0,9,45
17410,68,44,6,3,15,53
17411,25,12,7,0,6,19
17412,15,2,6,3,4,11
17413,21,7,6,1,7,14
17414,37,23,4,2,8,29
17415,41,17,15,0,9,32
17416,7,1,4,1,1,6
17417,58,13,5,27,13,45
17418,163,76,47,7,33,130
17419,32,21,9,0,2,30
17420,7,1,3,2,1,6
17421,19,2,15,0,2,17
17422,71,25,34,2,10,61
17423,214,163,8,0,43,171
17424,55,37,2,2,14,41
17425,51,31,11,0,9,42
17426,68,29,20,2,17,51
17427,146,36,76,1,33,113
17428,178,131,13,1,33,145
17429,29,12,14,0,3,26
17430,35,7,19,4,5,30
17431,49,18,20,1,10,39
17432,78,21,26,9,22,56
17433,175,69,71,15,20,155
17434,87,55,19,0,13,74
17435,86,42,25,2,17,69
17436,15,5,6,1,3,12
17437,30,23,2,0,5,25
17438,377,193,100,19,65,312
17439,86,21,47,3,15,71
17440,46,18,20,0,8,38
17441,52,25,22,0,5,47
17442,17,5,5,0,7,10
17443,53,32,12,0,9,44
17444,167,85,21,28,33,134
17445,73,25,33,1,14,59
17446,60,44,12,0,4,56
17447,58,17,27,2,12,46
17448,29,7,14,0,8,21
17449,270,141,84,0,45,225
17450,123,55,39,1,28,95
17451,150,45,73,0,32,118
17452,118,50,37,8,23,95
17453,17,5,6,0,6,11
17454,48,17,18,2,11,37
17455,37,6,22,0,9,28
17456,13,6,4,2,1,12
17457,32,21,9,0,2,30
17458,32,7,23,0,2,30
17459,88,43,19,7,19,69
17460,43,14,18,4,7,36
17461,116,47,16,19,34,82
17462,583,339,129,15,100,483
17463,115,39,33,13,30,85
17464,72,28,31,2,11,61
17465,52,21,17,8,6,46
17466,15,11,0,0,4,11
17467,19,6,8,3,2,17
17468,116,44,39,6,27,89
17469,26,7,14,0,5,21
17470,16,5,8,1,2,14
17471,111,25,53,5,28,83
17472,38,17,13,1,7,31
17473,32,25,0,0,7,25
17474,11,1,8,0,2,9
17475,222,119,67,0,36,186
17476,44,32,6,1,5,39
17477,100,64,10,11,15,85
17478,631,374,132,18,107,524
17479,85,52,20,10,3,82
17480,62,18,33,1,10,52
17481,5,1,4,0,0,5
17482,142,91,28,2,21,121
17483,60,32,9,7,12,48
17484,27,8,14,1,4,23
17485,41,20,14,0,7,34
17486,73,35,27,0,11,62
17487,100,64,9,5,22,78
17488,14,6,3,2,3,11
17489,134,49,39,11,35,99
17490,106,22,52,14,18,88
17491,52,20,11,9,12,40
17492,125,72,20,6,27,98
17493,137,91,19,1,26,111
17494,212,53,24,100,35,177
17495,69,50,7,3,9,60
17496,30,1,25,0,4,26
17497,50,3,38,1,8,42
17498,57,39,10,0,8,49
17499,156,61,42,25,28,128
17500,24,6,17,1,0,24
17501,16,9,5,0,2,14
17502,69,31,24,0,14,55
17503,125,29,42,29,25,100
17504,90,43,26,5,16,74
17505,24,6,15,0,3,21
17506,64,19,32,1,12,52
17507,369,204,91,15,59,310
17508,32,21,9,0,2,30
17509,231,78,91,14,48,183
17510,19,2,14,0,3,16
17511,338,151,116,11,60,278
17512,14,2,9,0,3,11
17513,218,56,31,96,35,183
17514,411,185,129,12,85,326
17515,53,26,15,0,12,41
17516,557,398,41,1,117,440
17517,32,21,9,0,2,30
17518,130,51,40,9,30,100
17519,70,20,38,1,11,59
17520,86,20,40,14,12,74
17521,15,7,2,1,5,10
17522,20,5,8,0,7,13
17523,78,38,26,1,13,65
17524,62,27,19,2,14,48
17525,21,9,5,0,7,14
17526,87,41,22,1,23,64
17527,35,7,20,2,6,29
17528,18,3,10,0,5,13
17529,32,21,9,0,2,30
17530,82,40,19,1,22,60
17531,12,0,11,0,1,11
17532,470,241,120,13,96,374
17533,213,88,14,74,37,176
17534,17,7,4,0,6,11
17535,35,12,11,2,10,25
17536,85,40,22,1,22,63
17537,85,64,5,4,12,73
17538,88,53,17,4,14,74
17539,82,45,20,1,16,66
17540,470,235,88,44,103,367
17541,125,97,9,0,19,106
17542,50,7,27,4,12,38
17543,274,16,205,0,53,221
17544,137,30,44,26,37,100
17545,68,28,26,0,14,54
17546,51,22,20,0,9,42
17547,16,1,7,2,6,10
17548,67,15,40,1,11,56
17549,83,67,2,0,14,69
17550,28,16,7,2,3,25
17551,61,41,7,0,13,48
17552,114,48,44,3,19,95
17553,114,43,26,24,21,93
17554,120,44,46,0,30,90
17555,91,29,46,0,16,75
17556,80,33,35,1,11,69
17557,103,29,50,2,22,81
17558,47,22,2,13,10,37
17559,32,21,9,0,2,30
17560,174,76,60,4,34,140
17561,136,47,46,19,24,112
17562,40,22,7,4,7,33
17563,12,3,5,3,1,11
17564,36,20,8,0,8,28
17565,86,68,3,1,14,72
17566,21,12,2,3,4,17
17567,96,34,28,8,26,70
17568,73,35,14,7,17,56
17569,43,27,8,2,6,37
17570,61,33,14,0,14,47
17571,27,15,6,0,6,21
17572,38,6,22,0,10,28
17573,25,16,4,2,3,22
17574,33,12,14,1,6,27
17575,152,104,30,11,7,145
17576,62,34,16,0,12,50
17577,67,34,16,0,17,50
17578,91,48,24,1,18,73
17579,101,37,37,5,22,79
17580,23,1,16,0,6,17
17581,51,20,20,1,10,41
17582,537,269,101,54,113,424
17583,58,34,16,0,8,50
17584,134,61,27,23,23,111
17585,66,46,1,0,19,47
17586,21,21,0,0,0,21
17587,199,105,51,7,36,163
17588,48,21,13,0,14,34
17589,47,12,18,10,7,40
17590,61,30,14,2,15,46
17591,387,223,85,0,79,308
17592,199,53,39,69,38,161
17593,117,40,59,0,18,99
17594,201,57,108,5,31,170
17595,153,70,49,5,29,124
17596,61,40,3,7,11,50
17597,108,48,33,5,22,86
17598,94,21,31,28,14,80
17599,35,26,4,0,5,30
17600,22,6,9,0,7,15
17601,8,1,3,0,4,4
17602,56,28,13,1,14,42
17603,92,48,13,1,30,62
17604,269,186,19,4,60,209
17605,137,72,34,0,31,106
17606,83,23,33,11,16,67
17607,3,2,1,0,0,3
17608,58,31,8,8,11,47
17609,167,31,103,1,32,135
17610,27,1,23,0,3,24
17611,138,51,36,21,30,108
17612,79,16,39,10,14,65
17613,21,9,5,2,5,16
17614,342,201,68,0,73,269
17615,90,27,27,12,24,66
17616,159,116,14,1,28,131
17617,55,38,6,1,10,45
17618,66,24,23,6,13,53
17619,99,65,17,0,17,82
17620,16,11,1,0,4,12
17621,194,14,145,0,35,159
17622,32,21,9,0,2,30
17623,77,41,12,2,22,55
17624,42,25,7,0,10,32
17625,94,48,28,1,17,77
17626,336,156,116,5,59,277
17627,38,23,9,4,2,36
17628,20,7,7,1,5,15
17629,151,97,29,0,25,126
17630,60,36,10,1,13,47
17631,663,385,144,18,116,547
17632,145,9,77,27,32,113
17633,30,1,25,0,4,26
17634,78,46,15,3,14,64
17635,75,37,17,2,19,56
17636,63,36,11,2,14,49
17637,25,1,19,0,5,20
17638,243,100,15,83,45,198
17639,34,17,6,8,3,31
17640,47,34,4,3,6,41
17641,77,39,19,0,19,58
17642,21,10,8,0,3,18
17643,33,9,12,4,8,25
17644,182,132,14,1,35,147
17645,90,44,29,1,16,74
17646,76,30,29,0,17,59
17647,386,227,78,16,65,321
17648,110,48,22,15,25,85
17649,41,21,3,2,15,26
17650,57,27,8,8,14,43
17651,9,1,4,3,1,8
17652,31,13,14,0,4,27
17653,34,11,16,3,4,30
17654,205,54,23,95,33,172
17655,24,2,18,1,3,21
17656,135,41,42,19,33,102
17657,40,8,27,3,2,38
17658,16,8,6,0,2,14
17659,70,19,39,1,11,59
17660,80,24,39,3,14,66
17661,128,54,46,4,24,104
17662,23,12,6,2,3,20
17663,67,46,6,0,15,52
17664,30,9,15,0,6,24
17665,21,14,2,0,5,16
17666,144,107,9,0,28,116
17667,63,37,17,3,6,57
17668,49,24,10,5,10,39
17669,30,11,13,0,6,24
17670,11,6,1,0,4,7
17671,95,30,26,20,19,76
17672,117,55,32,0,30,87
17673,242,163,62,2,15,227
17674,61,13,32,1,15,46
17675,20,15,2,0,3,17
17676,501,363,36,0,102,399
17677,21,9,5,0,7,14
17678,125,74,20,3,28,97
17679,55,11,38,0,6,49
17680,209,113,62,0,34,175
17681,12,3,7,1,1,11
17682,199,147,14,1,37,162
17683,53,28,9,7,9,44
17684,25,7,7,3,8,17
17685,101,47,14,13,27,74
17686,50,25,3,12,10,40
17687,40,8,13,7,12,28
17688,46,18,20,0,8,38
17689,32,21,9,0,2,30
17690,205,110,62,0,33,172
17691,46,29,9,0,8,38
17692,86,42,24,2,18,68
17693,50,14,15,7,14,36
17694,108,58,9,20,21,87
17695,44,21,17,0,6,38
17696,492,233,104,48,107,385
17697,33,8,17,6,2,31
17698,125,72,20,3,30,95
17699,38,10,15,6,7,31
17700,25,11,6,3,5,20
17701,25,11,7,0,7,18
17702,360,197,102,0,61,299
17703,121,95,3,0,23,98
17704,14,7,3,0,4,10
17705,32,21,9,0,2,30
17706,8,1,5,0,2,6
17707,37,18,5,5,9,28
17708,189,91,30,33,35,154
17709,47,2,28,7,10,37
17710,546,309,115,16,106,440
17711,69,39,7,11,12,57
17712,91,54,23,1,13,78
17713,190,88,47,17,38,152
17714,38,10,16,5,7,31
17715,179,101,32,0,46,133
17716,68,22,33,6,7,61
17717,34,17,4,4,9,25
17718,48,26,17,0,5,43
17719,32,1,28,0,3,29
17720,79,36,5,16,22,57
17721,9,5,4,0,0,9
17722,423,199,102,35,87,336
17723,22,11,5,1,5,17
17724,59,41,4,0,14,45
17725,22,1,12,1,8,14
17726,127,74,22,3,28,99
17727,41,28,7,0,6,35
17728,46,18,20,0,8,38
17729,33,9,7,10,7,26
17730,13,5,8,0,0,13
17731,91,28,42,1,20,71
17732,96,26,49,0,21,75
17733,147,59,57,8,23,124
17734,76,38,17,2,19,57
17735,149,117,4,0,28,121
17736,66,32,14,7,13,53
17737,153,37,80,1,35,118
17738,42,11,21,0,10,32
17739,228,154,32,0,42,186
17740,65,40,8,4,13,52
17741,89,29,37,5,18,71
17742,51,27,6,8,10,41
17743,202,138,26,4,34,168
17744,100,46,15,24,15,85
17745,297,153,100,0,44,253
17746,96,28,38,3,27,69
17747,61,28,15,3,15,46
17748,43,8,29,0,6,37
17749,18,5,5,3,5,13
17750,22,2,16,0,4,18
17751,42,27,4,3,8,34
17752,213,113,48,0,52,161
17753,127,74,22,3,28,99
17754,29,9,15,0,5,24
17755,82,51,17,0,14,68
17756,14,4,5,0,5,9
17757,47,22,15,0,10,37
17758,7,1,4,0,2,5
17759,73,27,22,7,17,56
17760,84,21,43,3,17,67
17761,198,53,111,3,31,167
17762,11,2,4,0,5,6
17763,48,17,16,3,12,36
17764,421,215,116,17,73,348
17765,99,66,17,0,16,83
17766,68,46,8,4,10,58
17767,506,264,93,46,103,403
17768,81,33,8,23,17,64
17769,43,12,16,8,7,36
17770,101,66,1,12,22,79
17771,66,35,15,0,16,50
17772,17,14,0,0,3,14
17773,47,24,9,0,14,33
17774,571,413,42,1,115,456
17775,0,0,0,0,0,0
17776,43,34,2,0,7,36
17777,26,0,23,0,3,23
17778,33,16,8,0,9,24
17779,64,41,5,0,18,46
17780,273,15,205,0,53,220
17781,72,46,15,0,11,61
17782,83,42,20,1,20,63
17783,120,64,33,1,22,98
17784,54,17,21,2,14,40
17785,33,24,5,0,4,29
17786,33,7,18,4,4,29
17787,78,45,23,0,10,68
17788,56,31,12,0,13,43
17789,17,4,11,0,2,15
17790,20,7,7,1,5,15
17791,103,24,42,14,23,80
17792,18,10,7,0,1,17
17793,17,5,9,1,2,15
17794,220,150,29,0,41,179
17795,41,24,11,0,6,35
17796,29,12,11,1,5,24
17797,37,21,8,0,8,29
17798,51,30,9,0,12,39
17799,200,49,103,14,34,166
17800,101,31,45,5,20,81
17801,237,143,9,31,54,183
17802,51,19,17,4,11,40
17803,26,18,1,0,7,19
17804,63,18,25,6,14,49
17805,29,15,4,0,10,19
17806,24,14,5,0,5,19
17807,0,0,0,0,0,0
17808,314,190,43,20,61,253
17809,69,22,30,1,16,53
17810,30,8,13,0,9,21
17811,17,6,4,4,3,14
17812,25,15,6,0,4,21
17813,11,4,7,0,0,11
17814,141,113,1,2,25,116
17815,20,17,0,0,3,17
17816,213,139,26,0,48,165
17817,19,8,7,1,3,16
17818,82,56,7,3,16,66
17819,43,29,4,3,7,36
17820,5,0,2,0,3,2
17821,180,129,14,1,36,144
17822,58,11,33,4,10,48
17823,95,52,19,1,23,72
17824,158,101,3,17,37,121
17825,114,70,27,0,17,97
17826,32,20,5,0,7,25
17827,95,59,16,0,20,75
17828,391,195,98,24,74,317
17829,14,8,2,1,3,11
17830,243,101,15,82,45,198
17831,453,228,118,12,95,358
17832,130,84,26,3,17,113
17833,105,50,5,33,17,88
17834,61,46,2,0,13,48
17835,13,3,9,0,1,12
17836,28,9,9,2,8,20
17837,36,13,12,3,8,28
17838,84,51,8,0,25,59
17839,15,7,5,0,3,12
17840,39,12,18,0,9,30
17841,80,54,15,0,11,69
17842,71,35,25,0,11,60
17843,120,74,22,0,24,96
17844,55,32,15,2,6,49
17845,139,108,5,3,23,116
17846,32,21,9,0,2,30
17847,118,66,32,10,10,108
17848,73,36,19,6,12,61
17849,390,198,96,23,73,317
17850,44,6,25,3,10,34
17851,46,24,13,2,7,39
17852,9,3,2,0,4,5
17853,150,115,9,1,25,125
17854,24,12,3,2,7,17
17855,388,188,97,27,76,312
17856,53,32,9,0,12,41
17857,103,35,49,0,19,84
17858,49,26,11,1,11,38
17859,47,1,36,0,10,37
17860,34,14,12,0,8,26
17861,159,77,48,1,33,126
17862,379,219,81,0,79,300
17863,109,48,41,2,18,91
17864,303,186,49,0,68,235
17865,21,9,8,1,3,18
17866,7,7,0,0,0,7
17867,46,18,20,0,8,38
17868,48,34,2,3,9,39
17869,23,3,6,5,9,14
17870,14,3,9,0,2,12
17871,46,3,8,28,7,39
17872,45,27,10,3,5,40
17873,69,21,28,8,12,57
17874,456,228,122,12,94,362
17875,25,2,18,0,5,20
17876,51,1,39,0,11,40
17877,629,348,156,23,102,527
17878,31,19,3,0,9,22
17879,14,1,9,0,4,10
17880,34,8,20,0,6,28
17881,42,7,24,1,10,32
17882,367,166,119,7,75,292
17883,63,5,54,0,4,59
17884,73,47,4,8,14,59
17885,120,46,4,51,19,101
17886,155,75,48,1,31,124
17887,92,32,42,1,17,75
17888,15,0,11,0,4,11
17889,270,109,100,16,45,225
17890,130,64,27,15,24,106
17891,33,16,8,1,8,25
17892,61,33,3,11,14,47
17893,33,17,5,3,8,25
17894,143,86,30,0,27,116
17895,55,34,9,0,12,43
17896,37,7,17,4,9,28
17897,58,33,13,1,11,47
17898,189,116,39,19,15,174
17899,676,379,162,23,112,564
17900,129,84,30,2,13,116
17901,6,2,2,0,2,4
17902,35,14,15,0,6,29
17903,24,10,2,8,4,20
17904,34,12,16,1,5,29
17905,8,3,1,0,4,4
17906,39,9,17,4,9,30
17907,53,34,9,0,10,43
17908,326,171,86,15,54,272
17909,91,43,26,3,19,72
17910,123,55,15,27,26,97
17911,30,12,10,0,8,22
17912,18,5,10,0,3,15
17913,236,155,35,0,46,190
17914,106,58,9,19,20,86
17915,435,139,155,49,92,343
17916,6,1,3,0,2,4
17917,135,45,57,0,33,102
17918,163,130,5,3,25,138
17919,20,9,2,1,8,12
17920,135,31,50,24,30,105
17921,55,35,12,0,8,47
17922,72,23,29,5,15,57
17923,120,54,49,3,14,106
17924,79,21,42,2,14,65
17925,281,177,42,0,62,219
17926,71,14,46,6,5,66
17927,22,10,7,0,5,17
17928,5,0,5,0,0,5
17929,169,86,31,21,31,138
17930,29,15,5,0,9,20
17931,50,35,5,0,10,40
17932,86,71,3,0,12,74
17933,478,332,45,1,100,378
17934,479,245,117,17,100,379
17935,139,48,42,22,27,112
17936,32,21,5,0,6,26
17937,105,30,57,0,18,87
17938,97,60,12,2,23,74
17939,245,172,18,0,55,190
17940,17,3,6,0,8,9
17941,13,13,0,0,0,13
17942,55,29,17,0,9,46
17943,230,98,47,26,59,171
17944,37,13,14,3,7,30
17945,27,17,3,0,7,20
17946,130,49,36,17,28,102
17947,28,8,10,1,9,19
17948,403,193,113,13,84,319
17949,73,40,18,0,15,58
17950,46,18,20,0,8,38
17951,21,7,9,1,4,17
17952,277,86,131,5,55,222
17953,8,4,0,1,3,5
17954,140,46,45,22,27,113
17955,70,37,18,0,15,55
17956,157,75,48,1,33,124
17957,82,16,47,3,16,66
17958,37,3,28,1,5,32
17959,195,76,36,33,50,145
17960,58,37,7,0,14,44
17961,102,54,20,11,17,85
17962,93,52,16,0,25,68
17963,109,30,39,16,24,85
17964,69,36,15,7,11,58
17965,18,6,4,1,7,11
17966,475,223,151,12,89,386
17967,52,8,27,5,12,40
17968,278,94,126,14,44,234
17969,44,14,15,3,12,32
17970,298,183,48,9,58,240
17971,54,15,18,8,13,41
17972,136,92,19,1,24,112
17973,20,8,6,2,4,16
17974,54,33,12,0,9,45
17975,32,21,9,0,2,30
17976,27,25,0,0,2,25
17977,69,45,14,0,10,59
17978,1077,386,437,46,208,869
17979,14,3,10,1,0,14
17980,140,10,80,18,32,108
17981,3,2,0,1,0,3
17982,204,145,41,1,17,187
17983,71,20,22,15,14,57
17984,21,10,8,0,3,18
17985,32,7,19,1,5,27
17986,18,11,2,1,4,14
17987,93,54,15,11,13,80
17988,178,109,34,6,29,149
17989,49,10,30,0,9,40
17990,52,41,1,0,10,42
17991,60,46,6,0,8,52
17992,59,17,27,0,15,44
17993,166,85,22,28,31,135
17994,33,17,14,0,2,31
17995,62,39,13,0,10,52
17996,145,95,26,0,24,121
17997,490,267,99,13,111,379
17998,89,49,22,0,18,71
17999,509,243,107,57,102,407
18000,76,41,19,4,12,64
18001,102,57,8,18,19,83
18002,24,7,14,0,3,21
18003,126,74,19,11,22,104
18004,135,103,1,1,30,105
18005,32,21,9,0,2,30
18006,36,20,3,0,13,23
18007,323,90,128,26,79,244
18008,45,16,18,0,11,34
18009,52,21,20,0,11,41
18010,33,7,17,0,9,24
18011,50,18,22,0,10,40
18012,93,55,26,8,4,89
18013,35,25,4,5,1,34
18014,117,31,43,16,27,90
18015,10,8,2,0,0,10
18016,30,10,10,4,6,24
18017,145,96,21,1,27,118
18018,42,13,19,0,10,32
18019,150,54,27,46,23,127
18020,13,4,7,0,2,11
18021,43,19,11,2,11,32
18022,29,13,9,3,4,25
18023,59,16,27,2,14,45
18024,55,34,9,0,12,43
18025,74,40,15,2,17,57
18026,73,23,24,14,12,61
18027,218,147,30,0,41,177
18028,286,182,79,4,21,265
18029,86,55,16,0,15,71
18030,6,2,3,0,1,5
18031,111,8,56,24,23,88
18032,37,34,0,0,3,34
18033,259,134,67,0,58,201
18034,411,230,81,19,81,330
18035,44,18,9,8,9,35
18036,50,35,2,0,13,37
18037,66,20,28,9,9,57
18038,111,105,0,6,0,111
18039,53,15,25,3,10,43
18040,62,25,20,3,14,48
18041,285,194,68,3,20,265
18042,148,113,7,0,28,120
18043,71,33,12,5,21,50
18044,110,90,3,3,14,96
18045,52,13,23,7,9,43
18046,35,7,19,0,9,26
18047,272,18,201,2,51,221
18048,60,11,32,0,17,43
18049,53,29,12,0,12,41
18050,78,27,25,14,12,66
18051,11,4,4,0,3,8
18052,24,10,10,1,3,21
18053,33,24,5,0,4,29
18054,14,2,11,0,1,13
18055,73,48,9,3,13,60
18056,52,14,21,8,9,43
18057,241,100,14,83,44,197
18058,123,44,43,14,22,101
18059,36,17,16,0,3,33
18060,18,1,10,5,2,16
18061,22,7,5,5,5,17
18062,12,5,3,2,2,10
18063,176,96,34,17,29,147
18064,89,42,32,1,14,75
18065,100,64,9,5,22,78
18066,32,21,9,0,2,30
18067,13,5,8,0,0,13
18068,2,0,2,0,0,2
18069,11,4,4,0,3,8
18070,143,88,26,0,29,114
18071,15,4,7,0,4,11
18072,249,163,21,3,62,187
18073,169,111,27,1,30,139
18074,60,47,1,0,12,48
18075,43,24,6,2,11,32
18076,68,30,13,11,14,54
18077,32,21,9,0,2,30
18078,44,25,6,2,11,33
18079,247,79,117,12,39,208
18080,673,398,136,20,119,554
18081,34,19,9,1,5,29
18082,470,136,193,37,104,366
18083,72,40,15,0,17,55
18084,69,34,22,0,13,56
18085,229,49,121,4,55,174
18086,23,2,4,7,10,13
18087,11,6,5,0,0,11
18088,67,21,34,1,11,56
18089,63,46,7,0,10,53
18090,161,82,45,1,33,128
18091,372,183,103,14,72,300
18092,100,46,15,24,15,85
18093,53,13,28,0,12,41
18094,191,45,104,10,32,159
18095,32,21,9,0,2,30
18096,22,9,7,0,6,16
18097,45,14,25,0,6,39
18098,178,100,33,0,45,133
18099,70,24,25,0,21,49
18100,173,121,11,10,31,142
18101,225,151,32,0,42,183
18102,127,44,47,8,28,99
18103,87,40,19,13,15,72
18104,103,58,8,18,19,84
18105,34,22,8,0,4,30
18106,143,77,45,10,11,132
18107,17,9,4,0,4,13
18108,130,44,49,12,25,105
18109,68,20,28,3,17,51
18110,5,1,2,0,2,3
18111,6,2,2,1,1,5
18112,32,21,9,0,2,30
18113,89,32,36,2,19,70
18114,62,19,32,1,10,52
18115,60,32,14,0,14,46
18116,63,31,14,5,13,50
18117,25,9,12,0,4,21
18118,36,20,11,0,5,31
18119,71,36,18,0,17,54
18120,200,146,15,3,36,164
18121,12,9,1,0,2,10
18122,12,3,6,2,1,11
18123,18,1,11,4,2,16
18124,34,8,18,4,4,30
18125,46,18,20,0,8,38
18126,66,46,8,0,12,54
18127,70,17,28,11,14,56
18128,444,143,180,20,101,343
18129,8,3,3,0,2,6
18130,101,37,37,5,22,79
18131,129,37,63,4,25,104
18132,397,228,69,7,93,304
18133,11,4,5,0,2,9
18134,163,117,9,5,32,131
18135,32,12,10,0,10,22
18136,39,8,25,4,2,37
18137,35,23,6,1,5,30
18138,515,274,86,48,107,408
18139,38,13,16,3,6,32
18140,37,15,12,0,10,27
18141,50,6,36,0,8,42
18142,82,55,7,1,19,63
18143,129,70,22,7,30,99
18144,39,4,25,0,10,29
18145,72,11,48,0,13,59
18146,26,19,2,0,5,21
18147,21,0,19,0,2,19
18148,57,26,6,12,13,44
18149,140,82,30,0,28,112
18150,19,3,14,0,2,17
18151,39,16,16,0,7,32
18152,10,6,2,0,2,8
18153,47,18,23,0,6,41
18154,314,156,101,4,53,261
18155,20,6,10,0,4,16
18156,91,65,6,0,20,71
18157,36,2,26,1,7,29
18158,18,5,6,2,5,13
18159,15,4,10,0,1,14
18160,36,7,21,0,8,28
18161,172,66,72,3,31,141
18162,105,66,29,1,9,96
18163,3,1,2,0,0,3
18164,15,3,7,1,4,11
18165,50,29,14,0,7,43
18166,68,44,12,0,12,56
18167,76,26,38,1,11,65
18168,224,132,18,26,48,176
18169,640,381,131,16,112,528
18170,67,36,15,1,15,52
18171,27,9,13,1,4,23
18172,262,20,192,2,48,214
18173,126,75,8,13,30,96
18174,223,75,82,15,51,172
18175,143,58,57,1,27,116
18176,88,55,20,0,13,75
18177,84,29,41,0,14,70
18178,70,31,22,0,17,53
18179,26,9,9,2,6,20
18180,34,18,13,0,3,31
18181,377,272,23,0,82,295
18182,60,24,25,1,10,50
18183,56,20,23,3,10,46
18184,217,89,43,28,57,160
18185,553,396,36,1,120,433
18186,153,74,26,24,29,124
18187,32,9,12,3,8,24
18188,7,4,1,0,2,5
18189,96,31,5,46,14,82
18190,521,295,127,15,84,437
18191,77,22,36,2,17,60
18192,32,21,9,0,2,30
18193,486,261,124,20,81,405
18194,39,29,5,0,5,34
18195,207,112,31,23,41,166
18196,48,28,10,0,10,38
18197,181,39,22,89,31,150
18198,62,23,28,1,10,52
18199,55,20,25,0,10,45
18200,163,70,35,19,39,124
18201,81,52,5,8,16,65
18202,78,13,41,7,17,61
18203,44,18,9,8,9,35
18204,86,42,25,4,15,71
18205,77,50,11,1,15,62
18206,32,4,26,0,2,30
18207,30,3,21,0,6,24
18208,143,93,29,0,21,122
18209,62,19,32,1,10,52
18210,342,147,119,6,70,272
18211,1293,524,176,336,257,1036
18212,119,60,24,12,23,96
18213,76,50,9,0,17,59
18214,48,24,12,1,11,37
18215,63,46,1,0,16,47
18216,17,11,6,0,0,17
18217,32,21,9,0,2,30
18218,6,3,1,0,2,4
18219,106,28,57,4,17,89
18220,13,2,7,0,4,9
18221,73,50,9,0,14,59
18222,9,4,4,0,1,8
18223,10,1,7,0,2,8
18224,3,0,3,0,0,3
18225,8,3,5,0,0,8
18226,100,54,21,1,24,76
18227,26,9,13,0,4,22
18228,99,62,14,3,20,79
18229,6,3,2,0,1,5
18230,179,113,30,5,31,148
18231,224,124,64,0,36,188
18232,161,124,15,1,21,140
18233,63,14,31,0,18,45
18234,9,6,0,0,3,6
18235,21,10,5,0,6,15
18236,6,1,3,0,2,4
18237,447,141,183,21,102,345
18238,112,55,33,0,24,88
18239,161,96,29,4,32,129
18240,42,19,12,2,9,33
18241,632,365,148,17,102,530
18242,59,6,35,2,16,43
18243,257,195,13,0,49,208
18244,52,0,32,3,17,35
18245,32,17,9,0,6,26
18246,131,28,46,29,28,103
18247,137,101,4,2,30,107
18248,145,86,41,9,9,136
18249,22,13,3,0,6,16
18250,46,18,20,0,8,38
18251,86,40,22,1,23,63
18252,14,2,9,0,3,11
18253,454,204,128,28,94,360
18254,27,14,7,0,6,21
18255,15,8,3,0,4,11
18256,412,132,170,22,88,324
18257,103,56,10,14,23,80
18258,96,69,5,0,22,74
18259,70,59,0,1,10,60
18260,428,240,106,0,82,346
18261,74,30,20,1,23,51
18262,65,40,7,1,17,48
18263,9,7,1,0,1,8
18264,51,17,20,2,12,39
18265,33,3,6,16,8,25
18266,32,21,9,0,2,30
18267,1308,530,182,339,257,1051
18268,20,6,9,0,5,15
18269,12,0,10,0,2,10
18270,52,26,17,0,9,43
18271,69,47,14,5,3,66
18272,14,4,2,5,3,11
18273,46,25,10,0,11,35
18274,48,15,24,1,8,40
18275,18,2,9,4,3,15
18276,16,9,4,0,3,13
18277,72,36,23,0,13,59
18278,36,20,11,0,5,31
18279,32,21,9,0,2,30
18280,27,9,14,0,4,23
18281,32,21,9,0,2,30
18282,123,32,49,10,32,91
18283,24,16,2,1,5,19
18284,153,53,50,17,33,120
18285,61,8,15,25,13,48
18286,137,73,26,10,28,109
18287,131,51,35,16,29,102
18288,147,83,26,10,28,119
18289,57,30,14,0,13,44
18290,27,7,9,4,7,20
18291,75,9,49,4,13,62
18292,7,3,3,0,1,6
18293,54,22,13,5,14,40
18294,84,70,3,0,11,73
18295,177,48,58,36,35,142
18296,32,12,2,14,4,28
18297,118,91,3,0,24,94
18298,60,39,13,0,8,52
18299,42,15,19,1,7,35
18300,39,23,8,0,8,31
18301,75,47,8,4,16,59
18302,19,2,14,0,3,16
18303,62,14,32,1,15,47
18304,27,9,15,1,2,25
18305,15,1,12,0,2,13
18306,129,86,11,5,27,102
18307,158,98,34,1,25,133
18308,196,145,13,1,37,159
18309,134,21,83,3,27,107
18310,48,17,18,2,11,37
18311,106,41,47,3,15,91
18312,85,41,25,2,17,68
18313,143,73,35,0,35,108
18314,83,43,21,0,19,64
18315,31,17,8,2,4,27
18316,46,18,20,0,8,38
18317,1,1,0,0,0,1
18318,32,21,9,0,2,30
18319,8,1,5,0,2,6
18320,87,64,5,0,18,69
18321,103,51,26,6,20,83
18322,27,8,7,5,7,20
18323,341,144,120,6,71,270
18324,269,112,98,16,43,226
18325,66,12,42,0,12,54
18326,200,28,90,33,49,151
18327,25,13,3,0,9,16
18328,47,7,29,0,11,36
18329,104,75,11,9,9,95
18330,344,155,114,6,69,275
18331,17,2,8,1,6,11
18332,472,218,147,14,93,379
18333,426,131,158,47,90,336
18334,66,26,19,12,9,57
18335,140,92,23,0,25,115
18336,5,2,1,0,2,3
18337,67,55,1,0,11,56
18338,27,12,10,0,5,22
18339,27,13,9,0,5,22
18340,130,47,37,16,30,100
18341,105,70,6,0,29,76
18342,76,47,11,3,15,61
18343,140,65,46,5,24,116
18344,74,53,7,3,11,63
18345,28,20,3,1,4,24
18346,43,15,19,0,9,34
18347,32,21,9,0,2,30
18348,34,13,15,0,6,28
18349,348,190,88,15,55,293
18350,47,28,10,0,9,38
18351,85,21,43,1,20,65
18352,443,252,82,14,95,348
18353,73,30,23,3,17,56
18354,64,34,6,4,20,44
18355,30,12,15,0,3,27
18356,74,52,9,0,13,61
18357,64,13,24,3,24,40
18358,50,37,0,0,13,37
18359,86,31,17,10,28,58
18360,127,81,29,0,17,110
18361,86,23,44,7,12,74
18362,32,21,9,0,2,30
18363,139,74,34,0,31,108
18364,26,2,15,4,5,21
18365,76,53,12,1,10,66
18366,113,65,16,5,27,86
18367,29,23,4,0,2,27
18368,61,42,10,0,9,52
18369,32,13,11,0,8,24
18370,92,30,34,9,19,73
18371,49,32,6,2,9,40
18372,83,38,28,1,16,67
18373,104,36,40,10,18,86
18374,100,47,15,23,15,85
18375,32,21,3,0,8,24
18376,6,2,3,0,1,5
18377,232,92,14,82,44,188
18378,94,62,15,0,17,77
18379,37,15,13,0,9,28
18380,134,43,35,31,25,109
18381,116,59,11,18,28,88
18382,121,58,25,16,22,99
18383,120,28,55,17,20,100
18384,16,4,5,1,6,10
18385,471,182,140,45,104,367
18386,48,30,8,2,8,40
18387,249,190,13,0,46,203
18388,160,111,23,0,26,134
18389,174,120,14,0,40,134
18390,31,15,7,0,9,22
18391,58,41,6,0,11,47
18392,100,63,10,2,25,75
18393,129,87,17,1,24,105
18394,17,14,1,0,2,15
18395,77,42,21,2,12,65
18396,40,1,33,0,6,34
18397,34,25,6,3,0,34
18398,95,41,33,4,17,78
18399,98,39,16,17,26,72
18400,310,159,83,15,53,257
18401,43,18,12,2,11,32
18402,61,28,17,5,11,50
18403,43,13,19,4,7,36
18404,31,13,7,4,7,24
18405,218,90,43,28,57,161
18406,26,7,13,0,6,20
18407,22,10,6,1,5,17
18408,53,14,26,0,13,40
18409,66,16,38,0,12,54
18410,291,19,215,2,55,236
18411,31,14,8,0,9,22
18412,14,7,4,0,3,11
18413,21,12,0,7,2,19
18414,42,6,27,0,9,33
18415,84,49,16,0,19,65
18416,96,51,20,4,21,75
18417,126,79,19,3,25,101
18418,116,49,43,1,23,93
18419,79,9,52,3,15,64
18420,402,189,136,7,70,332
18421,34,18,11,0,5,29
18422,21,7,4,5,5,16
18423,54,17,16,10,11,43
18424,147,98,24,0,25,122
18425,50,24,22,0,4,46
18426,36,2,24,0,10,26
18427,15,7,4,0,4,11
18428,44,31,4,0,9,35
18429,102,65,9,5,23,79
18430,362,195,92,15,60,302
18431,100,57,8,17,18,82
18432,51,17,14,8,12,39
18433,111,77,15,9,10,101
18434,161,95,25,11,30,131
18435,48,22,15,0,11,37
18436,112,38,36,18,20,92
18437,212,53,46,77,36,176
18438,63,14,33,1,15,48
18439,6,3,2,0,1,5
18440,148,8,81,27,32,116
18441,30,24,3,0,3,27
18442,41,14,18,1,8,33
18443,49,28,13,0,8,41
18444,143,90,35,9,9,134
18445,64,21,21,7,15,49
18446,74,45,20,1,8,66
18447,47,17,20,0,10,37
18448,167,41,21,75,30,137
18449,261,176,19,3,63,198
18450,31,18,3,0,10,21
18451,10,8,2,0,0,10
18452,362,263,18,2,79,283
18453,37,20,11,0,6,31
18454,70,26,28,1,15,55
18455,54,9,31,3,11,43
18456,32,19,5,0,8,24
18457,58,28,19,0,11,47
18458,9,7,0,0,2,7
18459,11,0,10,0,1,10
18460,31,4,24,0,3,28
18461,86,53,17,4,12,74
18462,173,127,13,1,32,141
18463,36,17,16,1,2,34
18464,96,58,18,0,20,76
18465,205,110,62,0,33,172
18466,79,28,24,10,17,62
18467,52,38,8,2,4,48
18468,428,194,138,10,86,342
18469,22,15,2,0,5,17
18470,20,6,11,1,2,18
18471,185,75,43,21,46,139
18472,31,11,14,0,6,25
18473,95,31,5,45,14,81
18474,75,35,20,7,13,62
18475,283,160,31,33,59,224
18476,58,2,47,1,8,50
18477,39,2,19,12,6,33
18478,65,42,7,1,15,50
18479,32,21,9,0,2,30
18480,53,27,17,0,9,44
18481,7,5,2,0,0,7
18482,22,1,16,0,5,17
18483,182,131,15,2,34,148
18484,21,6,9,2,4,17
18485,464,218,102,44,100,364
18486,98,52,19,11,16,82
18487,79,21,42,2,14,65
18488,25,11,10,1,3,22
18489,37,29,3,1,4,33
18490,88,38,20,9,21,67
18491,14,8,3,1,2,12
18492,69,23,26,7,13,56
18493,66,43,13,0,10,56
18494,80,49,19,0,12,68
18495,125,75,9,13,28,97
18496,59,21,14,15,9,50
18497,10,1,8,0,1,9
18498,347,188,89,15,55,292
18499,67,31,22,1,13,54
18500,141,51,34,20,36,105
18501,12,1,9,0,2,10
18502,216,101,73,1,41,175
18503,102,26,25,29,22,80
18504,32,21,9,0,2,30
18505,48,18,18,1,11,37
18506,40,30,1,2,7,33
18507,55,38,7,0,10,45
18508,21,12,6,0,3,18
18509,72,16,42,0,14,58
18510,175,103,36,7,29,146
18511,217,52,30,100,35,182
18512,57,10,24,7,16,41
18513,165,68,27,28,42,123
18514,112,63,38,0,11,101
18515,49,29,10,1,9,40
18516,59,31,18,0,10,49
18517,127,75,21,3,28,99
18518,72,54,6,0,12,60
18519,94,37,30,3,24,70
18520,29,9,15,0,5,24
18521,129,81,20,0,28,101
18522,37,26,0,1,10,27
18523,27,5,5,9,8,19
18524,221,150,30,0,41,180
18525,118,45,26,24,23,95
18526,70,33,11,2,24,46
18527,42,9,20,4,9,33
18528,56,14,18,12,12,44
18529,41,8,25,0,8,33
18530,57,29,6,9,13,44
18531,53,26,16,1,10,43
18532,66,26,29,2,9,57
18533,223,114,61,0,48,175
18534,108,57,16,12,23,85
18535,31,14,9,3,5,26
18536,34,8,17,0,9,25
18537,476,240,90,44,102,374
18538,19,12,1,0,6,13
18539,22,11,5,0,6,16
18540,314,221,19,2,72,242
18541,69,42,15,0,12,57
18542,190,136,7,3,44,146
18543,39,9,26,2,2,37
18544,137,80,23,2,32,105
18545,73,44,15,3,11,62
18546,17,15,0,0,2,15
18547,194,61,80,14,39,155
18548,38,10,15,6,7,31
18549,239,100,92,2,45,194
18550,128,63,21,18,26,102
18551,15,3,9,0,3,12
18552,89,56,16,2,15,74
18553,34,24,6,0,4,30
18554,194,138,12,7,37,157
18555,74,30,25,3,16,58
18556,289,126,88,16,59,230
18557,90,60,7,4,19,71
18558,51,31,8,4,8,43
18559,32,12,6,7,7,25
18560,19,12,4,1,2,17
18561,449,141,182,22,104,345
18562,278,110,106,16,46,232
18563,55,32,15,2,6,49
18564,68,31,6,17,14,54
18565,61,42,10,0,9,52
18566,32,0,25,2,5,27
18567,44,11,27,0,6,38
18568,54,9,28,5,12,42
18569,462,171,152,43,96,366
18570,67,44,10,1,12,55
18571,34,21,8,1,4,30
18572,40,15,18,3,4,36
18573,284,178,43,0,63,221
18574,137,37,68,1,31,106
18575,60,30,23,0,7,53
18576,54,39,8,0,7,47
18577,195,102,65,4,24,171
18578,14,7,6,1,0,14
18579,2,2,0,0,0,2
18580,283,74,40,125,44,239
18581,41,8,24,3,6,35
18582,32,21,9,0,2,30
18583,33,1,25,1,6,27
18584,90,38,8,26,18,72
18585,38,21,8,0,9,29
18586,12,1,8,0,3,9
18587,209,126,33,3,47,162
18588,41,13,23,1,4,37
18589,43,10,22,3,8,35
18590,49,34,8,0,7,42
18591,103,56,10,14,23,80
18592,82,53,16,0,13,69
18593,78,38,25,0,15,63
18594,268,22,189,2,55,213
18595,21,9,7,0,5,16
18596,79,36,29,0,14,65
18597,66,29,25,0,12,54
18598,180,43,91,3,43,137
18599,99,78,3,0,18,81
18600,37,13,15,2,7,30
18601,7,5,1,0,1,6
18602,97,59,19,0,19,78
18603,57,27,9,7,14,43
18604,37,8,12,6,11,26
18605,11,10,0,0,1,10
18606,220,149,30,0,41,179
18607,163,67,35,22,39,124
18608,47,32,10,0,5,42
18609,32,20,6,0,6,26
18610,80,56,5,0,19,61
18611,43,32,0,0,11,32
18612,48,10,34,0,4,44
18613,56,37,9,0,10,46
18614,21,5,12,0,4,17
18615,79,76,0,3,0,79
18616,50,11,30,0,9,41
18617,570,405,43,1,121,449
18618,59,17,33,0,9,50
18619,44,28,8,0,8,36
18620,42,12,19,0,11,31
18621,57,44,1,0,12,45
18622,340,171,91,14,64,276
18623,46,21,15,0,10,36
18624,65,37,17,0,11,54
18625,182,41,26,81,34,148
18626,88,20,40,6,22,66
18627,35,8,20,1,6,29
18628,43,32,4,0,7,36
18629,472,136,195,37,104,368
18630,37,15,13,0,9,28
18631,67,44,7,1,15,52
18632,50,33,9,0,8,42
18633,321,147,96,14,64,257
18634,32,15,7,1,9,23
18635,33,19,6,0,8,25
18636,91,28,47,0,16,75
18637,148,60,45,9,34,114
18638,101,27,48,8,18,83
18639,29,19,6,1,3,26
18640,46,22,14,0,10,36
18641,99,66,6,0,27,72
18642,30,3,22,0,5,25
18643,109,54,19,18,18,91
18644,2,0,1,0,1,1
18645,62,43,4,1,14,48
18646,21,7,11,0,3,18
18647,18,2,14,0,2,16
18648,22,1,16,0,5,17
18649,87,30,25,9,23,64
18650,36,6,21,0,9,27
18651,25,18,0,0,7,18
18652,63,21,25,3,14,49
18653,46,18,20,0,8,38
18654,126,29,42,30,25,101
18655,8,5,2,0,1,7
18656,58,35,8,3,12,46
18657,23,9,11,0,3,20
18658,26,10,10,0,6,20
18659,2,0,1,0,1,1
18660,429,199,112,30,88,341
18661,107,36,41,11,19,88
18662,32,21,9,0,2,30
18663,10,2,5,0,3,7
18664,81,40,10,18,13,68
18665,39,8,12,8,11,28
18666,14,10,0,0,4,10
18667,20,15,0,0,5,15
18668,64,14,38,0,12,52
18669,38,16,14,2,6,32
18670,56,3,40,1,12,44
18671,110,75,16,10,9,101
18672,251,111,80,17,43,208
18673,16,6,8,0,2,14
18674,42,15,15,3,9,33
18675,277,16,207,0,54,223
18676,32,21,9,0,2,30
18677,16,9,3,1,3,13
18678,24,3,19,0,2,22
18679,5,0,3,0,2,3
18680,70,35,15,5,15,55
18681,76,4,53,1,18,58
18682,52,10,33,0,9,43
18683,20,10,6,0,4,16
18684,571,321,140,19,91,480
18685,12,5,5,0,2,10
18686,235,155,34,0,46,189
18687,74,43,19,0,12,62
18688,37,14,14,0,9,28
18689,50,29,7,0,14,36
18690,266,75,37,110,44,222
18691,18,13,4,0,1,17
18692,454,268,54,37,95,359
18693,110,46,46,3,15,95
18694,31,24,3,0,4,27
18695,414,193,120,12,89,325
18696,48,18,21,0,9,39
18697,27,10,14,1,2,25
18698,259,97,107,6,49,210
18699,125,67,10,24,24,101
18700,28,11,6,6,5,23
18701,46,34,0,0,12,34
18702,342,145,120,6,71,271
18703,252,164,66,4,18,234
18704,56,3,40,1,12,44
18705,32,17,3,3,9,23
18706,9,3,5,0,1,8
18707,54,35,6,1,12,42
18708,39,13,21,1,4,35
18709,36,7,22,0,7,29
18710,74,56,5,4,9,65
18711,12,0,11,0,1,11
18712,447,112,190,44,101,346
18713,46,18,20,0,8,38
18714,359,178,97,14,70,289
18715,229,117,57,13,42,187
18716,15,12,0,0,3,12
18717,36,13,11,5,7,29
18718,46,18,20,0,8,38
18719,51,40,1,2,8,43
18720,54,33,13,0,8,46
18721,25,12,10,0,3,22
18722,43,19,14,0,10,33
18723,348,151,123,6,68,280
18724,48,36,8,4,0,48
18725,81,78,0,3,0,81
18726,50,34,5,2,9,41
18727,333,145,113,6,69,264
18728,77,23,36,0,18,59
18729,305,211,21,2,71,234
18730,43,15,22,0,6,37
18731,47,16,17,8,6,41
18732,76,39,13,9,15,61
18733,7,1,3,1,2,5
18734,41,16,8,6,11,30
18735,24,11,10,0,3,21
18736,151,52,34,32,33,118
18737,74,49,10,2,13,61
18738,13,2,8,0,3,10
18739,17,9,2,6,0,17
18740,30,16,4,4,6,24
18741,420,214,99,25,82,338
18742,106,69,18,0,19,87
18743,12,5,3,1,3,9
18744,42,18,15,0,9,33
18745,233,90,16,83,44,189
18746,29,12,13,0,4,25
18747,61,25,18,4,14,47
18748,613,364,132,15,102,511
18749,145,36,77,1,31,114
18750,75,35,22,2,16,59
18751,49,29,7,6,7,42
18752,123,44,18,39,22,101
18753,43,16,23,0,4,39
18754,135,77,21,3,34,101
18755,49,10,30,0,9,40
18756,59,15,34,1,9,50
18757,262,194,16,0,52,210
18758,195,77,35,33,50,145
18759,67,44,13,0,10,57
18760,35,7,23,0,5,30
18761,26,12,5,0,9,17
18762,92,34,35,9,14,78
18763,338,190,74,17,57,281
18764,38,25,7,1,5,33
18765,67,20,18,15,14,53
18766,35,11,18,3,3,32
18767,46,18,20,0,8,38
18768,53,28,14,1,10,43
18769,99,23,47,10,19,80
18770,360,156,125,11,68,292
18771,23,15,1,0,7,16
18772,112,35,35,13,29,83
18773,469,229,111,30,99,370
18774,72,32,25,0,15,57
18775,7,0,4,0,3,4
18776,225,69,108,12,36,189
18777,27,12,11,0,4,23
18778,86,9,54,5,18,68
18779,61,42,4,1,14,47
18780,147,63,50,14,20,127
18781,88,21,26,27,14,74
18782,29,11,12,0,6,23
18783,35,9,18,0,8,27
18784,131,92,20,0,19,112
18785,96,59,12,2,23,73
18786,73,63,2,0,8,65
18787,137,46,69,3,19,118
18788,38,4,29,0,5,33
18789,146,55,43,16,32,114
18790,32,19,6,1,6,26
18791,32,25,1,0,6,26
18792,199,147,14,1,37,162
18793,63,4,48,2,9,54
18794,40,24,6,1,9,31
18795,32,14,13,0,5,27
18796,8,3,3,0,2,6
18797,28,9,16,0,3,25
18798,6,3,1,0,2,4
18799,77,32,16,12,17,60
18800,119,10,65,17,27,92
18801,171,55,62,23,31,140
18802,598,414,56,1,127,471
18803,10,2,5,0,3,7
18804,441,113,187,38,103,338
18805,17,9,5,0,3,14
18806,71,35,25,1,10,61
18807,31,12,10,2,7,24
18808,46,18,20,0,8,38
18809,185,74,44,21,46,139
18810,446,211,96,42,97,349
18811,87,32,35,0,20,67
18812,15,10,2,1,2,13
18813,414,185,120,27,82,332
18814,79,25,38,1,15,64
18815,16,8,4,1,3,13
18816,31,4,24,0,3,28
18817,124,51,30,14,29,95
18818,25,1,13,1,10,15
18819,112,56,33,4,19,93
18820,80,36,28,0,16,64
18821,115,24,37,26,28,87
18822,198,132,20,0,46,152
18823,69,40,15,0,14,55
18824,69,39,3,14,13,56
18825,127,74,22,3,28,99
18826,109,44,9,36,20,89
18827,46,18,20,0,8,38
18828,58,30,6,5,17,41
18829,56,28,5,8,15,41
18830,72,40,19,0,13,59
18831,507,263,87,49,108,399
18832,306,187,53,0,66,240
18833,34,14,11,0,9,25
18834,104,10,62,10,22,82
18835,190,60,79,12,39,151
18836,111,48,30,13,20,91
18837,135,83,26,0,26,109
18838,86,55,12,3,16,70
18839,36,10,15,0,11,25
18840,64,1,55,0,8,56
18841,14,6,1,5,2,12
18842,151,76,31,15,29,122
18843,18,8,6,0,4,14
18844,42,19,14,2,7,35
18845,48,19,11,5,13,35
18846,69,12,48,1,8,61
18847,64,42,9,1,12,52
18848,119,44,35,14,26,93
18849,138,90,23,0,25,113
18850,396,231,82,16,67,329
18851,12,2,9,0,1,11
18852,7,1,2,1,3,4
18853,137,11,77,18,31,106
18854,31,21,2,0,8,23
18855,39,18,8,0,13,26
18856,377,167,115,11,84,293
18857,67,30,24,0,13,54
18858,16,4,6,1,5,11
18859,27,10,12,1,4,23
18860,7,2,3,0,2,5
18861,12,6,5,0,1,11
18862,24,10,7,1,6,18
18863,59,2,40,12,5,54
18864,103,61,18,7,17,86
18865,32,16,9,0,7,25
18866,15,1,11,0,3,12
18867,61,19,23,7,12,49
18868,66,51,1,0,14,52
18869,232,150,64,2,16,216
18870,34,16,15,0,3,31
18871,144,90,28,0,26,118
18872,214,116,33,23,42,172
18873,102,67,1,12,22,80
18874,165,113,9,8,35,130
18875,54,25,18,0,11,43
18876,104,30,56,0,18,86
18877,46,34,4,0,8,38
18878,113,50,33,0,30,83
18879,491,264,83,43,101,390
18880,63,35,15,0,13,50
18881,63,25,26,6,6,57
18882,32,18,5,0,9,23
18883,40,12,16,4,8,32
18884,50,20,21,0,9,41
18885,39,0,29,0,10,29
18886,278,92,127,14,45,233
18887,57,23,20,0,14,43
18888,47,25,8,2,12,35
18889,347,192,92,0,63,284
18890,46,18,20,0,8,38
18891,64,37,11,4,12,52
18892,57,24,25,1,7,50
18893,45,23,3,11,8,37
18894,38,11,19,0,8,30
18895,206,112,60,0,34,172
18896,235,91,101,4,39,196
18897,20,7,6,1,6,14
18898,30,12,14,0,4,26
18899,194,141,16,2,35,159
18900,73,16,29,13,15,58
18901,71,39,10,7,15,56
18902,43,20,6,7,10,33
18903,60,19,25,7,9,51
18904,23,12,5,0,6,17
18905,35,23,1,0,11,24
18906,3,0,1,1,1,2
18907,32,24,3,0,5,27
18908,32,21,9,0,2,30
18909,349,263,20,0,66,283
18910,63,31,20,0,12,51
18911,48,22,10,3,13,35
18912,94,28,26,21,19,75
18913,53,16,24,0,13,40
18914,37,14,14,0,9,28
18915,50,6,28,4,12,38
18916,64,42,10,2,10,54
18917,69,6,51,1,11,58
18918,52,32,12,0,8,44
18919,146,71,21,22,32,114
18920,71,25,17,6,23,48
18921,86,21,48,3,14,72
18922,22,3,0,10,9,13
18923,46,18,20,0,8,38
18924,19,6,7,0,6,13
18925,28,13,6,0,9,19
18926,21,15,2,1,3,18
18927,46,17,24,0,5,41
18928,54,22,16,3,13,41
18929,4,2,1,0,1,3
18930,621,348,153,22,98,523
18931,246,135,55,15,41,205
18932,30,7,11,3,9,21
18933,96,27,54,2,13,83
18934,97,37,43,3,14,83
18935,7,5,0,0,2,5
18936,10,7,1,0,2,8
18937,65,8,41,2,14,51
18938,66,35,10,9,12,54
18939,7,4,0,2,1,6
18940,47,13,25,1,8,39
18941,29,10,10,0,9,20
18942,73,25,32,1,15,58
18943,208,88,66,19,35,173
18944,74,37,18,3,16,58
18945,63,14,23,3,23,40
18946,83,67,2,0,14,69
18947,420,119,188,14,99,321
18948,10,4,3,0,3,7
18949,37,0,30,0,7,30
18950,91,63,9,3,16,75
18951,3,2,1,0,0,3
18952,58,19,25,2,12,46
18953,410,188,121,12,89,321
18954,24,11,11,0,2,22
18955,141,64,54,6,17,124
18956,52,33,8,8,3,49
18957,46,13,10,13,10,36
18958,26,12,7,0,7,19
18959,36,18,9,1,8,28
18960,46,18,20,0,8,38
18961,52,15,28,0,9,43
18962,35,0,29,0,6,29
18963,55,15,25,1,14,41
18964,179,78,30,28,43,136
18965,58,16,16,15,11,47
18966,631,352,156,19,104,527
18967,178,26,111,1,40,138
18968,48,21,16,2,9,39
18969,46,18,20,0,8,38
18970,32,12,11,0,9,23
18971,68,21,20,10,17,51
18972,37,18,13,0,6,31
18973,80,49,10,2,19,61
18974,24,8,12,1,3,21
18975,108,60,23,0,25,83
18976,230,157,31,0,42,188
18977,33,3,20,0,10,23
18978,23,1,14,1,7,16
18979,33,8,16,1,8,25
18980,9,5,3,0,1,8
18981,131,47,27,26,31,100
18982,90,51,16,1,22,68
18983,328,178,90,0,60,268
18984,42,7,22,0,13,29
18985,200,106,61,0,33,167
18986,175,80,57,4,34,141
18987,41,3,29,2,7,34
18988,32,21,9,0,2,30
18989,30,4,17,3,6,24
18990,15,4,10,0,1,14
18991,107,85,1,2,19,88
18992,17,0,16,0,1,16
18993,96,59,24,8,5,91
18994,367,278,20,0,69,298
18995,416,235,88,14,79,337
18996,108,40,31,12,25,83
18997,64,20,27,7,10,54
18998,254,174,14,5,61,193
18999,37,8,13,10,6,31
19000,326,149,78,35,64,262
19001,12,10,1,0,1,11
19002,95,21,51,3,20,75
19003,19,2,12,0,5,14
19004,31,0,11,15,5,26
19005,104,67,22,3,12,92
19006,8,3,4,0,1,7
19007,24,6,13,1,4,20
19008,64,39,13,0,12,52
19009,30,11,13,0,6,24
19010,74,39,21,0,14,60
19011,23,9,8,0,6,17
19012,46,18,20,0,8,38
19013,44,1,30,0,13,31
19014,49,30,7,0,12,37
19015,59,31,10,4,14,45
19016,119,99,3,2,15,104
19017,60,30,11,2,17,43
19018,462,218,143,13,88,374
19019,97,52,30,8,7,90
19020,63,41,4,0,18,45
19021,65,33,15,0,17,48
19022,115,22,65,3,25,90
19023,454,336,21,0,97,357
19024,32,7,16,0,9,23
19025,48,25,16,0,7,41
19026,79,26,31,6,16,63
19027,38,9,16,4,9,29
19028,204,96,62,1,45,159
19029,76,29,22,8,17,59
19030,96,71,3,1,21,75
19031,20,12,4,0,4,16
19032,11,5,3,0,3,8
19033,46,18,20,0,8,38
19034,571,337,118,16,100,471
19035,222,114,35,34,39,183
19036,29,11,12,0,6,23
19037,64,38,13,0,13,51
19038,74,35,21,2,16,58
19039,105,64,25,7,9,96
19040,596,353,120,20,103,493
19041,18,1,13,0,4,14
19042,46,18,20,0,8,38
19043,1,0,0,0,1,0
19044,343,146,120,6,71,272
19045,61,22,4,25,10,51
19046,12,5,4,1,2,10
19047,36,16,10,0,10,26
19048,468,243,111,12,102,366
19049,33,17,14,0,2,31
19050,44,34,6,1,3,41
19051,37,16,10,4,7,30
19052,199,145,14,0,40,159
19053,126,67,24,12,23,103
19054,47,26,12,0,9,38
19055,9,3,4,2,0,9
19056,137,102,3,0,32,105
19057,470,137,191,37,105,365
19058,77,10,43,5,19,58
19059,130,39,35,23,33,97
19060,19,6,10,0,3,16
19061,83,42,21,1,19,64
19062,90,56,15,0,19,71
19063,279,119,99,10,51,228
19064,141,110,6,0,25,116
19065,58,46,2,0,10,48
19066,32,21,9,0,2,30
19067,13,3,6,2,2,11
19068,195,103,31,27,34,161
19069,166,67,35,24,40,126
19070,32,21,9,0,2,30
19071,21,10,4,0,7,14
19072,146,71,20,22,33,113
19073,23,10,7,0,6,17
19074,34,2,24,0,8,26
19075,63,42,11,0,10,53
19076,133,87,24,0,22,111
19077,40,20,11,1,8,32
19078,6,4,2,0,0,6
19079,76,48,11,0,17,59
19080,32,21,9,0,2,30
19081,175,133,16,1,25,150
19082,110,76,13,1,20,90
19083,35,18,8,0,9,26
19084,394,104,154,48,88,306
19085,32,21,9,0,2,30
19086,54,43,1,0,10,44
19087,54,24,19,1,10,44
19088,51,22,18,1,10,41
19089,103,35,42,11,15,88
19090,45,25,9,3,8,37
19091,23,11,6,0,6,17
19092,40,18,12,0,10,30
19093,7,3,3,0,1,6
19094,164,49,85,0,30,134
19095,67,34,18,2,13,54
19096,36,20,11,0,5,31
19097,195,104,51,9,31,164
19098,62,34,18,0,10,52
19099,1,1,0,0,0,1
19100,24,7,10,0,7,17
19101,26,4,15,0,7,19
19102,19,6,9,0,4,15
19103,42,23,7,4,8,34
19104,218,51,52,77,38,180
19105,184,57,57,27,43,141
19106,127,74,22,3,28,99
19107,192,138,38,2,14,178
19108,43,6,25,2,10,33
19109,51,28,15,0,8,43
19110,82,38,18,7,19,63
19111,128,60,37,5,26,102
19112,51,26,20,0,5,46
19113,312,189,55,0,68,244
19114,16,9,2,1,4,12
19115,68,9,51,0,8,60
19116,57,27,23,1,6,51
19117,478,130,202,39,107,371
19118,28,12,11,0,5,23
19119,150,24,97,1,28,122
19120,20,11,5,0,4,16
19121,71,44,11,2,14,57
19122,56,3,40,1,12,44
19123,178,126,15,2,35,143
19124,46,18,20,0,8,38
19125,122,58,29,14,21,101
19126,29,12,14,1,2,27
19127,66,43,8,2,13,53
19128,96,52,30,7,7,89
19129,146,57,37,21,31,115
19130,103,89,3,0,11,92
19131,204,150,17,2,35,169
19132,164,69,35,21,39,125
19133,163,69,34,20,40,123
19134,24,5,13,0,6,18
19135,15,11,0,1,3,12
19136,58,33,15,0,10,48
19137,66,35,15,0,16,50
19138,94,67,7,0,20,74
19139,51,10,27,11,3,48
19140,105,45,29,8,23,82
19141,157,59,40,22,36,121
19142,14,5,4,0,5,9
19143,52,17,15,7,13,39
19144,39,5,28,0,6,33
19145,71,25,17,8,21,50
19146,6,3,3,0,0,6
19147,45,13,22,3,7,38
19148,42,23,9,0,10,32
19149,344,199,67,18,60,284
19150,44,12,14,7,11,33
19151,5,5,0,0,0,5
19152,345,186,89,15,55,290
19153,26,7,13,0,6,20
19154,74,48,5,10,11,63
19155,52,17,23,2,10,42
19156,37,27,1,2,7,30
19157,45,14,12,9,10,35
19158,149,38,79,1,31,118
19159,3,1,0,0,2,1
19160,17,8,2,4,3,14
19161,76,33,23,3,17,59
19162,44,24,5,6,9,35
19163,42,19,13,0,10,32
19164,28,15,7,0,6,22
19165,89,37,24,9,19,70
19166,130,65,29,14,22,108
19167,258,55,140,6,57,201
19168,510,290,100,14,106,404
19169,106,69,23,0,14,92
19170,61,14,25,8,14,47
19171,72,39,16,2,15,57
19172,44,29,10,1,4,40
19173,32,21,9,0,2,30
19174,14,4,5,3,2,12
19175,571,399,48,1,123,448
19176,147,30,83,4,30,117
19177,31,6,14,1,10,21
19178,257,174,26,4,53,204
19179,564,415,33,1,115,449
19180,95,27,47,7,14,81
19181,127,74,22,3,28,99
19182,337,173,95,5,64,273
19183,28,18,5,5,0,28
19184,49,3,11,26,9,40
19185,36,23,7,0,6,30
19186,285,156,76,0,53,232
19187,108,87,6,0,15,93
19188,42,25,8,1,8,34
19189,7,4,2,0,1,6
19190,158,71,51,5,31,127
19191,73,41,18,0,14,59
19192,93,25,39,3,26,67
19193,433,114,177,45,97,336
19194,55,5,34,6,10,45
19195,5,2,3,0,0,5
19196,45,10,23,5,7,38
19197,206,115,44,12,35,171
19198,77,47,14,0,16,61
19199,346,188,88,15,55,291
19200,35,6,21,0,8,27
19201,103,80,3,0,20,83
19202,47,32,2,1,12,35
19203,57,18,23,2,14,43
19204,82,8,46,10,18,64
19205,63,34,15,3,11,52
19206,36,14,17,0,5,31
19207,230,119,70,0,41,189
19208,32,21,9,0,2,30
19209,69,26,6,22,15,54
19210,17,10,3,0,4,13
19211,18,1,10,5,2,16
19212,77,47,15,0,15,62
19213,11,1,4,0,6,5
19214,209,101,44,21,43,166
19215,28,10,10,2,6,22
19216,153,53,47,23,30,123
19217,75,48,13,0,14,61
19218,116,52,28,11,25,91
19219,349,183,92,15,59,290
19220,39,27,5,6,1,38
19221,1,0,1,0,0,1
19222,83,24,41,0,18,65
19223,95,20,52,3,20,75
19224,61,32,22,2,5,56
19225,40,10,25,0,5,35
19226,23,3,16,0,4,19
19227,12,2,7,1,2,10
19228,55,24,13,6,12,43
19229,46,18,20,0,8,38
19230,178,101,32,0,45,133
19231,64,19,32,1,12,52
19232,53,26,15,0,12,41
19233,5,3,0,0,2,3
19234,39,4,29,2,4,35
19235,371,195,101,3,72,299
19236,58,14,34,1,9,49
19237,25,10,9,3,3,22
19238,34,7,19,1,7,27
19239,30,22,0,0,8,22
19240,44,2,32,0,10,34
19241,62,40,14,5,3,59
19242,121,66,29,4,22,99
19243,77,28,17,20,12,65
19244,60,5,9,28,18,42
19245,17,3,12,0,2,15
19246,81,54,7,1,19,62
19247,37,17,14,0,6,31
19248,18,11,5,0,2,16
19249,244,169,54,2,19,225
19250,0,0,0,0,0,0
19251,67,45,11,1,10,57
19252,61,10,33,6,12,49
19253,32,21,9,0,2,30
19254,89,52,16,4,17,72
19255,33,24,7,0,2,31
19256,165,97,38,1,29,136
19257,46,25,8,2,11,35
19258,414,218,106,20,70,344
19259,8,0,4,1,3,5
19260,133,71,30,7,25,108
19261,24,9,11,0,4,20
19262,21,8,7,2,4,17
19263,37,2,30,0,5,32
19264,46,18,20,0,8,38
19265,108,39,35,8,26,82
19266,32,21,9,0,2,30
19267,128,57,48,1,22,106
19268,110,91,3,3,13,97
19269,36,15,9,3,9,27
19270,37,1,27,2,7,30
19271,145,59,56,8,22,123
19272,150,98,31,0,21,129
19273,147,55,37,22,33,114
19274,78,44,18,2,14,64
19275,37,6,16,8,7,30
19276,10,5,2,0,3,7
19277,448,142,187,24,95,353
19278,36,15,15,0,6,30
19279,102,68,1,11,22,80
19280,6,2,2,0,2,4
19281,49,21,17,1,10,39
19282,105,37,39,7,22,83
19283,102,67,14,3,18,84
19284,84,29,30,12,13,71
19285,60,36,14,0,10,50
19286,28,9,10,2,7,21
19287,119,53,49,3,14,105
19288,93,41,35,1,16,77
19289,33,23,2,0,8,25
19290,48,29,11,0,8,40
19291,254,73,125,4,52,202
19292,102,31,44,6,21,81
19293,284,139,82,4,59,225
19294,38,5,28,0,5,33
19295,32,21,9,0,2,30
19296,84,58,5,0,21,63
19297,36,15,9,3,9,27
19298,135,48,55,0,32,103
19299,46,18,20,0,8,38
19300,32,21,9,0,2,30
19301,69,37,16,4,12,57
19302,54,21,19,0,14,40
19303,473,218,148,14,93,380
19304,200,80,37,32,51,149
19305,127,74,22,3,28,99
19306,113,46,39,7,21,92
19307,32,15,7,1,9,23
19308,7,0,6,0,1,6
19309,15,6,8,0,1,14
19310,27,9,9,2,7,20
19311,176,99,21,20,36,140
19312,98,45,15,23,15,83
19313,78,24,26,10,18,60
19314,95,32,33,12,18,77
19315,53,25,16,2,10,43
19316,61,34,14,0,13,48
19317,19,3,10,0,6,13
19318,224,150,33,0,41,183
19319,46,18,20,0,8,38
19320,133,47,21,28,37,96
19321,86,31,41,1,13,73
19322,65,17,32,4,12,53
19323,215,14,164,0,37,178
19324,56,14,20,13,9,47
19325,97,23,54,2,18,79
19326,23,11,9,0,3,20
19327,104,29,57,0,18,86
19328,97,57,22,3,15,82
19329,35,9,14,4,8,27
19330,6,1,4,0,1,5
19331,46,18,20,0,8,38
19332,270,128,90,4,48,222
19333,37,8,22,0,7,30
19334,46,18,20,0,8,38
19335,456,227,113,19,97,359
19336,345,148,120,6,71,274
19337,68,39,13,1,15,53
19338,91,26,53,0,12,79
19339,59,24,8,11,16,43
19340,160,114,11,0,35,125
19341,229,170,19,2,38,191
19342,84,55,9,3,17,67
19343,56,34,11,0,11,45
19344,20,0,16,1,3,17
19345,21,5,12,0,4,17
19346,88,54,22,10,2,86
19347,98,16,55,1,26,72
19348,35,26,2,0,7,28
19349,24,19,2,0,3,21
19350,89,51,18,0,20,69
19351,338,150,112,5,71,267
19352,16,3,7,0,6,10
19353,120,48,41,4,27,93
19354,45,13,18,7,7,38
19355,39,15,16,0,8,31
19356,190,145,18,0,27,163
19357,31,20,2,0,9,22
19358,15,12,0,0,3,12
19359,36,29,2,0,5,31
19360,107,67,23,4,13,94
19361,64,25,23,2,14,50
19362,30,10,16,0,4,26
19363,156,96,34,1,25,131
19364,196,110,27,23,36,160
19365,284,70,161,1,52,232
19366,31,10,10,0,11,20
19367,143,56,49,14,24,119
19368,54,29,6,6,13,41
19369,37,10,18,0,9,28
19370,77,46,17,0,14,63
19371,133,99,6,0,28,105
19372,90,45,32,3,10,80
19373,27,10,11,2,4,23
19374,15,8,0,3,4,11
19375,84,35,32,1,16,68
19376,44,7,25,0,12,32
19377,29,6,11,9,3,26
19378,68,33,23,1,11,57
19379,33,8,12,6,7,26
19380,113,32,59,0,22,91
19381,29,5,20,2,2,27
19382,79,40,26,4,9,70
19383,0,0,0,0,0,0
19384,665,391,139,18,117,548
19385,92,28,47,2,15,77
19386,34,24,6,4,0,34
19387,67,27,23,4,13,54
19388,46,18,20,0,8,38
19389,453,218,137,13,85,368
19390,20,11,5,0,4,16
19391,228,153,34,0,41,187
19392,52,32,10,0,10,42
19393,213,115,49,0,49,164
19394,260,182,57,2,19,241
19395,96,44,26,1,25,71
19396,120,59,43,1,17,103
19397,61,25,24,0,12,49
19398,47,11,24,3,9,38
19399,13,3,5,3,2,11
19400,29,15,4,0,10,19
19401,5,4,0,0,1,4
19402,39,24,11,0,4,35
19403,169,112,26,1,30,139
19404,32,21,9,0,2,30
19405,32,21,9,0,2,30
19406,37,27,5,0,5,32
19407,44,13,18,0,13,31
19408,69,40,14,0,15,54
19409,76,26,36,1,13,63
19410,64,44,4,1,15,49
19411,172,124,11,6,31,141
19412,148,111,10,0,27,121
19413,27,17,3,0,7,20
19414,414,235,102,0,77,337
19415,99,34,25,21,19,80
19416,10,6,0,1,3,7
19417,48,18,15,0,15,33
19418,99,57,24,0,18,81
19419,105,77,4,1,23,82
19420,46,13,23,0,10,36
19421,25,9,11,1,4,21
19422,44,30,1,1,12,32
19423,11,3,7,0,1,10
19424,207,102,61,0,44,163
19425,235,16,177,0,42,193
19426,33,7,17,1,8,25
19427,26,5,8,4,9,17
19428,38,16,15,0,7,31
19429,31,9,12,0,10,21
19430,283,160,31,33,59,224
19431,63,47,5,4,7,56
19432,45,23,15,1,6,39
19433,15,0,10,0,5,10
19434,35,13,12,2,8,27
19435,231,161,25,6,39,192
19436,68,28,26,0,14,54
19437,70,29,20,3,18,52
19438,62,20,23,1,18,44
19439,37,21,6,2,8,29
19440,90,31,43,1,15,75
19441,35,23,8,0,4,31
19442,39,2,26,4,7,32
19443,224,96,14,76,38,186
19444,46,18,20,0,8,38
19445,439,139,187,13,100,339
19446,47,20,18,0,9,38
19447,42,26,10,2,4,38
19448,41,7,20,0,14,27
19449,27,1,20,0,6,21
19450,8,3,5,0,0,8
19451,16,9,2,0,5,11
19452,29,13,8,1,7,22
19453,74,35,19,3,17,57
19454,122,45,37,21,19,103
19455,3,0,1,0,2,1
19456,475,200,119,47,109,366
19457,120,83,11,0,26,94
19458,14,6,4,0,4,10
19459,32,21,9,0,2,30
19460,36,16,13,0,7,29
19461,92,82,2,8,0,92
19462,177,140,11,1,25,152
19463,37,9,23,2,3,34
19464,71,43,6,5,17,54
19465,123,99,5,0,19,104
19466,11,9,2,0,0,11
19467,65,52,0,2,11,54
19468,54,22,20,1,11,43
19469,107,36,51,3,17,90
19470,174,82,71,4,17,157
19471,91,39,23,13,16,75
19472,52,17,16,7,12,40
19473,69,44,12,1,12,57
19474,102,67,1,12,22,80
19475,62,19,32,1,10,52
19476,133,58,46,1,28,105
19477,28,13,7,3,5,23
19478,73,24,32,4,13,60
19479,141,66,46,5,24,117
19480,55,17,24,0,14,41
19481,40,24,7,0,9,31
19482,36,22,5,1,8,28
19483,57,10,24,7,16,41
19484,29,9,11,0,9,20
19485,79,35,35,1,8,71
19486,85,21,47,0,17,68
19487,20,4,7,3,6,14
19488,5,1,3,0,1,4
19489,205,55,41,68,41,164
19490,414,238,99,0,77,337
19491,58,20,27,2,9,49
19492,17,8,6,0,3,14
19493,23,12,6,0,5,18
19494,24,4,13,2,5,19
19495,460,143,190,30,97,363
19496,23,7,10,0,6,17
19497,60,14,40,0,6,54
19498,123,44,34,18,27,96
19499,343,148,119,6,70,273
19500,29,19,4,0,6,23
19501,57,34,14,3,6,51
19502,423,141,174,16,92,331
19503,36,6,22,0,8,28
19504,25,11,9,0,5,20
19505,91,54,14,3,20,71
19506,103,69,21,0,13,90
19507,50,18,18,2,12,38
19508,94,90,0,4,0,94
19509,337,140,120,6,71,266
19510,61,19,18,7,17,44
19511,170,125,19,0,26,144
19512,108,36,42,11,19,89
19513,56,34,9,2,11,45
19514,108,46,31,7,24,84
19515,7,5,2,0,0,7
19516,37,8,14,3,12,25
19517,548,309,127,21,91,457
19518,116,58,35,0,23,93
19519,20,5,8,2,5,15
19520,75,9,42,5,19,56
19521,73,63,2,0,8,65
19522,47,9,24,0,14,33
19523,55,34,13,0,8,47
19524,256,147,23,33,53,203
19525,132,59,39,11,23,109
19526,143,61,32,16,34,109
19527,198,81,31,39,47,151
19528,109,59,25,3,22,87
19529,47,21,16,4,6,41
19530,189,145,17,0,27,162
19531,37,20,5,7,5,32
19532,31,7,19,2,3,28
19533,70,18,27,11,14,56
19534,51,24,18,0,9,42
19535,166,85,21,27,33,133
19536,125,73,11,20,21,104
19537,25,7,12,1,5,20
19538,46,18,20,0,8,38
19539,112,48,46,3,15,97
19540,42,25,5,6,6,36
19541,13,5,8,0,0,13
19542,292,74,43,127,48,244
19543,100,41,25,22,12,88
19544,91,60,17,0,14,77
19545,74,42,13,3,16,58
19546,140,80,18,22,20,120
19547,207,126,12,24,45,162
19548,564,312,118,13,121,443
19549,32,23,3,2,4,28
19550,103,56,10,14,23,80
19551,183,105,20,23,35,148
19552,73,40,4,13,16,57
19553,141,53,57,3,28,113
19554,136,11,76,18,31,105
19555,38,17,16,0,5,33
19556,34,14,7,5,8,26
19557,218,151,53,2,12,206
19558,92,26,47,2,17,75
19559,25,15,6,0,4,21
19560,32,21,9,0,2,30
19561,137,72,34,0,31,106
19562,27,6,16,2,3,24
19563,180,13,132,0,35,145
19564,25,9,12,0,4,21
19565,111,25,46,13,27,84
19566,127,97,5,2,23,104
19567,590,359,90,9,132,458
19568,184,128,7,5,44,140
19569,277,17,204,2,54,223
19570,21,14,5,0,2,19
19571,80,46,17,2,15,65
19572,186,75,47,20,44,142
19573,37,13,18,0,6,31
19574,85,54,16,0,15,70
19575,49,27,11,3,8,41
19576,71,35,19,6,11,60
19577,360,196,89,15,60,300
19578,11,1,8,1,1,10
19579,84,37,31,3,13,71
19580,41,32,2,0,7,34
19581,23,0,20,0,3,20
19582,82,24,17,22,19,63
19583,8,1,0,5,2,6
19584,247,40,161,2,44,203
19585,62,36,17,1,8,54
19586,68,23,27,5,13,55
19587,32,17,8,0,7,25
19588,23,16,1,2,4,19
19589,27,13,6,4,4,23
19590,78,49,10,1,18,60
19591,22,4,14,1,3,19
19592,21,9,6,0,6,15
19593,177,81,55,7,34,143
19594,30,12,13,0,5,25
19595,114,48,15,17,34,80
19596,103,65,27,0,11,92
19597,9,3,5,0,1,8
19598,39,21,9,1,8,31
19599,57,10,25,11,11,46
19600,112,88,2,2,20,92
19601,100,43,36,3,18,82
19602,123,63,22,12,26,97
19603,68,4,48,0,16,52
19604,97,24,54,4,15,82
19605,42,13,18,0,11,31
19606,42,30,7,0,5,37
19607,29,8,14,0,7,22
19608,69,47,9,0,13,56
19609,24,5,13,0,6,18
19610,7,3,2,1,1,6
19611,10,1,5,1,3,7
19612,154,51,41,32,30,124
19613,328,87,162,5,74,254
19614,54,18,26,0,10,44
19615,188,109,42,9,28,160
19616,90,43,14,14,19,71
19617,46,18,20,0,8,38
19618,102,57,8,18,19,83
19619,56,20,19,4,13,43
19620,220,149,30,0,41,179
19621,60,15,32,0,13,47
19622,68,46,2,2,18,50
19623,31,12,11,1,7,24
19624,173,121,14,2,36,137
19625,4,1,1,0,2,2
19626,25,8,12,1,4,21
19627,76,10,43,5,18,58
19628,487,268,77,41,101,386
19629,90,29,19,23,19,71
19630,36,26,2,0,8,28
19631,48,27,13,0,8,40
19632,223,46,125,7,45,178
19633,64,29,17,5,13,51
19634,74,25,22,9,18,56
19635,33,22,4,3,4,29
19636,71,23,25,2,21,50
19637,15,6,1,3,5,10
19638,33,26,2,2,3,30
19639,163,69,35,20,39,124
19640,110,54,36,0,20,90
19641,61,42,10,0,9,52
19642,55,15,21,9,10,45
19643,64,41,5,0,18,46
19644,83,24,22,19,18,65
19645,22,4,13,0,5,17
19646,87,28,38,9,12,75
19647,286,121,104,9,52,234
19648,10,1,4,0,5,5
19649,26,15,7,0,4,22
19650,45,4,29,0,12,33
19651,88,44,25,2,17,71
19652,22,8,3,3,8,14
19653,39,26,8,1,4,35
19654,121,22,69,1,29,92
19655,49,34,2,1,12,37
19656,45,13,15,10,7,38
19657,34,6,18,3,7,27
19658,98,43,33,4,18,80
19659,146,58,45,9,34,112
19660,34,10,12,1,11,23
19661,55,33,10,0,12,43
19662,140,54,48,14,24,116
19663,113,47,36,8,22,91
19664,173,101,26,9,37,136
19665,13,13,0,0,0,13
19666,12,9,2,0,1,11
19667,66,35,15,0,16,50
19668,12,4,5,2,1,11
19669,43,16,19,1,7,36
19670,46,18,20,0,8,38
19671,228,119,54,13,42,186
19672,72,19,42,1,10,62
19673,29,2,22,1,4,25
19674,68,40,13,0,15,53
19675,11,8,1,0,2,9
19676,32,18,9,0,5,27
19677,41,29,5,0,7,34
19678,44,29,8,0,7,37
19679,444,243,118,0,83,361
19680,38,13,10,8,7,31
19681,67,19,32,1,15,52
19682,352,169,114,1,68,284
19683,116,81,16,3,16,100
19684,148,94,29,0,25,123
19685,15,6,2,1,6,9
19686,143,66,44,11,22,121
19687,89,47,22,0,20,69
19688,93,25,41,5,22,71
19689,138,38,68,1,31,107
19690,61,33,15,1,12,49
19691,47,32,8,0,7,40
19692,429,215,109,11,94,335
19693,12,3,4,1,4,8
19694,31,17,10,0,4,27
19695,225,48,54,80,43,182
19696,90,70,0,4,16,74
19697,63,30,16,1,16,47
19698,39,20,12,3,4,35
19699,382,114,140,47,81,301
19700,88,36,18,8,26,62
19701,43,5,26,1,11,32
19702,34,27,2,1,4,30
19703,106,30,48,5,23,83
19704,59,29,11,4,15,44
19705,37,15,13,0,9,28
19706,15,9,6,0,0,15
19707,46,15,17,0,14,32
19708,48,18,14,6,10,38
19709,55,26,15,3,11,44
19710,17,7,6,1,3,14
19711,95,57,23,1,14,81
19712,113,47,14,18,34,79
19713,15,3,9,1,2,13
19714,20,8,3,3,6,14
19715,137,94,21,0,22,115
19716,79,46,9,9,15,64
19717,215,164,10,0,41,174
19718,104,37,41,11,15,89
19719,39,22,10,0,7,32
19720,44,35,2,0,7,37
19721,62,41,9,0,12,50
19722,36,9,17,1,9,27
19723,35,19,12,0,4,31
19724,390,180,125,9,76,314
19725,126,70,22,3,31,95
19726,92,48,28,1,15,77
19727,158,92,26,10,30,128
19728,100,46,25,9,20,80
19729,76,17,42,1,16,60
19730,365,163,126,6,70,295
19731,173,85,35,21,32,141
19732,229,54,118,3,54,175
19733,46,18,20,0,8,38
19734,29,12,13,0,4,25
19735,20,1,13,0,6,14
19736,27,15,8,0,4,23
19737,25,14,7,2,2,23
19738,59,37,7,0,15,44
19739,66,33,21,0,12,54
19740,156,121,12,1,22,134
19741,319,161,89,15,54,265
19742,144,51,37,29,27,117
19743,142,87,29,0,26,116
19744,223,91,41,37,54,169
19745,24,10,12,0,2,22
19746,84,60,7,0,17,67
19747,129,85,21,0,23,106
19748,208,112,34,23,39,169
19749,70,13,43,0,14,56
19750,145,78,29,6,32,113
19751,30,9,15,0,6,24
19752,39,11,20,0,8,31
19753,68,46,7,0,15,53
19754,15,1,10,0,4,11
19755,44,19,12,8,5,39
19756,271,70,39,118,44,227
19757,216,143,24,0,49,167
19758,88,38,27,3,20,68
19759,129,67,12,22,28,101
19760,39,15,4,10,10,29
19761,65,24,4,27,10,55
19762,42,13,7,12,10,32
19763,48,11,29,0,8,40
19764,38,21,10,1,6,32
19765,42,11,26,0,5,37
19766,110,78,8,6,18,92
19767,166,98,38,1,29,137
19768,105,55,22,7,21,84
19769,9,0,4,4,1,8
19770,65,44,9,2,10,55
19771,57,7,34,0,16,41
19772,9,6,2,1,0,9
19773,69,28,14,14,13,56
19774,11,2,7,1,1,10
19775,71,34,24,1,12,59
19776,38,18,7,1,12,26
19777,4,4,0,0,0,4
19778,37,21,6,0,10,27
19779,36,9,19,0,8,28
19780,477,221,157,11,88,389
19781,154,62,37,18,37,117
19782,24,8,12,1,3,21
19783,272,14,205,0,53,219
19784,354,159,103,23,69,285
19785,43,6,30,0,7,36
19786,55,22,21,2,10,45
19787,69,34,17,2,16,53
19788,59,27,24,0,8,51
19789,157,67,44,10,36,121
19790,72,57,2,0,13,59
19791,22,4,11,0,7,15
19792,130,37,42,18,33,97
19793,131,65,30,14,22,109
19794,39,2,30,2,5,34
19795,30,14,7,3,6,24
19796,12,5,4,0,3,9
19797,36,18,9,1,8,28
19798,4,0,1,1,2,2
19799,256,133,85,0,38,218
19800,5,1,1,0,3,2
19801,9,0,5,1,3,6
19802,23,10,10,0,3,20
19803,32,21,9,0,2,30
19804,74,41,19,0,14,60
19805,50,27,13,3,7,43
19806,251,35,166,2,48,203
19807,20,11,6,2,1,19
19808,148,42,58,19,29,119
19809,80,47,17,2,14,66
19810,80,54,9,0,17,63
19811,413,219,103,20,71,342
19812,29,19,6,1,3,26
19813,151,23,99,1,28,123
19814,76,27,31,3,15,61
19815,26,7,13,0,6,20
19816,122,67,35,1,19,103
19817,48,23,19,0,6,42
19818,65,13,25,14,13,52
19819,109,78,7,1,23,86
19820,116,97,2,2,15,101
19821,24,5,17,0,2,22
19822,59,29,18,0,12,47
19823,17,5,3,0,9,8
19824,405,229,92,0,84,321
19825,8,5,2,0,1,7
19826,52,18,11,16,7,45
19827,27,4,18,0,5,22
19828,68,43,15,2,8,60
19829,88,44,25,2,17,71
19830,292,37,198,2,55,237
19831,17,1,13,0,3,14
19832,17,3,11,0,3,14
19833,261,51,161,1,48,213
19834,12,4,6,0,2,10
19835,245,102,15,81,47,198
19836,17,2,5,1,9,8
19837,152,62,31,24,35,117
19838,62,43,8,4,7,55
19839,324,246,19,0,59,265
19840,44,13,22,0,9,35
19841,15,9,2,1,3,12
19842,31,17,6,0,8,23
19843,629,349,158,21,101,528
19844,65,36,12,2,15,50
19845,38,18,9,1,10,28
19846,34,2,25,1,6,28
19847,80,35,31,0,14,66
19848,98,29,41,6,22,76
19849,60,30,11,2,17,43
19850,69,34,19,2,14,55
19851,52,41,1,0,10,42
19852,4,2,1,0,1,3
19853,51,22,6,15,8,43
19854,46,18,20,0,8,38
19855,31,3,22,0,6,25
19856,216,59,21,103,33,183
19857,7,1,5,0,1,6
19858,15,4,9,0,2,13
19859,45,10,24,0,11,34
19860,29,2,21,1,5,24
19861,55,26,18,1,10,45
19862,44,36,2,0,6,38
19863,72,37,17,6,12,60
19864,669,390,144,18,117,552
19865,63,32,15,4,12,51
19866,25,12,6,1,6,19
19867,89,42,27,0,20,69
19868,244,133,56,14,41,203
19869,32,21,9,0,2,30
19870,137,77,23,3,34,103
19871,38,23,9,4,2,36
19872,148,61,32,19,36,112
19873,91,54,18,2,17,74
19874,63,22,24,5,12,51
19875,62,18,29,1,14,48
19876,32,15,10,2,5,27
19877,40,20,11,1,8,32
19878,21,0,14,0,7,14
19879,48,26,15,0,7,41
19880,36,10,19,0,7,29
19881,26,13,7,0,6,20
19882,75,41,20,0,14,61
19883,441,200,151,9,81,360
19884,48,25,14,2,7,41
19885,73,40,18,0,15,58
19886,98,39,42,1,16,82
19887,2,2,0,0,0,2
19888,94,26,33,14,21,73
19889,120,49,35,13,23,97
19890,203,54,38,76,35,168
19891,113,48,39,4,22,91
19892,56,35,14,0,7,49
19893,16,10,3,0,3,13
19894,58,12,30,0,16,42
19895,28,14,8,0,6,22
19896,185,54,84,5,42,143
19897,62,14,32,7,9,53
19898,256,14,193,0,49,207
19899,23,8,12,0,3,20
19900,67,44,7,1,15,52
19901,435,136,185,16,98,337
19902,115,7,60,25,23,92
19903,170,84,52,3,31,139
19904,240,176,11,1,52,188
19905,61,28,19,0,14,47
19906,79,37,28,4,10,69
19907,95,46,26,5,18,77
19908,28,9,15,0,4,24
19909,29,16,6,0,7,22
19910,108,74,13,1,20,88
19911,46,10,22,0,14,32
19912,90,36,16,19,19,71
19913,18,10,7,0,1,17
19914,13,5,3,2,3,10
19915,19,16,0,0,3,16
19916,42,18,11,0,13,29
19917,96,47,32,1,16,80
19918,227,52,33,103,39,188
19919,349,183,93,14,59,290
19920,46,18,20,0,8,38
19921,127,74,22,3,28,99
19922,60,38,7,0,15,45
19923,77,14,39,6,18,59
19924,28,13,8,0,7,21
19925,22,13,4,0,5,17
19926,9,1,6,0,2,7
19927,174,49,52,35,38,136
19928,51,39,6,0,6,45
19929,45,27,8,0,10,35
19930,31,8,10,3,10,21
19931,67,46,8,0,13,54
19932,51,25,10,7,9,42
19933,95,25,54,2,14,81
19934,142,40,70,1,31,111
19935,38,9,22,4,3,35
19936,85,40,32,0,13,72
19937,45,6,29,0,10,35
19938,53,23,18,2,10,43
19939,26,9,8,3,6,20
19940,35,19,9,1,6,29
19941,87,28,44,2,13,74
19942,131,71,39,0,21,110
19943,174,127,10,5,32,142
19944,32,21,9,0,2,30
19945,24,13,7,2,2,22
19946,183,102,33,1,47,136
19947,24,9,5,1,9,15
19948,33,17,7,0,9,24
19949,433,236,93,12,92,341
19950,85,43,16,8,18,67
19951,154,50,75,2,27,127
19952,134,74,22,4,34,100
19953,76,38,17,2,19,57
19954,130,98,5,1,26,104
19955,129,87,17,1,24,105
19956,63,21,26,7,9,54
19957,469,222,150,13,84,385
19958,32,21,9,0,2,30
19959,274,17,202,2,53,221
19960,60,47,5,0,8,52
19961,99,41,16,17,25,74
19962,76,31,8,17,20,56
19963,156,76,33,17,30,126
19964,240,159,20,3,58,182
19965,20,3,14,0,3,17
19966,73,23,24,14,12,61
19967,19,3,15,0,1,18
19968,9,7,0,0,2,7
19969,279,27,198,2,52,227
19970,57,15,16,17,9,48
19971,215,13,163,0,39,176
19972,71,36,17,0,18,53
19973,114,52,38,1,23,91
19974,22,9,6,0,7,15
19975,58,9,36,4,9,49
19976,21,1,17,0,3,18
19977,103,53,23,0,27,76
19978,138,94,32,3,9,129
19979,90,44,5,27,14,76
19980,43,22,9,3,9,34
19981,168,31,103,1,33,135
19982,76,31,14,14,17,59
19983,59,36,13,0,10,49
19984,5,3,0,0,2,3
19985,108,51,37,0,20,88
19986,41,7,15,8,11,30
19987,46,18,20,0,8,38
19988,34,17,13,0,4,30
19989,50,16,21,0,13,37
19990,55,17,27,0,11,44
19991,51,9,30,4,8,43
19992,72,4,52,0,16,56
19993,11,0,9,0,2,9
19994,69,17,3,34,15,54
19995,29,14,4,5,6,23
19996,35,7,25,0,3,32
19997,62,23,30,1,8,54
19998,85,30,37,1,17,68
19999,56,21,23,1,11,45
20000,40,7,22,2,9,31
20001,46,18,20,2,6,40
20002,8,3,5,0,0,8
20003,33,19,7,0,7,26
20004,32,21,9,0,2,30
20005,112,57,24,11,20,92
20006,63,33,10,2,18,45
20007,20,11,4,1,4,16
20008,65,21,16,21,7,58
20009,169,54,85,0,30,139
20010,69,16,37,0,16,53
20011,170,116,16,0,38,132
20012,34,13,8,1,12,22
20013,83,47,19,4,13,70
20014,32,22,2,0,8,24
20015,45,13,15,9,8,37
20016,46,18,20,0,8,38
20017,426,201,137,11,77,349
20018,58,10,23,13,12,46
20019,280,73,153,1,53,227
20020,42,26,5,0,11,31
20021,133,101,8,0,24,109
20022,56,0,39,0,17,39
20023,483,261,80,41,101,382
20024,81,30,21,13,17,64
20025,218,147,30,0,41,177
20026,13,3,7,1,2,11
20027,284,75,150,2,57,227
20028,54,11,38,0,5,49
20029,72,45,13,0,14,58
20030,82,31,34,0,17,65
20031,88,21,26,27,14,74
20032,148,41,78,4,25,123
20033,20,10,8,0,2,18
20034,100,65,18,0,17,83
20035,25,9,4,8,4,21
20036,174,89,41,0,44,130
20037,50,10,26,0,14,36
20038,165,97,38,1,29,136
20039,12,9,2,0,1,11
20040,30,10,12,4,4,26
20041,415,276,43,0,96,319
20042,44,6,25,3,10,34
20043,330,207,50,9,64,266
20044,130,42,48,16,24,106
20045,58,37,6,4,11,47
20046,150,69,46,5,30,120
20047,127,37,56,6,28,99
20048,14,4,6,0,4,10
20049,108,54,37,1,16,92
20050,132,103,6,0,23,109
20051,197,53,108,4,32,165
20052,46,18,20,0,8,38
20053,43,21,12,1,9,34
20054,56,20,22,4,10,46
20055,23,3,12,1,7,16
20056,165,76,51,0,38,127
20057,435,213,106,29,87,348
20058,34,11,11,5,7,27
20059,58,12,38,0,8,50
20060,262,63,46,109,44,218
20061,35,18,9,0,8,27
20062,343,203,68,0,72,271
20063,10,6,0,1,3,7
20064,109,104,0,5,0,109
20065,416,100,177,44,95,321
20066,4,1,2,0,1,3
20067,39,20,10,1,8,31
20068,46,18,20,0,8,38
20069,93,55,14,1,23,70
20070,279,188,68,2,21,258
20071,104,48,27,2,27,77
20072,404,229,57,34,84,320
20073,177,141,11,1,24,153
20074,88,19,30,19,20,68
20075,39,15,11,3,10,29
20076,330,141,114,6,69,261
20077,14,6,3,0,5,9
20078,89,42,22,1,24,65
20079,49,25,6,2,16,33
20080,7,3,2,2,0,7
20081,145,61,32,22,30,115
20082,57,39,8,1,9,48
20083,38,12,12,7,7,31
20084,75,45,8,8,14,61
20085,25,2,16,0,7,18
20086,42,21,11,4,6,36
20087,39,13,21,1,4,35
20088,13,5,7,0,1,12
20089,80,40,25,0,15,65
20090,161,126,2,2,31,130
20091,71,47,9,2,13,58
20092,37,8,12,8,9,28
20093,186,127,11,9,39,147
20094,44,18,20,0,6,38
20095,50,15,15,10,10,40
20096,53,22,18,0,13,40
20097,52,10,32,0,10,42
20098,57,26,16,0,15,42
20099,210,85,66,12,47,163
20100,149,116,12,1,20,129
20101,114,31,60,0,23,91
20102,8,1,4,0,3,5
20103,28,7,15,0,6,22
20104,257,138,62,0,57,200
20105,46,2,34,0,10,36
20106,3,0,3,0,0,3
20107,59,29,18,1,11,48
20108,381,183,112,14,72,309
20109,433,315,28,0,90,343
20110,434,197,140,10,87,347
20111,25,14,7,0,4,21
20112,38,11,21,1,5,33
20113,314,164,74,19,57,257
20114,34,13,14,2,5,29
20115,24,2,17,0,5,19
20116,126,81,26,3,16,110
20117,231,101,15,75,40,191
20118,32,21,9,0,2,30
20119,357,251,31,0,75,282
20120,106,73,13,2,18,88
20121,39,20,13,1,5,34
20122,77,49,15,0,13,64
20123,66,35,9,6,16,50
20124,28,8,11,1,8,20
20125,40,6,22,6,6,34
20126,71,54,5,4,8,63
20127,143,60,32,17,34,109
20128,141,59,51,3,28,113
20129,65,25,29,2,9,56
20130,8,3,3,0,2,6
20131,69,7,48,3,11,58
20132,152,110,16,0,26,126
20133,56,17,22,1,16,40
20134,56,1,22,25,8,48
20135,185,70,46,29,40,145
20136,73,25,20,10,18,55
20137,50,11,30,0,9,41
20138,226,48,56,82,40,186
20139,66,29,17,4,16,50
20140,13,0,11,1,1,12
20141,45,34,9,2,0,45
20142,52,24,14,5,9,43
20143,39,5,25,0,9,30
20144,44,19,17,1,7,37
20145,59,42,12,0,5,54
20146,89,48,18,5,18,71
20147,130,72,11,20,27,103
20148,71,57,2,0,12,59
20149,131,28,45,30,28,103
20150,51,30,7,3,11,40
20151,19,9,5,1,4,15
20152,252,170,28,4,50,202
20153,176,126,12,1,37,139
20154,13,6,4,0,3,10
20155,94,61,14,11,8,86
20156,141,59,41,15,26,115
20157,72,25,26,2,19,53
20158,37,22,10,1,4,33
20159,42,13,20,2,7,35
20160,10,2,5,1,2,8
20161,56,11,28,11,6,50
20162,117,72,16,3,26,91
20163,61,21,14,17,9,52
20164,27,11,10,0,6,21
20165,253,117,88,0,48,205
20166,89,16,46,6,21,68
20167,42,20,12,0,10,32
20168,381,221,69,13,78,303
20169,171,62,51,25,33,138
20170,28,8,15,2,3,25
20171,368,220,71,13,64,304
20172,53,3,40,2,8,45
20173,152,106,15,0,31,121
20174,46,18,11,10,7,39
20175,45,25,12,0,8,37
20176,188,109,22,22,35,153
20177,422,212,106,11,93,329
20178,13,8,3,1,1,12
20179,44,14,18,2,10,34
20180,29,6,13,3,7,22
20181,100,54,20,11,15,85
20182,17,5,5,1,6,11
20183,80,41,7,13,19,61
20184,96,25,37,13,21,75
20185,147,87,26,6,28,119
20186,32,11,14,0,7,25
20187,22,10,11,0,1,21
20188,71,18,37,1,15,56
20189,236,180,12,0,44,192
20190,13,8,4,0,1,12
20191,9,3,2,1,3,6
20192,46,18,20,0,8,38
20193,5,1,2,0,2,3
20194,20,5,0,8,7,13
20195,228,172,15,0,41,187
20196,50,21,18,2,9,41
20197,27,13,9,0,5,22
20198,79,32,8,16,23,56
20199,568,398,47,1,122,446
20200,16,1,12,1,2,14
20201,61,28,23,1,9,52
20202,520,376,32,1,111,409
20203,16,10,1,2,3,13
20204,23,12,7,1,3,20
20205,72,33,20,5,14,58
20206,95,43,20,8,24,71
20207,54,39,8,0,7,47
20208,138,74,33,0,31,107
20209,36,0,27,0,9,27
20210,158,76,48,1,33,125
20211,6,2,2,0,2,4
20212,61,22,31,0,8,53
20213,32,24,1,3,4,28
20214,18,6,9,0,3,15
20215,109,47,30,12,20,89
20216,64,37,13,1,13,51
20217,34,12,16,2,4,30
20218,222,96,14,75,37,185
20219,282,103,122,3,54,228
20220,168,72,53,3,40,128
20221,23,10,6,2,5,18
20222,370,193,92,20,65,305
20223,23,10,7,0,6,17
20224,10,7,2,0,1,9
20225,169,111,27,1,30,139
20226,81,35,31,0,15,66
20227,64,26,22,5,11,53
20228,120,53,36,2,29,91
20229,44,7,28,3,6,38
20230,73,37,18,6,12,61
20231,22,14,5,0,3,19
20232,372,206,92,15,59,313
20233,17,10,5,0,2,15
20234,355,156,123,6,70,285
20235,37,5,25,4,3,34
20236,9,2,3,0,4,5
20237,32,21,9,0,2,30
20238,127,42,46,7,32,95
20239,32,11,12,1,8,24
20240,4,1,1,0,2,2
20241,19,8,5,2,4,15
20242,29,9,15,1,4,25
20243,221,115,52,13,41,180
20244,15,11,2,0,2,13
20245,81,46,18,0,17,64
20246,121,60,40,10,11,110
20247,125,45,41,10,29,96
20248,163,10,89,30,34,129
20249,160,93,37,1,29,131
20250,86,39,25,4,18,68
20251,37,3,26,0,8,29
20252,148,82,14,24,28,120
20253,13,0,11,1,1,12
20254,159,52,55,24,28,131
20255,22,11,0,6,5,17
20256,116,45,43,3,25,91
20257,24,7,8,1,8,16
20258,34,13,14,0,7,27
20259,34,22,7,0,5,29
20260,49,14,15,12,8,41
20261,134,99,4,2,29,105
20262,126,80,22,0,24,102
20263,69,26,5,23,15,54
20264,420,242,87,16,75,345
20265,39,27,0,1,11,28
20266,32,21,9,0,2,30
20267,59,43,3,3,10,49
20268,56,24,20,1,11,45
20269,43,7,23,0,13,30
20270,54,22,21,0,11,43
20271,357,162,120,6,69,288
20272,3,3,0,0,0,3
20273,347,142,97,33,75,272
20274,73,63,2,0,8,65
20275,21,1,13,1,6,15
20276,49,26,2,9,12,37
20277,4,4,0,0,0,4
20278,53,15,18,10,10,43
20279,130,11,71,18,30,100
20280,137,91,13,4,29,108
20281,52,12,31,0,9,43
20282,105,17,47,13,28,77
20283,13,2,9,0,2,11
20284,39,13,14,2,10,29
20285,73,22,17,15,19,54
20286,40,16,21,0,3,37
20287,53,35,1,4,13,40
20288,80,32,10,20,18,62
20289,80,30,15,16,19,61
20290,6,3,1,0,2,4
20291,69,23,31,6,9,60
20292,28,13,10,1,4,24
20293,100,31,40,10,19,81
20294,31,10,4,7,10,21
20295,21,13,5,0,3,18
20296,52,25,3,14,10,42
20297,39,20,13,0,6,33
20298,138,56,44,15,23,115
20299,43,15,21,0,7,36
20300,46,18,20,0,8,38
20301,151,43,12,69,27,124
20302,26,12,7,0,7,19
20303,53,23,15,1,14,39
20304,124,36,39,23,26,98
20305,99,61,11,2,25,74
20306,59,18,15,14,12,47
20307,48,27,16,0,5,43
20308,91,36,19,18,18,73
20309,48,26,15,0,7,41
20310,43,7,27,5,4,39
20311,85,49,20,3,13,72
20312,73,18,32,7,16,57
20313,31,17,6,0,8,23
20314,46,18,20,0,8,38
20315,21,1,17,0,3,18
20316,373,260,33,0,80,293
20317,111,51,17,16,27,84
20318,27,19,3,1,4,23
20319,136,72,33,0,31,105
20320,106,49,34,4,19,87
20321,306,147,95,12,52,254
20322,86,56,15,0,15,71
20323,76,5,53,1,17,59
20324,44,1,30,0,13,31
20325,50,4,35,6,5,45
20326,36,4,21,0,11,25
20327,32,9,4,11,8,24
20328,33,8,17,0,8,25
20329,132,97,4,2,29,103
20330,10,8,0,0,2,8
20331,51,31,2,2,16,35
20332,21,1,17,0,3,18
20333,156,57,47,17,35,121
20334,92,56,19,0,17,75
20335,38,7,23,0,8,30
20336,39,18,3,7,11,28
20337,114,79,17,9,9,105
20338,46,26,8,2,10,36
20339,44,30,1,1,12,32
20340,15,5,7,0,3,12
20341,6,3,0,0,3,3
20342,35,12,19,0,4,31
20343,147,68,49,3,27,120
20344,13,2,7,0,4,9
20345,2,0,1,0,1,1
20346,170,86,40,0,44,126
20347,53,9,31,2,11,42
20348,75,14,46,0,15,60
20349,49,21,6,11,11,38
20350,82,30,32,4,16,66
20351,140,86,29,0,25,115
20352,42,13,24,0,5,37
20353,62,19,18,10,15,47
20354,247,128,84,0,35,212
20355,42,14,15,0,13,29
20356,19,5,9,1,4,15
20357,101,36,39,11,15,86
20358,63,44,5,0,14,49
20359,13,4,6,1,2,11
20360,46,18,20,0,8,38
20361,55,24,13,6,12,43
20362,71,50,7,1,13,58
20363,168,85,37,7,39,129
20364,653,381,145,15,112,541
20365,83,39,29,1,14,69
20366,87,27,19,21,20,67
20367,5,3,1,0,1,4
20368,31,23,3,1,4,27
20369,53,21,19,2,11,42
20370,68,2,43,17,6,62
20371,17,7,5,0,5,12
20372,57,28,12,6,11,46
20373,19,12,2,1,4,15
20374,57,31,12,3,11,46
20375,217,98,79,1,39,178
20376,14,5,6,0,3,11
20377,74,21,38,0,15,59
20378,298,145,74,18,61,237
20379,216,144,31,0,41,175
20380,79,42,29,1,7,72
20381,140,50,45,16,29,111
20382,189,58,79,14,38,151
20383,33,5,12,5,11,22
20384,227,169,6,2,50,177
20385,69,38,10,8,13,56
20386,593,340,123,19,111,482
20387,76,38,13,5,20,56
20388,50,11,24,1,14,36
20389,45,8,25,4,8,37
20390,27,13,7,3,4,23
20391,67,13,31,10,13,54
20392,57,17,21,10,9,48
20393,47,13,24,0,10,37
20394,87,32,36,1,18,69
20395,1,0,1,0,0,1
20396,50,6,36,0,8,42
20397,236,55,24,118,39,197
20398,60,37,7,6,10,50
20399,98,36,20,12,30,68
20400,91,41,30,3,17,74
20401,84,38,25,3,18,66
20402,19,4,12,0,3,16
20403,55,7,38,1,9,46
20404,37,21,6,2,8,29
20405,104,52,32,0,20,84
20406,79,36,29,4,10,69
20407,92,38,33,8,13,79
20408,43,9,20,0,14,29
20409,116,48,29,17,22,94
20410,56,34,13,2,7,49
20411,137,50,50,14,23,114
20412,35,17,12,0,6,29
20413,32,10,17,0,5,27
20414,88,21,40,3,24,64
20415,30,6,15,1,8,22
20416,73,22,27,7,17,56
20417,71,37,8,10,16,55
20418,33,25,4,4,0,33
20419,336,140,119,6,71,265
20420,5,0,3,0,2,3
20421,222,121,64,0,37,185
20422,0,0,0,0,0,0
20423,113,68,20,1,24,89
20424,27,2,11,7,7,20
20425,178,139,6,0,33,145
20426,48,25,9,0,14,34
20427,29,6,20,0,3,26
20428,27,6,10,2,9,18
20429,41,13,13,6,9,32
20430,31,4,21,0,6,25
20431,679,406,133,23,117,562
20432,60,33,13,1,13,47
20433,9,6,2,1,0,9
20434,286,131,94,4,57,229
20435,39,9,25,0,5,34
20436,30,9,16,1,4,26
20437,22,2,16,0,4,18
20438,46,18,20,0,8,38
20439,115,44,41,9,21,94
20440,5,2,3,0,0,5
20441,16,1,9,0,6,10
20442,296,172,54,13,57,239
20443,139,80,22,3,34,105
20444,53,21,15,6,11,42
20445,66,34,15,0,17,49
20446,247,188,13,0,46,201
20447,44,31,4,0,9,35
20448,52,3,41,1,7,45
20449,40,19,14,0,7,33
20450,64,32,21,0,11,53
20451,29,6,16,0,7,22
20452,105,58,8,19,20,85
20453,12,0,11,0,1,11
20454,180,92,51,0,37,143
20455,437,233,109,20,75,362
20456,157,100,3,17,37,120
20457,112,30,52,6,24,88
20458,34,2,23,0,9,25
20459,104,49,35,3,17,87
20460,56,3,40,1,12,44
20461,15,9,0,0,6,9
20462,140,65,42,10,23,117
20463,296,183,48,0,65,231
20464,72,24,19,9,20,52
20465,27,1,22,0,4,23
20466,96,30,23,24,19,77
20467,31,0,27,1,3,28
20468,602,344,114,13,131,471
20469,178,67,50,32,29,149
20470,83,24,44,2,13,70
20471,71,56,1,0,14,57
20472,77,39,19,0,19,58
20473,27,14,5,5,3,24
20474,5,0,4,0,1,4
20475,150,116,2,2,30,120
20476,47,11,29,0,7,40
20477,50,20,12,5,13,37
20478,35,5,20,0,10,25
20479,31,17,5,1,8,23
20480,99,95,0,4,0,99
20481,2,1,1,0,0,2
20482,9,3,4,0,2,7
20483,92,39,29,3,21,71
20484,109,59,24,4,22,87
20485,52,16,24,0,12,40
20486,13,5,5,0,3,10
20487,87,32,41,2,12,75
20488,108,43,38,5,22,86
20489,350,193,87,15,55,295
20490,62,25,28,1,8,54
20491,54,15,30,1,8,46
20492,25,6,13,0,6,19
20493,96,38,28,9,21,75
20494,222,119,67,0,36,186
20495,15,1,10,0,4,11
20496,67,15,35,7,10,57
20497,414,163,132,26,93,321
20498,22,5,8,1,8,14
20499,111,74,15,1,21,90
20500,56,20,24,0,12,44
20501,89,64,5,1,19,70
20502,244,51,144,2,47,197
20503,19,3,15,0,1,18
20504,27,9,13,1,4,23
20505,113,54,16,15,28,85
20506,12,0,10,0,2,10
20507,90,40,36,0,14,76
20508,214,117,33,22,42,172
20509,58,30,15,0,13,45
20510,126,39,39,15,33,93
20511,13,8,0,0,5,8
20512,158,68,54,7,29,129
20513,9,6,0,0,3,6
20514,78,49,13,8,8,70
20515,52,15,23,3,11,41
20516,58,20,20,5,13,45
20517,177,82,62,2,31,146
20518,533,250,115,54,114,419
20519,9,3,4,0,2,7
20520,61,12,29,6,14,47
20521,95,18,47,13,17,78
20522,27,10,11,2,4,23
20523,51,29,10,0,12,39
20524,2,0,1,0,1,1
20525,4,1,0,2,1,3
20526,103,25,56,3,19,84
20527,0,0,0,0,0,0
20528,45,19,16,1,9,36
20529,208,142,25,6,35,173
20530,21,5,12,0,4,17
20531,50,28,9,2,11,39
20532,649,378,140,17,114,535
20533,39,20,14,0,5,34
20534,82,17,44,0,21,61
20535,137,93,17,2,25,112
20536,176,14,126,0,36,140
20537,55,11,38,0,6,49
20538,102,36,40,11,15,87
20539,141,81,21,2,37,104
20540,53,34,7,0,12,41
20541,31,17,10,2,2,29
20542,142,51,35,20,36,106
20543,54,8,31,5,10,44
20544,66,37,17,0,12,54
20545,100,61,17,6,16,84
20546,55,14,27,0,14,41
20547,125,50,37,9,29,96
20548,19,0,6,10,3,16
20549,45,19,14,3,9,36
20550,6,0,4,0,2,4
20551,148,68,41,4,35,113
20552,22,3,9,1,9,13
20553,242,130,35,29,48,194
20554,110,34,54,1,21,89
20555,26,11,8,0,7,19
20556,74,39,22,3,10,64
20557,43,10,22,2,9,34
20558,79,17,39,5,18,61
20559,75,10,50,1,14,61
20560,347,181,94,5,67,280
20561,26,1,16,0,9,17
20562,643,370,151,17,105,538
20563,65,23,33,0,9,56
20564,58,36,3,10,9,49
20565,175,82,27,23,43,132
20566,22,8,6,5,3,19
20567,49,20,18,1,10,39
20568,25,15,5,0,5,20
20569,48,17,17,0,14,34
20570,64,16,26,12,10,54
20571,21,7,9,0,5,16
20572,146,50,39,30,27,119
20573,51,14,24,2,11,40
20574,106,49,34,4,19,87
20575,66,46,8,0,12,54
20576,180,101,33,0,46,134
20577,27,14,8,0,5,22
20578,36,16,8,5,7,29
20579,77,37,31,1,8,69
20580,50,9,29,0,12,38
20581,46,18,5,13,10,36
20582,139,54,47,14,24,115
20583,150,64,42,20,24,126
20584,25,19,2,0,4,21
20585,72,39,16,0,17,55
20586,132,58,47,1,26,106
20587,310,171,89,0,50,260
20588,21,6,1,7,7,14
20589,33,8,17,0,8,25
20590,97,16,54,7,20,77
20591,61,23,25,1,12,49
20592,70,37,17,4,12,58
20593,90,27,40,5,18,72
20594,38,17,6,2,13,25
20595,16,4,8,0,4,12
20596,21,13,1,3,4,17
20597,37,18,13,0,6,31
20598,6,1,3,0,2,4
20599,44,18,10,5,11,33
20600,46,18,20,0,8,38
20601,28,7,16,1,4,24
20602,76,32,8,20,16,60
20603,50,30,6,0,14,36
20604,328,197,59,0,72,256
20605,106,63,20,6,17,89
20606,117,93,7,2,15,102
20607,66,24,25,4,13,53
20608,31,7,12,5,7,24
20609,17,6,5,1,5,12
20610,542,315,109,17,101,441
20611,24,4,12,2,6,18
20612,134,71,28,1,34,100
20613,42,19,14,1,8,34
20614,7,2,2,0,3,4
20615,85,57,8,0,20,65
20616,52,15,21,7,9,43
20617,24,8,6,1,9,15
20618,87,55,17,0,15,72
20619,168,74,54,7,33,135
20620,15,7,3,3,2,13
20621,171,58,56,25,32,139
20622,167,121,14,2,30,137
20623,25,17,1,0,7,18
20624,46,18,20,0,8,38
20625,110,44,23,18,25,85
20626,27,1,21,1,4,23
20627,141,41,44,22,34,107
20628,62,12,39,1,10,52
20629,82,49,15,2,16,66
20630,51,15,26,3,7,44
20631,46,18,20,0,8,38
20632,22,7,14,0,1,21
20633,280,94,126,16,44,236
20634,54,38,3,4,9,45
20635,32,21,9,0,2,30
20636,30,1,25,0,4,26
20637,59,40,13,6,0,59
20638,76,4,54,0,18,58
20639,17,5,4,5,3,14
20640,2,0,2,0,0,2
20641,29,4,17,2,6,23
20642,283,97,126,16,44,239
20643,28,10,10,2,6,22
20644,8,4,2,0,2,6
20645,54,17,25,6,6,48
20646,417,238,77,15,87,330
20647,91,53,17,0,21,70
20648,126,41,35,27,23,103
20649,37,9,20,4,4,33
20650,381,169,132,9,71,310
20651,53,24,19,2,8,45
20652,195,49,101,5,40,155
20653,148,98,27,1,22,126
20654,156,45,80,0,31,125
20655,38,10,19,0,9,29
20656,95,25,54,2,14,81
20657,56,7,33,1,15,41
20658,57,36,6,0,15,42
20659,308,81,167,4,56,252
20660,143,28,49,25,41,102
20661,25,4,10,5,6,19
20662,90,32,40,3,15,75
20663,140,33,48,30,29,111
20664,117,98,4,0,15,102
20665,105,55,23,1,26,79
20666,58,10,33,4,11,47
20667,24,11,11,0,2,22
20668,184,124,11,10,39,145
20669,163,68,36,27,32,131
20670,223,74,85,15,49,174
20671,59,27,21,0,11,48
20672,39,23,8,0,8,31
20673,51,9,29,0,13,38
20674,48,34,2,3,9,39
20675,63,42,9,2,10,53
20676,199,105,61,0,33,166
20677,42,10,27,0,5,37
20678,19,12,4,0,3,16
20679,588,427,40,1,120,468
20680,183,47,22,83,31,152
20681,8,6,0,0,2,6
20682,204,97,61,1,45,159
20683,93,31,44,2,16,77
20684,82,15,46,3,18,64
20685,202,30,93,33,46,156
20686,11,3,4,0,4,7
20687,39,27,6,1,5,34
20688,139,94,19,1,25,114
20689,21,18,1,0,2,19
20690,54,14,26,0,14,40
20691,27,10,11,2,4,23
20692,399,123,164,29,83,316
20693,122,68,26,6,22,100
20694,63,37,11,1,14,49
20695,57,10,24,7,16,41
20696,69,26,17,10,16,53
20697,73,15,43,1,14,59
20698,124,36,63,4,21,103
20699,76,20,39,1,16,60
20700,33,16,10,0,7,26
20701,234,118,67,0,49,185
20702,21,7,7,0,7,14
20703,35,25,2,0,8,27
20704,338,140,122,6,70,268
20705,25,5,15,0,5,20
20706,28,19,2,0,7,21
20707,37,11,14,0,12,25
20708,139,58,45,8,28,111
20709,149,92,29,3,25,124
20710,163,125,7,0,31,132
20711,32,21,9,0,2,30
20712,84,40,17,12,15,69
20713,107,53,30,5,19,88
20714,42,8,19,0,15,27
20715,145,28,89,1,27,118
20716,41,7,16,7,11,30
20717,145,81,27,1,36,109
20718,21,13,5,0,3,18
20719,31,9,12,0,10,21
20720,229,125,68,0,36,193
20721,76,38,8,3,27,49
20722,77,24,32,9,12,65
20723,52,38,2,0,12,40
20724,16,6,8,0,2,14
20725,34,15,12,1,6,28
20726,326,165,91,5,65,261
20727,108,86,7,2,13,95
20728,32,21,9,0,2,30
20729,40,10,17,4,9,31
20730,161,68,45,11,37,124
20731,94,54,17,7,16,78
20732,49,31,13,2,3,46
20733,56,35,14,0,7,49
20734,35,13,11,3,8,27
20735,47,33,4,0,10,37
20736,38,9,18,1,10,28
20737,53,30,7,0,16,37
20738,79,20,25,21,13,66
20739,75,53,11,0,11,64
20740,5,3,2,0,0,5
20741,202,89,55,20,38,164
20742,52,20,21,0,11,41
20743,128,32,9,63,24,104
20744,47,33,4,0,10,37
20745,97,42,22,10,23,74
20746,81,56,8,3,14,67
20747,64,33,22,0,9,55
20748,7,3,2,1,1,6
20749,27,8,16,1,2,25
20750,15,2,2,9,2,13
20751,10,2,6,0,2,8
20752,125,42,46,13,24,101
20753,32,15,7,1,9,23
20754,133,61,45,1,26,107
20755,23,4,15,1,3,20
20756,42,18,18,0,6,36
20757,14,5,7,0,2,12
20758,69,43,13,1,12,57
20759,84,35,12,17,20,64
20760,42,25,12,0,5,37
20761,147,37,75,1,34,113
20762,65,18,26,6,15,50
20763,13,7,3,1,2,11
20764,14,10,0,0,4,10
20765,8,3,4,0,1,7
20766,68,14,29,10,15,53
20767,98,50,24,4,20,78
20768,520,366,43,1,110,410
20769,26,16,6,1,3,23
20770,62,34,17,1,10,52
20771,12,0,10,0,2,10
20772,655,385,139,17,114,541
20773,80,53,6,0,21,59
20774,84,37,31,0,16,68
20775,58,31,12,0,15,43
20776,24,13,4,1,6,18
20777,155,71,49,5,30,125
20778,185,58,75,14,38,147
20779,147,53,67,0,27,120
20780,443,203,141,12,87,356
20781,62,20,28,6,8,54
20782,139,52,51,15,21,118
20783,474,220,155,13,86,388
20784,233,155,32,0,46,187
20785,25,5,1,15,4,21
20786,111,55,36,0,20,91
20787,36,13,14,0,9,27
20788,26,1,19,1,5,21
20789,5,2,2,0,1,4
20790,98,39,22,18,19,79
20791,40,8,17,0,15,25
20792,102,37,26,20,19,83
20793,278,156,35,32,55,223
20794,42,9,22,0,11,31
20795,28,6,17,0,5,23
20796,17,2,9,1,5,12
20797,71,42,21,1,7,64
20798,88,52,21,2,13,75
20799,64,27,24,0,13,51
20800,419,197,136,11,75,344
20801,72,48,7,0,17,55
20802,71,53,7,4,7,64
20803,107,86,4,2,15,92
20804,235,56,24,117,38,197
20805,49,27,9,2,11,38
20806,133,86,16,4,27,106
20807,88,45,24,2,17,71
20808,127,37,49,11,30,97
20809,102,85,3,2,12,90
20810,190,109,24,22,35,155
20811,23,7,11,1,4,19
20812,104,34,55,0,15,89
20813,3,1,0,0,2,1
20814,11,1,8,0,2,9
20815,14,8,0,0,6,8
20816,52,41,1,0,10,42
20817,14,3,7,1,3,11
20818,32,4,17,5,6,26
20819,31,20,3,0,8,23
20820,33,3,22,0,8,25
20821,3,0,3,0,0,3
20822,16,6,7,0,3,13
20823,21,9,6,2,4,17
20824,27,5,14,4,4,23
20825,38,9,5,17,7,31
20826,122,37,51,7,27,95
20827,64,29,24,0,11,53
20828,168,43,17,79,29,139
20829,277,175,76,4,22,255
20830,49,17,11,4,17,32
20831,34,7,15,1,11,23
20832,173,52,88,0,33,140
20833,63,27,22,0,14,49
20834,35,22,6,2,5,30
20835,318,169,81,15,53,265
20836,55,24,13,6,12,43
20837,114,29,50,16,19,95
20838,41,22,10,0,9,32
20839,18,5,10,0,3,15
20840,204,53,38,78,35,169
20841,48,29,6,0,13,35
20842,118,51,26,15,26,92
20843,36,16,9,2,9,27
20844,50,25,20,0,5,45
20845,114,24,50,14,26,88
20846,162,68,35,20,39,123
20847,43,18,12,2,11,32
20848,36,1,30,0,5,31
20849,86,41,22,1,22,64
20850,251,152,10,31,58,193
20851,46,26,17,0,3,43
20852,19,3,0,8,8,11
20853,52,24,8,12,8,44
20854,54,12,22,7,13,41
20855,94,26,21,27,20,74
20856,34,10,14,2,8,26
20857,330,248,19,2,61,269
20858,679,392,144,21,122,557
20859,46,29,4,7,6,40
20860,76,33,16,13,14,62
20861,158,106,31,13,8,150
20862,107,48,26,4,29,78
20863,32,21,9,0,2,30
20864,72,45,17,9,1,71
20865,312,236,19,0,57,255
20866,31,12,13,2,4,27
20867,63,37,7,9,10,53
20868,84,38,25,0,21,63
20869,173,58,83,0,32,141
20870,184,73,27,53,31,153
20871,12,5,4,3,0,12
20872,151,24,98,1,28,123
20873,12,1,4,1,6,6
20874,62,49,2,0,11,51
20875,61,18,24,6,13,48
20876,64,52,0,1,11,53
20877,133,55,50,2,26,107
20878,81,43,18,0,20,61
20879,31,4,9,10,8,23
20880,63,34,10,5,14,49
20881,130,27,47,30,26,104
20882,27,3,18,0,6,21
20883,147,61,31,26,29,118
20884,31,9,19,0,3,28
20885,25,4,15,0,6,19
20886,63,36,13,0,14,49
20887,478,183,146,46,103,375
20888,43,5,29,0,9,34
20889,32,21,9,0,2,30
20890,26,4,17,0,5,21
20891,125,44,39,16,26,99
20892,24,21,0,0,3,21
20893,94,38,29,11,16,78
20894,9,6,2,1,0,9
20895,136,80,28,0,28,108
20896,62,41,11,1,9,53
20897,69,19,29,2,19,50
20898,89,41,27,7,14,75
20899,57,18,18,8,13,44
20900,5,3,1,0,1,4
20901,285,25,201,2,57,228
20902,11,2,9,0,0,11
20903,37,7,9,16,5,32
20904,41,28,5,0,8,33
20905,114,45,30,14,25,89
20906,42,13,15,2,12,30
20907,59,19,15,13,12,47
20908,28,21,2,0,5,23
20909,8,6,2,0,0,8
20910,15,11,3,1,0,15
20911,19,9,5,1,4,15
20912,38,7,10,16,5,33
20913,83,43,19,9,12,71
20914,57,43,1,0,13,44
20915,35,13,0,14,8,27
20916,51,11,24,2,14,37
20917,38,2,31,0,5,33
20918,52,36,4,1,11,41
20919,23,9,8,0,6,17
20920,82,20,43,7,12,70
20921,90,26,40,10,14,76
20922,32,21,9,0,2,30
20923,95,31,37,10,17,78
20924,109,59,24,4,22,87
20925,56,38,11,5,2,54
20926,376,212,75,12,77,299
20927,262,59,140,7,56,206
20928,278,114,105,14,45,233
20929,29,10,8,1,10,19
20930,15,6,2,3,4,11
20931,32,21,9,0,2,30
20932,603,415,58,1,129,474
20933,461,229,115,19,98,363
20934,69,24,32,1,12,57
20935,36,2,24,0,10,26
20936,80,16,39,10,15,65
20937,62,34,18,0,10,52
20938,276,85,130,17,44,232
20939,53,30,13,0,10,43
20940,131,65,28,6,32,99
20941,84,19,46,2,17,67
20942,463,257,69,38,99,364
20943,276,147,64,15,50,226
20944,193,93,61,0,39,154
20945,8,2,2,1,3,5
20946,60,23,29,0,8,52
20947,130,36,60,7,27,103
20948,106,57,22,7,20,86
20949,188,91,46,10,41,147
20950,80,23,34,6,17,63
20951,68,23,30,1,14,54
20952,15,2,5,4,4,11
20953,49,23,12,2,12,37
20954,246,121,58,18,49,197
20955,212,84,37,41,50,162
20956,71,28,28,3,12,59
20957,664,388,142,17,117,547
20958,46,20,15,2,9,37
20959,19,3,14,0,2,17
20960,146,72,19,25,30,116
20961,5,2,2,0,1,4
20962,110,49,29,12,20,90
20963,30,5,21,2,2,28
20964,62,15,24,8,15,47
20965,35,6,17,3,9,26
20966,82,41,10,18,13,69
20967,49,32,6,2,9,40
20968,64,30,21,0,13,51
20969,45,15,18,0,12,33
20970,43,24,12,0,7,36
20971,139,105,6,0,28,111
20972,12,1,9,0,2,10
20973,337,140,120,6,71,266
20974,11,1,6,0,4,7
20975,227,100,44,27,56,171
20976,250,129,84,0,37,213
20977,158,62,41,25,30,128
20978,195,95,32,33,35,160
20979,125,51,39,14,21,104
20980,26,2,15,6,3,23
20981,174,87,39,9,39,135
20982,47,34,7,0,6,41
20983,49,16,10,17,6,43
20984,39,3,26,2,8,31
20985,86,60,5,0,21,65
20986,84,43,27,0,14,70
20987,247,138,56,0,53,194
20988,37,20,13,0,4,33
20989,31,3,22,0,6,25
20990,32,14,7,3,8,24
20991,556,399,35,1,121,435
20992,159,108,26,0,25,134
20993,82,41,23,2,16,66
20994,260,70,109,19,62,198
20995,32,14,12,0,6,26
20996,36,10,13,6,7,29
20997,38,17,8,4,9,29
20998,160,71,53,5,31,129
20999,95,30,38,9,18,77
21000,64,18,30,1,15,49
21001,99,53,28,0,18,81
21002,29,2,21,0,6,23
21003,135,95,10,0,30,105
21004,160,114,11,0,35,125
21005,55,16,25,0,14,41
21006,145,68,42,5,30,115
21007,24,8,0,8,8,16
21008,529,239,128,47,115,414
21009,201,80,84,3,34,167
21010,109,83,5,0,21,88
21011,30,12,15,0,3,27
21012,35,14,15,0,6,29
21013,56,40,6,1,9,47
21014,61,20,17,8,16,45
21015,45,21,15,0,9,36
21016,420,206,106,18,90,330
21017,168,31,104,1,32,136
21018,106,71,11,1,23,83
21019,25,3,13,1,8,17
21020,81,22,48,0,11,70
21021,110,45,14,17,34,76
21022,591,339,122,19,111,480
21023,62,23,20,1,18,44
21024,114,44,38,8,24,90
21025,19,4,7,1,7,12
21026,47,7,34,0,6,41
21027,26,4,19,0,3,23
21028,0,0,0,0,0,0
21029,59,28,17,4,10,49
21030,139,27,47,26,39,100
21031,67,35,15,1,16,51
21032,11,0,6,0,5,6
21033,39,23,10,0,6,33
21034,46,18,20,0,8,38
21035,42,24,11,0,7,35
21036,33,5,16,1,11,22
21037,26,17,3,0,6,20
21038,449,330,20,0,99,350
21039,182,99,52,0,31,151
21040,73,24,21,10,18,55
21041,12,11,0,0,1,11
21042,32,7,18,3,4,28
21043,99,60,22,5,12,87
21044,31,18,8,0,5,26
21045,228,153,34,0,41,187
21046,114,24,56,14,20,94
21047,35,21,6,1,7,28
21048,184,38,49,63,34,150
21049,93,61,15,0,17,76
21050,29,4,15,5,5,24
21051,37,14,11,0,12,25
21052,122,83,12,2,25,97
21053,87,45,13,9,20,67
21054,68,22,27,3,16,52
21055,39,1,8,23,7,32
21056,46,18,20,0,8,38
21057,116,59,33,0,24,92
21058,196,44,49,66,37,159
21059,32,21,9,0,2,30
21060,263,148,34,32,49,214
21061,131,57,45,0,29,102
21062,46,18,20,0,8,38
21063,16,12,2,0,2,14
21064,38,22,11,5,0,38
21065,35,14,14,1,6,29
21066,2,1,1,0,0,2
21067,420,239,90,12,79,341
21068,81,28,32,8,13,68
21069,67,34,11,6,16,51
21070,27,8,13,2,4,23
21071,80,36,24,3,17,63
21072,77,43,11,5,18,59
21073,25,8,11,2,4,21
21074,43,19,8,3,13,30
21075,28,13,9,0,6,22
21076,37,15,6,6,10,27
21077,76,43,11,0,22,54
21078,20,3,9,1,7,13
21079,31,12,14,0,5,26
21080,142,41,44,22,35,107
21081,79,21,42,2,14,65
21082,61,20,22,5,14,47
21083,250,188,13,0,49,201
21084,103,86,3,3,11,92
21085,25,3,12,0,10,15
21086,349,183,93,14,59,290
21087,131,41,60,4,26,105
21088,126,69,34,13,10,116
21089,118,54,30,13,21,97
21090,43,7,22,1,13,30
21091,27,10,11,2,4,23
21092,64,42,4,0,18,46
21093,82,22,32,0,28,54
21094,46,18,20,0,8,38
21095,510,272,88,44,106,404
21096,128,48,44,8,28,100
21097,68,44,12,0,12,56
21098,31,9,19,0,3,28
21099,36,12,14,1,9,27
21100,10,3,3,0,4,6
21101,21,12,4,0,5,16
21102,96,56,20,0,20,76
21103,15,9,2,0,4,11
21104,65,27,26,0,12,53
21105,88,29,28,8,23,65
21106,287,64,167,1,55,232
21107,203,117,45,6,35,168
21108,31,14,6,4,7,24
21109,35,18,12,0,5,30
21110,52,36,5,5,6,46
21111,60,33,4,12,11,49
21112,25,3,17,1,4,21
21113,75,9,42,5,19,56
21114,85,44,23,4,14,71
21115,25,5,10,3,7,18
21116,44,9,21,0,14,30
21117,138,62,41,12,23,115
21118,69,41,11,4,13,56
21119,49,27,14,0,8,41
21120,52,38,4,0,10,42
21121,48,16,11,8,13,35
21122,472,219,155,11,87,385
21123,65,22,29,5,9,56
21124,30,22,3,1,4,26
21125,23,9,6,0,8,15
21126,178,76,27,31,44,134
21127,141,48,37,30,26,115
21128,28,15,8,1,4,24
21129,139,46,54,8,31,108
21130,66,11,40,0,15,51
21131,81,23,39,11,8,73
21132,52,16,24,1,11,41
21133,41,24,8,0,9,32
21134,38,13,15,4,6,32
21135,146,65,44,0,37,109
21136,94,63,7,4,20,74
21137,44,28,7,3,6,38
21138,22,0,19,0,3,19
21139,29,14,8,4,3,26
21140,348,181,90,18,59,289
21141,38,0,33,0,5,33
21142,102,25,55,3,19,83
21143,124,67,37,1,19,105
21144,25,9,10,2,4,21
21145,119,52,25,14,28,91
21146,102,22,42,14,24,78
21147,16,11,3,0,2,14
21148,28,12,7,0,9,19
21149,211,139,23,0,49,162
21150,9,6,2,1,0,9
21151,34,15,10,1,8,26
21152,134,50,39,16,29,105
21153,242,179,11,1,51,191
21154,15,5,7,0,3,12
21155,58,37,7,0,14,44
21156,41,15,12,5,9,32
21157,25,17,1,0,7,18
21158,40,22,7,4,7,33
21159,427,194,137,11,85,342
21160,5,1,4,0,0,5
21161,104,42,41,1,20,84
21162,123,60,27,14,22,101
21163,107,37,35,15,20,87
21164,7,2,4,0,1,6
21165,213,55,114,5,39,174
21166,26,13,7,0,6,20
21167,313,163,84,15,51,262
21168,117,35,42,15,25,92
21169,80,32,15,14,19,61
21170,38,16,2,9,11,27
21171,17,0,12,0,5,12
21172,19,4,13,1,1,18
21173,42,22,4,7,9,33
21174,4,2,1,0,1,3
21175,27,13,7,0,7,20
21176,42,25,8,3,6,36
21177,66,30,23,3,10,56
21178,228,114,38,36,40,188
21179,463,221,142,13,87,376
21180,97,41,34,4,18,79
21181,2,1,0,0,1,1
21182,72,22,31,2,17,55
21183,33,17,8,3,5,28
21184,286,49,182,2,53,233
21185,32,21,9,0,2,30
21186,69,33,18,0,18,51
21187,156,45,59,21,31,125
21188,96,54,20,6,16,80
21189,58,21,20,5,12,46
21190,52,34,7,0,11,41
21191,391,156,126,22,87,304
21192,107,37,26,24,20,87
21193,165,69,34,23,39,126
21194,69,29,23,2,15,54
21195,50,33,8,1,8,42
21196,25,21,2,0,2,23
21197,342,200,69,0,73,269
21198,58,27,18,0,13,45
21199,91,41,31,0,19,72
21200,28,8,18,0,2,26
21201,52,15,29,1,7,45
21202,635,369,143,16,107,528
21203,165,44,94,4,23,142
21204,129,44,49,11,25,104
21205,18,3,13,0,2,16
21206,32,21,9,0,2,30
21207,84,25,38,5,16,68
21208,58,31,6,8,13,45
21209,202,88,56,20,38,164
21210,457,159,155,46,97,360
21211,12,2,8,0,2,10
21212,39,15,14,2,8,31
21213,279,175,41,0,63,216
21214,41,21,11,0,9,32
21215,646,361,159,24,102,544
21216,54,21,21,1,11,43
21217,110,30,62,0,18,92
21218,24,3,19,0,2,22
21219,66,37,12,2,15,51
21220,85,43,23,4,15,70
21221,256,133,79,0,44,212
21222,47,30,10,0,7,40
21223,228,58,118,4,48,180
21224,13,8,3,1,1,12
21225,19,4,6,4,5,14
21226,31,12,15,0,4,27
21227,29,7,15,3,4,25
21228,145,88,29,4,24,121
21229,265,22,195,2,46,219
21230,43,12,20,0,11,32
21231,40,25,8,0,7,33
21232,37,15,13,1,8,29
21233,98,60,8,8,22,76
21234,66,17,32,2,15,51
21235,9,4,3,1,1,8
21236,90,67,16,2,5,85
21237,219,148,30,0,41,178
21238,63,16,31,4,12,51
21239,18,0,14,0,4,14
21240,40,7,20,4,9,31
21241,159,66,56,8,29,130
21242,403,228,93,0,82,321
21243,58,11,33,4,10,48
21244,23,11,9,2,1,22
21245,88,50,24,10,4,84
21246,18,5,12,0,1,17
21247,14,2,8,2,2,12
21248,147,76,30,6,35,112
21249,397,177,100,36,84,313
21250,36,13,18,0,5,31
21251,127,29,43,30,25,102
21252,20,10,7,0,3,17
21253,25,14,0,5,6,19
21254,366,207,83,0,76,290
21255,664,393,137,19,115,549
21256,34,1,26,1,6,28
21257,86,35,16,15,20,66
21258,32,21,9,0,2,30
21259,49,20,12,6,11,38
21260,45,32,3,0,10,35
21261,75,15,53,2,5,70
21262,36,10,12,5,9,27
21263,75,61,4,0,10,65
21264,27,12,14,0,1,26
21265,18,10,5,0,3,15
21266,19,15,2,0,2,17
21267,97,49,29,1,18,79
21268,382,177,127,5,73,309
21269,39,1,19,13,6,33
21270,32,21,9,0,2,30
21271,111,32,57,0,22,89
21272,153,51,48,19,35,118
21273,32,21,9,0,2,30
21274,71,38,10,10,13,58
21275,360,155,126,11,68,292
21276,42,10,22,0,10,32
21277,147,90,28,0,29,118
21278,42,26,11,0,5,37
21279,2,1,0,0,1,1
21280,37,8,19,0,10,27
21281,65,36,12,2,15,50
21282,103,33,51,7,12,91
21283,2,1,0,0,1,1
21284,109,53,35,0,21,88
21285,32,21,9,0,2,30
21286,132,59,25,18,30,102
21287,93,31,36,6,20,73
21288,18,2,12,0,4,14
21289,40,31,5,0,4,36
21290,70,34,22,1,13,57
21291,60,32,7,4,17,43
21292,663,387,142,17,117,546
21293,31,19,3,0,9,22
21294,21,14,2,0,5,16
21295,108,31,55,4,18,90
21296,286,37,196,2,51,235
21297,68,16,26,10,16,52
21298,278,64,159,1,54,224
21299,74,36,26,0,12,62
21300,151,57,39,21,34,117
21301,59,32,10,0,17,42
21302,94,60,23,0,11,83
21303,63,11,37,0,15,48
21304,102,54,28,4,16,86
21305,112,76,15,1,20,92
21306,28,19,5,4,0,28
21307,222,74,82,15,51,171
21308,46,18,20,0,8,38
21309,68,44,12,0,12,56
21310,96,29,42,6,19,77
21311,25,4,1,16,4,21
21312,29,8,13,2,6,23
21313,227,88,14,81,44,183
21314,129,62,45,1,21,108
21315,31,15,6,1,9,22
21316,54,25,18,1,10,44
21317,120,53,22,17,28,92
21318,19,13,3,0,3,16
21319,32,16,2,6,8,24
21320,25,8,11,0,6,19
21321,3,0,0,1,2,1
21322,95,49,27,1,18,77
21323,223,113,37,34,39,184
21324,26,12,12,1,1,25
21325,81,39,28,4,10,71
21326,148,115,7,3,23,125
21327,34,16,8,3,7,27
21328,28,13,8,0,7,21
21329,78,19,36,2,21,57
21330,47,17,20,0,10,37
21331,22,9,8,0,5,17
21332,45,25,14,0,6,39
21333,76,29,35,1,11,65
21334,5,1,4,0,0,5
21335,369,281,20,0,68,301
21336,199,100,50,0,49,150
21337,175,130,7,10,28,147
21338,46,18,20,0,8,38
21339,13,3,7,0,3,10
21340,26,12,6,1,7,19
21341,133,58,51,1,23,110
21342,577,413,45,1,118,459
21343,71,40,16,1,14,57
21344,46,18,20,0,8,38
21345,77,24,32,9,12,65
21346,40,21,8,2,9,31
21347,41,15,13,5,8,33
21348,31,12,14,1,4,27
21349,48,23,5,5,15,33
21350,27,11,10,0,6,21
21351,19,6,7,4,2,17
21352,109,57,23,4,25,84
21353,126,62,21,15,28,98
21354,40,18,9,5,8,32
21355,161,126,7,0,28,133
21356,78,46,19,6,7,71
21357,90,37,27,0,26,64
21358,47,13,24,0,10,37
21359,9,1,6,0,2,7
21360,132,102,11,0,19,113
21361,8,6,2,0,0,8
21362,92,25,44,8,15,77
21363,126,71,31,10,14,112
21364,16,7,7,0,2,14
21365,46,21,15,0,10,36
21366,10,3,4,0,3,7
21367,16,8,4,0,4,12
21368,72,24,20,11,17,55
21369,233,148,29,3,53,180
21370,186,126,18,0,42,144
21371,80,45,18,1,16,64
21372,124,50,39,21,14,110
21373,55,12,29,2,12,43
21374,141,107,4,2,28,113
21375,60,22,29,0,9,51
21376,115,84,7,0,24,91
21377,153,100,3,16,34,119
21378,52,41,1,0,10,42
21379,36,10,15,2,9,27
21380,51,27,11,0,13,38
21381,453,244,107,14,88,365
21382,79,51,10,4,14,65
21383,381,168,94,41,78,303
21384,127,74,22,3,28,99
21385,51,32,12,0,7,44
21386,117,51,45,5,16,101
21387,343,147,120,6,70,273
21388,12,8,2,1,1,11
21389,42,11,12,9,10,32
21390,39,14,20,1,4,35
21391,373,213,85,15,60,313
21392,47,13,24,0,10,37
21393,403,229,91,0,83,320
21394,206,110,62,0,34,172
21395,4,0,3,1,0,4
21396,32,12,12,1,7,25
21397,58,26,23,2,7,51
21398,79,25,27,14,13,66
21399,31,8,18,1,4,27
21400,131,66,28,10,27,104
21401,13,3,7,1,2,11
21402,94,37,28,1,28,66
21403,17,7,5,0,5,12
21404,21,7,10,0,4,17
21405,37,22,5,2,8,29
21406,219,61,107,14,37,182
21407,13,4,6,0,3,10
21408,38,11,18,1,8,30
21409,95,60,15,0,20,75
21410,266,196,15,0,55,211
21411,78,39,20,0,19,59
21412,5,1,2,0,2,3
21413,8,4,1,0,3,5
21414,115,30,43,15,27,88
21415,69,55,0,2,12,57
21416,114,45,39,3,27,87
21417,501,264,92,45,100,401
21418,39,8,25,4,2,37
21419,37,13,14,1,9,28
21420,81,30,33,6,12,69
21421,60,27,15,7,11,49
21422,438,161,139,43,95,343
21423,536,315,117,14,90,446
21424,26,7,14,0,5,21
21425,74,31,28,1,14,60
21426,235,178,17,2,38,197
21427,50,18,18,1,13,37
21428,39,26,5,1,7,32
21429,357,195,87,15,60,297
21430,216,109,68,6,33,183
21431,36,6,20,2,8,28
21432,83,38,24,0,21,62
21433,143,36,73,1,33,110
21434,32,21,9,0,2,30
21435,41,30,6,0,5,36
21436,72,17,31,6,18,54
21437,57,28,15,5,9,48
21438,78,38,21,4,15,63
21439,40,12,22,0,6,34
21440,110,42,37,10,21,89
21441,23,5,12,0,6,17
21442,119,96,3,3,17,102
21443,165,99,36,1,29,136
21444,7,1,5,0,1,6
21445,13,10,1,0,2,11
21446,79,26,41,0,12,67
21447,109,58,25,4,22,87
21448,466,343,22,0,101,365
21449,19,3,15,0,1,18
21450,36,8,24,0,4,32
21451,135,92,18,1,24,111
21452,286,84,136,4,62,224
21453,33,16,10,0,7,26
21454,60,13,41,1,5,55
21455,190,72,63,7,48,142
21456,79,7,54,5,13,66
21457,23,5,12,0,6,17
21458,29,14,6,4,5,24
21459,29,1,23,2,3,26
21460,277,21,198,2,56,221
21461,95,60,18,2,15,80
21462,45,30,7,1,7,38
21463,64,18,33,1,12,52
21464,29,14,9,1,5,24
21465,46,18,20,0,8,38
21466,363,199,91,15,58,305
21467,43,15,18,0,10,33
21468,95,58,22,10,5,90
21469,25,14,7,0,4,21
21470,126,83,24,0,19,107
21471,196,14,147,0,35,161
21472,16,3,11,0,2,14
21473,65,30,17,2,16,49
21474,43,34,1,0,8,35
21475,284,101,123,16,44,240
21476,74,62,1,0,11,63
21477,7,3,2,0,2,5
21478,104,44,24,7,29,75
21479,16,3,9,0,4,12
21480,53,27,14,1,11,42
21481,34,18,8,1,7,27
21482,220,111,36,35,38,182
21483,25,11,9,0,5,20
21484,85,38,31,0,16,69
21485,28,23,3,0,2,26
21486,56,29,12,5,10,46
21487,0,0,0,0,0,0
21488,53,4,15,25,9,44
21489,147,95,31,0,21,126
21490,83,27,30,6,20,63
21491,14,10,2,0,2,12
21492,36,20,12,0,4,32
21493,351,185,92,15,59,292
21494,99,23,54,2,20,79
21495,30,22,3,1,4,26
21496,422,313,20,0,89,333
21497,25,5,1,15,4,21
21498,11,2,4,0,5,6
21499,30,5,14,1,10,20
21500,465,246,100,13,106,359
21501,13,3,8,0,2,11
21502,140,81,22,3,34,106
21503,37,14,14,0,9,28
21504,40,18,8,6,8,32
21505,225,75,84,15,51,174
21506,61,15,37,0,9,52
21507,74,46,13,2,13,61
21508,68,11,42,0,15,53
21509,62,29,17,0,16,46
21510,53,20,24,0,9,44
21511,38,18,16,0,4,34
21512,108,29,61,0,18,90
21513,351,202,74,12,63,288
21514,100,30,51,0,19,81
21515,40,21,7,3,9,31
21516,108,48,36,5,19,89
21517,142,78,26,7,31,111
21518,136,74,42,9,11,125
21519,76,37,20,1,18,58
21520,55,33,13,0,9,46
21521,84,33,36,4,11,73
21522,138,86,16,9,27,111
21523,32,21,9,0,2,30
21524,15,3,8,0,4,11
21525,30,17,7,1,5,25
21526,473,229,150,13,81,392
21527,33,23,3,2,5,28
21528,26,8,16,0,2,24
21529,486,333,53,1,99,387
21530,93,27,38,10,18,75
21531,91,47,27,0,17,74
21532,168,82,51,3,32,136
21533,42,28,9,0,5,37
21534,99,51,29,3,16,83
21535,19,11,4,0,4,15
21536,33,15,9,0,9,24
21537,60,30,17,0,13,47
21538,37,13,0,16,8,29
21539,43,11,21,3,8,35
21540,111,47,15,16,33,78
21541,33,20,4,3,6,27
21542,149,82,20,19,28,121
21543,21,8,9,0,4,17
21544,45,29,7,3,6,39
21545,98,43,18,16,21,77
21546,204,52,38,78,36,168
21547,211,102,70,0,39,172
21548,117,82,17,9,9,108
21549,72,54,5,4,9,63
21550,78,42,18,4,14,64
21551,42,17,16,0,9,33
21552,40,15,12,6,7,33
21553,38,18,9,1,10,28
21554,22,4,13,0,5,17
21555,32,21,9,0,2,30
21556,6,2,3,0,1,5
21557,30,19,5,0,6,24
21558,14,3,9,0,2,12
21559,386,217,89,0,80,306
21560,39,7,23,2,7,32
21561,164,84,47,1,32,132
21562,56,14,33,1,8,48
21563,150,90,32,0,28,122
21564,56,9,29,4,14,42
21565,61,32,8,9,12,49
21566,63,27,24,0,12,51
21567,67,46,6,0,15,52
21568,53,26,11,3,13,40
21569,25,11,11,0,3,22
21570,224,86,97,4,37,187
21571,73,44,14,1,14,59
21572,39,9,19,0,11,28
21573,10,0,9,0,1,9
21574,78,34,20,11,13,65
21575,75,58,2,0,15,60
21576,177,121,16,0,40,137
21577,81,35,31,0,15,66
21578,260,18,192,0,50,210
21579,24,12,4,0,8,16
21580,129,40,42,21,26,103
21581,45,12,25,0,8,37
21582,152,98,3,17,34,118
21583,61,14,25,8,14,47
21584,81,62,4,4,11,70
21585,30,14,9,4,3,27
21586,31,21,7,0,3,28
21587,24,9,8,2,5,19
21588,46,18,20,0,8,38
21589,37,11,18,2,6,31
21590,400,192,109,14,85,315
21591,218,104,59,14,41,177
21592,9,1,5,1,2,7
21593,674,394,143,18,119,555
21594,96,63,12,1,20,76
21595,216,115,34,26,41,175
21596,65,32,15,0,18,47
21597,44,27,7,2,8,36
21598,20,14,4,0,2,18
21599,33,8,14,2,9,24
21600,41,16,11,3,11,30
21601,146,80,28,1,37,109
21602,190,108,24,23,35,155
21603,26,8,12,0,6,20
21604,18,8,6,0,4,14
21605,40,5,24,0,11,29
21606,120,57,24,17,22,98
21607,106,68,19,2,17,89
21608,29,20,6,3,0,29
21609,162,123,9,3,27,135
21610,94,48,28,1,17,77
21611,570,391,52,1,126,444
21612,7,2,3,0,2,5
21613,220,149,30,0,41,179
21614,110,43,39,9,19,91
21615,34,19,9,0,6,28
21616,125,81,16,4,24,101
21617,32,6,14,4,8,24
21618,16,11,1,2,2,14
21619,426,114,200,10,102,324
21620,29,4,21,0,4,25
21621,151,60,40,19,32,119
21622,103,51,32,0,20,83
21623,139,50,34,20,35,104
21624,49,38,1,0,10,39
21625,16,0,11,0,5,11
21626,56,24,22,0,10,46
21627,78,33,28,4,13,65
21628,46,18,20,0,8,38
21629,39,18,3,10,8,31
21630,33,25,3,1,4,29
21631,172,82,25,25,40,132
21632,197,90,62,0,45,152
21633,169,88,40,0,41,128
21634,49,19,19,0,11,38
21635,61,34,8,0,19,42
21636,20,2,13,0,5,15
21637,38,4,24,2,8,30
21638,230,49,40,100,41,189
21639,382,199,97,20,66,316
21640,89,55,15,3,16,73
21641,26,1,22,0,3,23
21642,71,46,9,2,14,57
21643,27,6,19,0,2,25
21644,25,14,0,5,6,19
21645,110,48,39,2,21,89
21646,13,7,5,0,1,12
21647,64,25,21,1,17,47
21648,103,53,28,0,22,81
21649,17,3,11,0,3,14
21650,40,8,24,1,7,33
21651,31,4,21,0,6,25
21652,9,6,0,1,2,7
21653,30,18,6,1,5,25
21654,126,45,46,8,27,99
21655,46,22,10,3,11,35
21656,19,9,6,0,4,15
21657,71,43,12,2,14,57
21658,249,190,13,0,46,203
21659,89,31,41,0,17,72
21660,42,27,6,0,9,33
21661,129,41,49,14,25,104
21662,76,35,20,0,21,55
21663,118,55,32,0,31,87
21664,40,8,18,5,9,31
21665,71,37,26,2,6,65
21666,83,28,42,0,13,70
21667,143,74,47,10,12,131
21668,32,0,29,1,2,30
21669,292,68,168,4,52,240
21670,32,21,9,0,2,30
21671,28,5,18,3,2,26
21672,46,17,16,4,9,37
21673,32,16,11,1,4,28
21674,39,21,6,2,10,29
21675,33,15,10,1,7,26
21676,87,56,16,0,15,72
21677,10,1,8,1,0,10
21678,127,74,22,3,28,99
21679,194,79,41,30,44,150
21680,55,9,29,4,13,42
21681,49,16,18,0,15,34
21682,659,387,143,17,112,547
21683,235,101,14,79,41,194
21684,373,209,85,0,79,294
21685,57,24,17,3,13,44
21686,178,91,42,7,38,140
21687,53,11,27,4,11,42
21688,46,18,20,0,8,38
21689,117,39,36,16,26,91
21690,7,4,2,0,1,6
21691,82,21,27,18,16,66
21692,81,33,32,4,12,69
21693,37,23,8,1,5,32
21694,27,14,10,2,1,26
21695,38,9,17,4,8,30
21696,53,30,8,3,12,41
21697,54,23,10,6,15,39
21698,56,22,25,0,9,47
21699,117,97,3,3,14,103
21700,57,29,19,1,8,49
21701,57,40,11,5,1,56
21702,56,17,31,1,7,49
21703,75,41,18,3,13,62
21704,417,219,107,20,71,346
21705,102,69,1,11,21,81
21706,29,15,7,3,4,25
21707,150,48,43,32,27,123
21708,78,42,23,0,13,65
21709,89,24,47,3,15,74
21710,404,208,95,21,80,324
21711,24,12,6,0,6,18
21712,30,10,5,8,7,23
21713,52,10,32,2,8,44
21714,10,1,4,0,5,5
21715,6,1,4,0,1,5
21716,20,9,5,4,2,18
21717,202,50,103,14,35,167
21718,39,17,19,0,3,36
21719,182,120,25,5,32,150
21720,40,30,1,2,7,33
21721,26,13,6,0,7,19
21722,186,80,67,0,39,147
21723,98,51,26,4,17,81
21724,46,18,20,0,8,38
21725,72,42,15,0,15,57
21726,51,31,10,0,10,41
21727,123,68,31,0,24,99
21728,67,5,45,4,13,54
21729,73,30,24,3,16,57
21730,11,4,4,0,3,8
21731,54,34,10,2,8,46
21732,66,30,17,4,15,51
21733,201,86,42,25,48,153
21734,98,49,26,5,18,80
21735,102,64,7,7,24,78
21736,127,39,59,4,25,102
21737,31,14,9,0,8,23
21738,20,9,2,3,6,14
21739,95,48,23,10,14,81
21740,117,41,32,26,18,99
21741,16,11,2,0,3,13
21742,245,18,180,0,47,198
21743,97,22,40,14,21,76
21744,27,14,5,0,8,19
21745,124,28,40,22,34,90
21746,75,46,15,0,14,61
21747,99,65,8,10,16,83
21748,10,2,3,2,3,7
21749,101,26,52,3,20,81
21750,38,23,4,2,9,29
21751,16,3,10,0,3,13
21752,40,12,21,0,7,33
21753,217,152,50,3,12,205
21754,138,55,44,8,31,107
21755,87,50,22,4,11,76
21756,9,3,5,0,1,8
21757,182,130,13,1,38,144
21758,30,17,5,0,8,22
21759,7,4,3,0,0,7
21760,28,5,19,0,4,24
21761,38,30,1,0,7,31
21762,50,6,30,0,14,36
21763,20,5,7,6,2,18
21764,193,40,51,64,38,155
21765,157,71,51,6,29,128
21766,31,13,14,0,4,27
21767,32,21,9,0,2,30
21768,91,57,16,0,18,73
21769,16,10,5,0,1,15
21770,146,77,32,5,32,114
21771,81,11,51,3,16,65
21772,89,63,7,0,19,70
21773,25,7,11,1,6,19
21774,21,10,4,0,7,14
21775,13,2,8,0,3,10
21776,131,46,29,26,30,101
21777,74,31,8,16,19,55
21778,50,13,25,3,9,41
21779,15,4,10,0,1,14
21780,189,48,64,32,45,144
21781,199,82,31,40,46,153
21782,236,155,35,0,46,190
21783,40,18,7,6,9,31
21784,134,68,17,18,31,103
21785,343,148,119,6,70,273
21786,32,21,9,0,2,30
21787,40,36,0,0,4,36
21788,29,8,13,0,8,21
21789,104,27,39,12,26,78
21790,61,25,22,1,13,48
21791,41,21,10,3,7,34
21792,61,34,15,0,12,49
21793,347,189,88,15,55,292
21794,20,14,0,1,5,15
21795,133,54,51,2,26,107
21796,9,4,2,0,3,6
21797,75,37,22,4,12,63
21798,67,35,11,6,15,52
21799,15,5,4,0,6,9
21800,101,28,53,0,20,81
21801,87,44,4,26,13,74
21802,193,75,34,34,50,143
21803,115,97,2,2,14,101
21804,339,181,87,15,56,283
21805,11,0,6,0,5,6
21806,63,46,1,0,16,47
21807,83,32,21,13,17,66
21808,31,11,14,2,4,27
21809,10,5,4,0,1,9
21810,50,26,6,7,11,39
21811,52,13,17,7,15,37
21812,14,3,8,0,3,11
21813,81,41,20,8,12,69
21814,62,27,23,0,12,50
21815,133,103,10,0,20,113
21816,30,22,0,0,8,22
21817,25,8,13,1,3,22
21818,36,16,10,0,10,26
21819,64,24,4,23,13,51
21820,577,329,121,16,111,466
21821,74,32,24,3,15,59
21822,95,26,48,0,21,74
21823,57,45,1,0,11,46
21824,43,16,22,0,5,38
21825,28,19,5,0,4,24
21826,220,46,125,5,44,176
21827,667,393,135,20,119,548
21828,30,18,6,2,4,26
21829,75,40,19,0,16,59
21830,46,18,20,0,8,38
21831,78,30,21,13,14,64
21832,32,21,9,0,2,30
21833,160,102,3,18,37,123
21834,29,12,13,0,4,25
21835,27,5,16,0,6,21
21836,106,100,0,6,0,106
21837,15,0,11,0,4,11
21838,28,16,6,2,4,24
21839,53,34,8,1,10,43
21840,155,51,75,0,29,126
21841,1,0,0,0,1,0
21842,28,13,4,5,6,22
21843,3,2,0,0,1,2
21844,159,57,49,23,30,129
21845,24,10,7,3,4,20
21846,110,77,14,10,9,101
21847,88,51,21,3,13,75
21848,60,36,13,3,8,52
21849,164,115,9,7,33,131
21850,121,58,24,16,23,98
21851,148,37,76,1,34,114
21852,27,12,8,0,7,20
21853,48,25,14,0,9,39
21854,32,21,9,0,2,30
21855,85,18,40,5,22,63
21856,84,47,16,1,20,64
21857,106,41,19,14,32,74
21858,133,59,50,1,23,110
21859,193,98,33,27,35,158
21860,204,58,110,4,32,172
21861,44,11,21,0,12,32
21862,7,2,2,2,1,6
21863,1090,399,441,46,204,886
21864,32,21,9,0,2,30
21865,78,13,41,7,17,61
21866,131,45,47,8,31,100
21867,23,8,12,0,3,20
21868,3,1,2,0,0,3
21869,260,171,69,2,18,242
21870,151,24,98,1,28,123
21871,529,258,117,38,116,413
21872,206,91,61,19,35,171
21873,32,21,9,0,2,30
21874,70,8,8,34,20,50
21875,86,34,37,0,15,71
21876,52,5,34,1,12,40
21877,69,37,4,13,15,54
21878,17,4,7,2,4,13
21879,141,60,53,5,23,118
21880,56,23,18,7,8,48
21881,44,9,28,0,7,37
21882,211,79,57,30,45,166
21883,132,104,8,0,20,112
21884,58,47,0,0,11,47
21885,233,79,89,15,50,183
21886,102,36,39,6,21,81
21887,44,23,2,11,8,36
21888,18,7,6,0,5,13
21889,46,18,20,0,8,38
21890,61,49,0,1,11,50
21891,118,23,49,16,30,88
21892,83,41,22,1,19,64
21893,186,140,4,2,40,146
21894,5,3,0,2,0,5
21895,55,39,3,1,12,43
21896,157,63,55,15,24,133
21897,152,117,1,0,34,118
21898,341,158,87,26,70,271
21899,178,105,36,8,29,149
21900,24,9,9,0,6,18
21901,41,17,16,0,8,33
21902,208,58,113,4,33,175
21903,26,17,3,0,6,20
21904,41,3,29,2,7,34
21905,62,23,27,1,11,51
21906,96,56,27,10,3,93
21907,52,20,18,0,14,38
21908,54,7,32,4,11,43
21909,7,0,6,0,1,6
21910,4,1,3,0,0,4
21911,102,26,56,3,17,85
21912,22,11,4,3,4,18
21913,92,24,48,0,20,72
21914,5,0,3,0,2,3
21915,17,5,6,0,6,11
21916,5,2,0,0,3,2
21917,15,1,13,0,1,14
21918,336,140,120,6,70,266
21919,31,17,7,3,4,27
21920,6,5,1,0,0,6
21921,20,13,2,0,5,15
21922,107,31,46,7,23,84
21923,8,1,5,0,2,6
21924,58,31,8,10,9,49
21925,15,8,1,6,0,15
21926,65,7,48,1,9,56
21927,221,119,51,15,36,185
21928,18,11,3,1,3,15
21929,30,9,10,1,10,20
21930,63,27,22,0,14,49
21931,224,75,84,15,50,174
21932,51,11,24,4,12,39
21933,85,37,32,0,16,69
21934,201,48,40,76,37,164
21935,76,53,4,0,19,57
21936,95,71,3,1,20,75
21937,9,3,4,0,2,7
21938,29,20,3,0,6,23
21939,74,23,30,7,14,60
21940,104,50,15,23,16,88
21941,19,6,1,7,5,14
21942,383,226,79,17,61,322
21943,19,11,4,0,4,15
21944,358,207,76,0,75,283
21945,45,32,10,3,0,45
21946,65,43,7,0,15,50
21947,17,14,0,0,3,14
21948,254,172,61,3,18,236
21949,46,18,20,0,8,38
21950,36,19,8,4,5,31
21951,12,4,5,0,3,9
21952,137,47,31,23,36,101
21953,37,12,15,1,9,28
21954,179,64,51,23,41,138
21955,17,6,7,0,4,13
21956,0,0,0,0,0,0
21957,70,32,23,2,13,57
21958,26,5,19,0,2,24
21959,13,11,0,0,2,11
21960,78,30,21,13,14,64
21961,49,1,16,25,7,42
21962,57,19,26,0,12,45
21963,496,269,111,17,99,397
21964,167,68,49,7,43,124
21965,48,33,6,3,6,42
21966,11,7,1,0,3,8
21967,260,120,68,25,47,213
21968,153,104,24,0,25,128
21969,31,21,4,0,6,25
21970,39,9,17,4,9,30
21971,33,1,25,1,6,27
21972,157,49,82,4,22,135
21973,39,12,15,2,10,29
21974,319,141,109,4,65,254
21975,79,52,11,0,16,63
21976,58,38,4,2,14,44
21977,54,29,13,4,8,46
21978,62,41,10,2,9,53
21979,61,20,24,7,10,51
21980,678,395,140,21,122,556
21981,69,50,7,3,9,60
21982,126,89,5,5,27,99
21983,398,226,76,8,88,310
21984,96,33,40,10,13,83
21985,123,60,27,14,22,101
21986,34,12,13,2,7,27
21987,41,5,25,0,11,30
21988,16,0,14,0,2,14
21989,90,37,39,2,12,78
21990,81,17,50,0,14,67
21991,92,20,31,27,14,78
21992,17,3,9,1,4,13
21993,42,24,8,0,10,32
21994,639,356,156,24,103,536
21995,159,101,3,17,38,121
21996,108,80,7,1,20,88
21997,51,30,13,8,0,51
21998,234,105,71,17,41,193
21999,347,188,88,15,56,291
22000,30,5,21,0,4,26
22001,26,13,8,0,5,21
22002,250,79,120,11,40,210
22003,75,29,9,17,20,55
22004,148,57,62,4,25,123
22005,38,26,5,0,7,31
22006,15,8,1,5,1,14
22007,54,14,28,0,12,42
22008,33,17,7,0,9,24
22009,88,45,24,2,17,71
22010,25,11,12,0,2,23
22011,38,24,8,1,5,33
22012,6,2,3,0,1,5
22013,10,4,5,0,1,9
22014,24,12,6,3,3,21
22015,82,50,11,2,19,63
22016,149,44,37,39,29,120
22017,74,53,6,3,12,62
22018,59,28,13,3,15,44
22019,25,4,1,16,4,21
22020,21,4,11,1,5,16
22021,43,20,12,3,8,35
22022,2,2,0,0,0,2
22023,195,129,21,0,45,150
22024,62,28,20,1,13,49
22025,31,14,9,2,6,25
22026,80,41,7,13,19,61
22027,53,16,30,0,7,46
22028,42,35,0,0,7,35
22029,47,21,16,0,10,37
22030,16,5,8,0,3,13
22031,286,152,69,17,48,238
22032,165,77,49,7,32,133
22033,17,4,11,0,2,15
22034,112,56,34,4,18,94
22035,36,17,10,0,9,27
22036,5,0,3,0,2,3
22037,20,9,9,0,2,18
22038,55,33,14,2,6,49
22039,7,3,3,0,1,6
22040,32,21,9,0,2,30
22041,58,24,17,3,14,44
22042,44,27,9,1,7,37
22043,74,19,28,1,26,48
22044,90,32,28,10,20,70
22045,19,7,5,0,7,12
22046,178,81,58,4,35,143
22047,29,13,12,0,4,25
22048,13,3,7,0,3,10
22049,12,2,8,0,2,10
22050,422,124,156,48,94,328
22051,218,147,30,0,41,177
22052,26,11,7,4,4,22
22053,40,9,21,3,7,33
22054,7,2,3,1,1,6
22055,50,5,33,0,12,38
22056,56,20,21,6,9,47
22057,198,29,89,32,48,150
22058,32,21,9,0,2,30
22059,263,198,12,0,53,210
22060,32,21,9,0,2,30
22061,155,90,37,1,27,128
22062,21,13,1,3,4,17
22063,111,91,3,3,14,97
22064,67,42,8,3,14,53
22065,64,27,21,4,12,52
22066,92,41,25,5,21,71
22067,169,74,55,7,33,136
22068,65,26,20,2,17,48
22069,136,76,23,6,31,105
22070,377,122,160,10,85,292
22071,26,2,19,0,5,21
22072,101,76,4,0,21,80
22073,66,46,1,0,19,47
22074,98,64,17,0,17,81
22075,34,20,7,0,7,27
22076,20,2,10,0,8,12
22077,64,28,14,8,14,50
22078,70,39,13,2,16,54
22079,39,13,17,0,9,30
22080,46,18,20,0,8,38
22081,46,18,20,0,8,38
22082,76,34,5,15,22,54
22083,374,272,19,2,81,293
22084,138,47,42,17,32,106
22085,213,93,63,19,38,175
22086,454,136,187,30,101,353
22087,28,15,5,0,8,20
22088,4,1,3,0,0,4
22089,74,39,8,10,17,57
22090,34,2,23,0,9,25
22091,626,364,143,16,103,523
22092,85,55,15,0,15,70
22093,36,17,9,3,7,29
22094,26,2,16,2,6,20
22095,8,4,3,0,1,7
22096,182,133,14,1,34,148
22097,100,65,18,0,17,83
22098,64,24,22,3,15,49
22099,66,50,11,0,5,61
22100,34,14,14,0,6,28
22101,208,44,72,45,47,161
22102,26,2,16,2,6,20
22103,415,132,172,22,89,326
22104,289,71,44,125,49,240
22105,213,113,48,0,52,161
22106,353,186,93,15,59,294
22107,38,22,7,7,2,36
22108,7,4,1,1,1,6
22109,118,44,29,14,31,87
22110,33,2,23,0,8,25
22111,141,79,40,12,10,131
22112,66,35,14,4,13,53
22113,25,4,13,2,6,19
22114,34,0,29,0,5,29
22115,58,29,16,6,7,51
22116,554,316,127,20,91,463
22117,77,29,34,3,11,66
22118,3,2,1,0,0,3
22119,50,35,2,0,13,37
22120,10,7,1,0,2,8
22121,26,9,12,2,3,23
22122,104,55,14,17,18,86
22123,92,51,19,7,15,77
22124,90,56,16,0,18,72
22125,93,64,10,10,9,84
22126,139,80,21,2,36,103
22127,98,73,4,2,19,79
22128,143,35,77,1,30,113
22129,124,53,27,22,22,102
22130,111,53,28,5,25,86
22131,442,253,82,13,94,348
22132,19,6,6,4,3,16
22133,3,1,0,0,2,1
22134,564,397,46,1,120,444
22135,242,100,15,82,45,197
22136,56,13,29,0,14,42
22137,543,386,44,1,112,431
22138,34,10,5,11,8,26
22139,42,7,27,4,4,38
22140,46,18,20,0,8,38
22141,53,31,12,0,10,43
22142,21,17,2,0,2,19
22143,201,13,150,0,38,163
22144,4,0,3,0,1,3
22145,15,12,0,0,3,12
22146,14,11,1,0,2,12
22147,44,19,17,1,7,37
22148,223,86,14,81,42,181
22149,84,17,36,12,19,65
22150,46,18,20,0,8,38
22151,23,9,9,1,4,19
22152,39,1,26,5,7,32
22153,66,31,23,0,12,54
22154,51,17,21,3,10,41
22155,49,24,11,4,10,39
22156,136,71,31,9,25,111
22157,28,7,16,1,4,24
22158,123,51,30,14,28,95
22159,40,23,14,0,3,37
22160,73,19,34,5,15,58
22161,143,59,43,15,26,117
22162,51,15,25,0,11,40
22163,33,8,17,4,4,29
22164,114,23,54,15,22,92
22165,32,21,9,0,2,30
22166,28,5,18,1,4,24
22167,53,10,30,1,12,41
22168,62,29,23,2,8,54
22169,14,5,6,2,1,13
22170,10,6,4,0,0,10
22171,62,24,26,1,11,51
22172,23,2,19,0,2,21
22173,127,64,12,23,28,99
22174,6,3,0,0,3,3
22175,213,114,63,0,36,177
22176,52,14,23,1,14,38
22177,76,10,42,5,19,57
22178,56,23,18,1,14,42
22179,33,23,2,0,8,25
22180,29,7,14,0,8,21
22181,68,17,30,3,18,50
22182,32,21,9,0,2,30
22183,53,36,3,1,13,40
22184,79,50,17,0,12,67
22185,138,85,29,0,24,114
22186,87,22,48,8,9,78
22187,40,17,11,2,10,30
22188,18,7,6,0,5,13
22189,162,46,89,4,23,139
22190,62,37,14,1,10,52
22191,44,35,2,0,7,37
22192,1,0,0,0,1,0
22193,623,368,124,22,109,514
22194,14,9,3,1,1,13
22195,22,11,0,6,5,17
22196,104,54,21,0,29,75
22197,69,20,18,14,17,52
22198,43,14,18,4,7,36
22199,62,24,15,7,16,46
22200,129,60,40,4,25,104
22201,134,72,29,7,26,108
22202,16,9,5,0,2,14
22203,169,80,25,24,40,129
22204,11,4,3,0,4,7
22205,292,176,52,6,58,234
22206,35,23,5,2,5,30
22207,48,29,7,0,12,36
22208,151,101,26,5,19,132
22209,324,76,137,32,79,245
22210,2,2,0,0,0,2
22211,127,66,36,0,25,102
22212,108,81,7,1,19,89
22213,217,146,30,0,41,176
22214,31,3,25,0,3,28
22215,39,9,16,4,10,29
22216,49,21,17,1,10,39
22217,49,23,3,13,10,39
22218,39,11,20,1,7,32
22219,26,18,4,0,4,22
22220,293,34,198,4,57,236
22221,35,15,8,0,12,23
22222,79,27,32,10,10,69
22223,20,7,5,1,7,13
22224,80,18,44,7,11,69
22225,361,263,18,2,78,283
22226,323,196,58,0,69,254
22227,15,1,9,3,2,13
22228,137,92,27,3,15,122
22229,23,2,15,3,3,20
22230,107,58,17,9,23,84
22231,27,18,3,0,6,21
22232,8,4,2,0,2,6
22233,29,16,5,0,8,21
22234,31,14,6,4,7,24
22235,22,5,11,1,5,17
22236,65,37,19,0,9,56
22237,68,33,23,1,11,57
22238,18,10,7,0,1,17
22239,72,53,7,2,10,62
22240,33,8,17,4,4,29
22241,613,363,132,15,103,510
22242,46,18,10,6,12,34
22243,140,55,47,14,24,116
22244,65,32,19,1,13,52
22245,51,12,27,0,12,39
22246,25,11,12,1,1,24
22247,0,0,0,0,0,0
22248,452,227,118,12,95,357
22249,57,24,22,1,10,47
22250,5,3,2,0,0,5
22251,76,32,28,1,15,61
22252,32,15,2,5,10,22
22253,48,26,15,0,7,41
22254,597,432,42,1,122,475
22255,19,12,3,0,4,15
22256,25,3,12,1,9,16
22257,45,13,12,14,6,39
22258,71,45,12,2,12,59
22259,109,90,3,3,13,96
22260,114,70,3,15,26,88
22261,26,11,13,1,1,25
22262,83,32,23,16,12,71
22263,11,6,3,0,2,9
22264,129,28,46,29,26,103
22265,73,41,18,0,14,59
22266,91,36,13,17,25,66
22267,127,74,22,3,28,99
22268,24,6,13,1,4,20
22269,76,46,17,0,13,63
22270,78,46,18,0,14,64
22271,209,139,22,0,48,161
22272,31,5,15,1,10,21
22273,6,0,4,0,2,4
22274,44,29,8,1,6,38
22275,37,22,2,0,13,24
22276,87,71,3,0,13,74
22277,19,1,14,1,3,16
22278,60,28,19,0,13,47
22279,102,58,22,0,22,80
22280,23,5,8,3,7,16
22281,89,51,17,7,14,75
22282,34,15,12,1,6,28
22283,144,85,22,9,28,116
22284,55,38,5,0,12,43
22285,7,1,2,0,4,3
22286,93,34,39,3,17,76
22287,47,19,18,2,8,39
22288,345,163,113,2,67,278
22289,54,14,21,0,19,35
22290,438,201,145,9,83,355
22291,390,168,124,23,75,315
22292,171,90,33,19,29,142
22293,248,190,13,0,45,203
22294,36,22,5,1,8,28
22295,8,0,7,0,1,7
22296,167,93,20,17,37,130
22297,48,9,24,4,11,37
22298,53,10,5,29,9,44
22299,97,48,25,9,15,82
22300,138,43,63,4,28,110
22301,207,52,25,98,32,175
22302,396,225,89,0,82,314
22303,6,2,3,0,1,5
22304,37,18,7,4,8,29
22305,39,14,20,1,4,35
22306,76,44,17,0,15,61
22307,34,4,18,6,6,28
22308,74,39,7,12,16,58
22309,346,186,90,15,55,291
22310,73,32,26,6,9,64
22311,280,204,18,2,56,224
22312,12,6,2,1,3,9
22313,63,41,4,0,18,45
22314,60,22,25,0,13,47
22315,55,33,10,0,12,43
22316,84,17,37,13,17,67
22317,53,27,16,1,9,44
22318,80,37,29,4,10,70
22319,178,97,32,2,47,131
22320,10,1,6,0,3,7
22321,138,49,6,60,23,115
22322,220,135,69,2,14,206
22323,80,52,9,3,16,64
22324,67,22,33,1,11,56
22325,433,136,184,16,97,336
22326,17,7,3,4,3,14
22327,21,1,14,0,6,15
22328,32,21,9,0,2,30
22329,108,104,0,4,0,108
22330,45,20,18,1,6,39
22331,44,17,18,0,9,35
22332,27,8,14,1,4,23
22333,73,31,26,7,9,64
22334,26,6,16,0,4,22
22335,37,16,11,1,9,28
22336,69,38,18,0,13,56
22337,44,35,2,0,7,37
22338,15,9,3,0,3,12
22339,20,9,2,2,7,13
22340,71,11,49,2,9,62
22341,76,4,53,1,18,58
22342,78,28,29,9,12,66
22343,91,11,48,8,24,67
22344,62,36,11,2,13,49
22345,19,11,5,1,2,17
22346,69,32,24,2,11,58
22347,109,44,35,9,21,88
22348,32,13,10,0,9,23
22349,152,55,46,16,35,117
22350,54,34,11,0,9,45
22351,78,40,26,4,8,70
22352,73,46,10,3,14,59
22353,31,17,8,1,5,26
22354,47,30,10,0,7,40
22355,14,4,9,0,1,13
22356,205,139,25,6,35,170
22357,32,18,7,6,1,31
22358,57,16,30,2,9,48
22359,267,200,15,0,52,215
22360,36,16,6,1,13,23
22361,69,28,29,2,10,59
22362,5,3,1,0,1,4
22363,82,25,17,21,19,63
22364,55,23,23,0,9,46
22365,69,30,27,2,10,59
22366,109,85,2,0,22,87
22367,24,11,7,1,5,19
22368,110,8,56,23,23,87
22369,34,1,25,0,8,26
22370,11,4,2,0,5,6
22371,127,74,30,6,17,110
22372,457,158,156,47,96,361
22373,28,18,3,0,7,21
22374,163,86,41,6,30,133
22375,44,10,27,1,6,38
22376,18,7,4,1,6,12
22377,33,14,10,0,9,24
22378,51,34,5,3,9,42
22379,26,0,22,0,4,22
22380,55,19,12,17,7,48
22381,164,73,53,7,31,133
22382,10,0,7,0,3,7
22383,25,8,10,3,4,21
22384,15,3,8,0,4,11
22385,524,249,117,46,112,412
22386,32,21,9,0,2,30
22387,70,45,9,2,14,56
22388,36,8,21,0,7,29
22389,3,0,1,0,2,1
22390,67,35,17,6,9,58
22391,83,30,27,5,21,62
22392,71,11,49,2,9,62
22393,27,2,10,8,7,20
22394,159,108,26,0,25,134
22395,33,25,4,1,3,30
22396,103,56,10,14,23,80
22397,59,10,34,4,11,48
22398,68,45,5,3,15,53
22399,159,80,46,1,32,127
22400,38,26,9,3,0,38
22401,95,63,8,4,20,75
22402,55,6,40,1,8,47
22403,23,5,12,1,5,18
22404,22,10,7,0,5,17
22405,139,79,23,3,34,105
22406,55,7,30,1,17,38
22407,11,7,2,1,1,10
22408,49,23,14,1,11,38
22409,80,26,31,5,18,62
22410,59,22,25,0,12,47
22411,46,28,5,5,8,38
22412,118,17,56,17,28,90
22413,31,24,1,0,6,25
22414,61,21,32,0,8,53
22415,59,21,30,1,7,52
22416,369,190,108,4,67,302
22417,17,2,11,0,4,13
22418,134,75,23,7,29,105
22419,67,19,22,15,11,56
22420,79,46,16,2,15,64
22421,37,20,9,0,8,29
22422,49,20,18,2,9,40
22423,51,22,17,2,10,41
22424,61,24,26,1,10,51
22425,103,56,19,5,23,80
22426,35,1,27,0,7,28
22427,95,47,30,1,17,78
22428,80,43,21,4,12,68
22429,25,15,5,0,5,20
22430,40,26,7,0,7,33
22431,32,21,9,0,2,30
22432,672,393,144,16,119,553
22433,72,40,12,4,16,56
22434,36,17,6,2,11,25
22435,66,35,14,2,15,51
22436,66,35,16,0,15,51
22437,11,2,6,0,3,8
22438,452,243,113,21,75,377
22439,39,26,5,4,4,35
22440,97,45,31,0,21,76
22441,39,29,1,0,9,30
22442,15,8,1,2,4,11
22443,20,9,5,1,5,15
22444,75,53,5,5,12,63
22445,20,3,14,0,3,17
22446,54,0,34,3,17,37
22447,5,5,0,0,0,5
22448,97,51,25,4,17,80
22449,19,5,8,0,6,13
22450,90,48,18,5,19,71
22451,32,21,9,0,2,30
22452,87,44,24,2,17,70
22453,146,52,47,17,30,116
22454,87,23,32,15,17,70
22455,85,41,14,9,21,64
22456,667,392,142,17,116,551
22457,138,49,54,0,35,103
22458,10,6,3,0,1,9
22459,150,77,19,24,30,120
22460,155,105,23,0,27,128
22461,57,38,11,1,7,50
22462,57,44,4,0,9,48
22463,391,93,163,46,89,302
22464,25,5,19,0,1,24
22465,38,3,29,1,5,33
22466,86,48,22,4,12,74
22467,77,19,37,7,14,63
22468,35,18,15,0,2,33
22469,47,24,11,2,10,37
22470,5,3,1,0,1,4
22471,25,15,4,3,3,22
22472,18,9,7,0,2,16
22473,58,30,10,4,14,44
22474,62,4,49,0,9,53
22475,43,25,6,0,12,31
22476,230,91,14,81,44,186
22477,82,53,15,0,14,68
22478,75,42,20,0,13,62
22479,48,29,11,0,8,40
22480,204,33,90,32,49,155
22481,20,1,13,1,5,15
22482,40,21,3,5,11,29
22483,42,14,19,2,7,35
22484,30,12,10,0,8,22
22485,70,32,25,3,10,60
22486,281,107,115,7,52,229
22487,198,142,9,10,37,161
22488,39,5,28,0,6,33
22489,95,38,37,1,19,76
22490,67,22,18,17,10,57
22491,8,5,0,0,3,5
22492,206,86,60,20,40,166
22493,29,19,6,0,4,25
22494,44,2,33,0,9,35
22495,79,26,32,4,17,62
22496,426,115,196,13,102,324
22497,36,11,18,2,5,31
22498,129,110,2,0,17,112
22499,78,27,23,10,18,60
22500,21,7,10,0,4,17
22501,78,38,31,1,8,70
22502,55,30,14,3,8,47
22503,34,10,21,0,3,31
22504,128,92,18,0,18,110
22505,21,8,8,2,3,18
22506,36,25,4,2,5,31
22507,65,44,6,2,13,52
22508,83,41,30,0,12,71
22509,13,3,4,0,6,7
22510,167,97,33,6,31,136
22511,56,27,17,1,11,45
22512,36,5,13,10,8,28
22513,29,16,8,0,5,24
22514,212,112,49,0,51,161
22515,75,22,25,9,19,56
22516,14,3,8,1,2,12
22517,69,45,4,8,12,57
22518,181,113,24,3,41,140
22519,194,88,48,20,38,156
22520,61,19,24,7,11,50
22521,22,8,10,2,2,20
22522,38,10,16,5,7,31
22523,6,3,1,0,2,4
22524,35,8,21,1,5,30
22525,38,5,23,0,10,28
22526,12,5,2,2,3,9
22527,39,23,8,0,8,31
22528,63,21,31,0,11,52
22529,61,12,31,0,18,43
22530,109,48,36,3,22,87
22531,32,21,9,0,2,30
22532,519,379,31,1,108,411
22533,68,33,23,1,11,57
22534,39,16,16,0,7,32
22535,72,23,31,2,16,56
22536,19,3,12,2,2,17
22537,35,23,5,1,6,29
22538,28,23,1,0,4,24
22539,98,36,39,6,17,81
22540,101,33,47,1,20,81
22541,76,39,16,2,19,57
22542,37,22,6,1,8,29
22543,100,45,27,2,26,74
22544,355,186,97,3,69,286
22545,39,9,18,2,10,29
22546,120,58,23,16,23,97
22547,193,88,47,20,38,155
22548,45,6,29,0,10,35
22549,38,10,19,1,8,30
22550,305,190,44,12,59,246
22551,137,46,43,22,26,111
22552,9,5,2,1,1,8
22553,109,91,3,3,12,97
22554,105,8,55,21,21,84
22555,248,162,27,4,55,193
22556,46,18,20,0,8,38
22557,133,39,65,1,28,105
22558,93,45,25,5,18,75
22559,32,21,9,0,2,30
22560,90,40,34,1,15,75
22561,60,30,11,2,17,43
22562,178,13,130,0,35,143
22563,514,204,152,48,110,404
22564,31,15,8,3,5,26
22565,30,8,11,0,11,19
22566,42,23,9,0,10,32
22567,39,20,10,1,8,31
22568,15,3,8,0,4,11
22569,15,8,3,2,2,13
22570,63,6,40,0,17,46
22571,50,29,13,0,8,42
22572,47,22,2,13,10,37
22573,102,43,33,7,19,83
22574,50,9,29,0,12,38
22575,383,200,98,20,65,318
22576,119,65,23,4,27,92
22577,73,11,50,2,10,63
22578,50,33,8,0,9,41
22579,60,37,14,0,9,51
22580,23,11,2,3,7,16
22581,17,12,2,0,3,14
22582,87,35,16,15,21,66
22583,119,33,36,24,26,93
22584,58,2,47,1,8,50
22585,158,115,6,0,37,121
22586,7,0,6,0,1,6
22587,681,384,161,23,113,568
22588,220,53,123,2,42,178
22589,112,67,16,3,26,86
22590,35,16,14,0,5,30
22591,11,8,0,2,1,10
22592,91,30,23,20,18,73
22593,503,269,86,44,104,399
22594,106,38,39,5,24,82
22595,615,424,58,1,132,483
22596,245,62,52,80,51,194
22597,65,21,27,7,10,55
22598,12,0,9,0,3,9
22599,97,41,32,4,20,77
22600,22,1,18,0,3,19
22601,25,0,19,0,6,19
22602,18,13,0,0,5,13
22603,19,3,5,8,3,16
22604,32,12,7,2,11,21
22605,55,34,5,9,7,48
22606,123,62,28,7,26,97
22607,102,64,10,5,23,79
22608,2,1,0,0,1,1
22609,366,201,92,14,59,307
22610,71,34,12,7,18,53
22611,440,204,138,12,86,354
22612,79,45,18,2,14,65
22613,17,1,13,0,3,14
22614,69,18,37,0,14,55
22615,239,84,103,4,48,191
22616,104,48,34,1,21,83
22617,125,39,44,13,29,96
22618,110,43,27,18,22,88
22619,110,79,13,0,18,92
22620,77,50,5,9,13,64
22621,37,28,2,2,5,32
22622,135,11,75,19,30,105
22623,14,2,5,2,5,9
22624,102,32,49,0,21,81
22625,288,134,75,22,57,231
22626,168,57,82,0,29,139
22627,343,146,120,6,71,272
22628,207,110,58,0,39,168
22629,339,164,67,41,67,272
22630,46,18,20,0,8,38
22631,421,218,115,18,70,351
22632,67,14,31,4,18,49
22633,32,21,9,0,2,30
22634,34,12,13,0,9,25
22635,85,45,19,1,20,65
22636,27,10,11,2,4,23
22637,32,21,9,0,2,30
22638,97,50,29,1,17,80
22639,18,7,5,0,6,12
22640,112,64,9,11,28,84
22641,19,6,9,0,4,15
22642,126,41,47,7,31,95
22643,1060,390,424,46,200,860
22644,68,56,1,0,11,57
22645,120,58,22,17,23,97
22646,60,14,29,2,15,45
22647,1,1,0,0,0,1
22648,67,39,2,13,13,54
22649,262,74,133,2,53,209
22650,11,3,5,0,3,8
22651,434,206,140,12,76,358
22652,72,42,21,2,7,65
22653,127,69,26,5,27,100
22654,57,20,25,2,10,47
22655,41,32,1,0,8,33
22656,157,94,41,13,9,148
22657,17,5,6,0,6,11
22658,30,5,21,0,4,26
22659,97,58,25,12,2,95
22660,158,49,49,24,36,122
22661,70,19,33,1,17,53
22662,489,207,122,49,111,378
22663,39,18,15,0,6,33
22664,36,15,9,3,9,27
22665,181,131,34,2,14,167
22666,88,49,20,4,15,73
22667,44,30,4,3,7,37
22668,90,59,9,5,17,73
22669,70,35,21,0,14,56
22670,6,2,3,0,1,5
22671,111,37,44,11,19,92
22672,69,44,12,1,12,57
22673,376,217,84,15,60,316
22674,23,1,17,0,5,18
22675,41,29,1,0,11,30
22676,80,37,23,3,17,63
22677,321,165,56,41,59,262
22678,21,8,11,1,1,20
22679,122,44,58,0,20,102
22680,64,41,5,0,18,46
22681,422,191,138,8,85,337
22682,341,257,19,2,63,278
22683,52,26,15,0,11,41
22684,38,19,9,3,7,31
22685,65,47,2,0,16,49
22686,58,22,24,0,12,46
22687,41,8,25,0,8,33
22688,83,24,44,2,13,70
22689,177,90,52,0,35,142
22690,252,18,187,2,45,207
22691,25,12,6,2,5,20
22692,58,22,6,14,16,42
22693,268,185,17,4,62,206
22694,65,21,23,6,15,50
22695,10,0,8,0,2,8
22696,46,18,20,0,8,38
22697,162,123,8,4,27,135
22698,209,51,108,14,36,173
22699,18,9,4,0,5,13
22700,39,26,5,0,8,31
22701,17,3,4,0,10,7
22702,349,183,89,18,59,290
22703,23,1,17,1,4,19
22704,81,37,5,16,23,58
22705,36,17,9,2,8,28
22706,283,99,124,16,44,239
22707,129,40,48,20,21,108
22708,86,46,22,1,17,69
22709,131,94,6,3,28,103
22710,378,196,97,20,65,313
22711,12,6,2,1,3,9
22712,30,4,16,4,6,24
22713,52,33,6,9,4,48
22714,2,2,0,0,0,2
22715,33,7,16,3,7,26
22716,42,17,9,5,11,31
22717,166,83,26,24,33,133
22718,220,165,9,0,46,174
22719,52,31,11,0,10,42
22720,390,190,112,14,74,316
22721,23,5,13,0,5,18
22722,50,20,21,0,9,41
22723,8,4,2,0,2,6
22724,468,244,106,17,101,367
22725,83,27,39,4,13,70
22726,50,16,25,0,9,41
22727,73,52,7,3,11,62
22728,29,10,12,1,6,23
22729,14,4,4,3,3,11
22730,32,21,9,0,2,30
22731,53,26,18,0,9,44
22732,13,5,4,0,4,9
22733,25,17,1,0,7,18
22734,31,15,6,2,8,23
22735,43,9,22,5,7,36
22736,71,16,34,2,19,52
22737,59,15,34,1,9,50
22738,109,104,0,5,0,109
22739,465,327,40,1,97,368
22740,210,122,51,0,37,173
22741,368,97,176,7,88,280
22742,165,50,89,4,22,143
22743,107,40,17,26,24,83
22744,10,2,2,2,4,6
22745,398,232,83,16,67,331
22746,22,5,15,0,2,20
22747,68,48,8,1,11,57
22748,40,23,11,1,5,35
22749,22,12,5,0,5,17
22750,67,25,22,8,12,55
22751,26,19,3,1,3,23
22752,72,24,36,1,11,61
22753,69,8,43,2,16,53
22754,77,19,37,8,13,64
22755,96,51,18,5,22,74
22756,302,163,73,16,50,252
22757,69,7,7,35,20,49
22758,76,15,46,0,15,61
22759,33,23,4,0,6,27
22760,18,8,5,0,5,13
22761,38,23,9,1,5,33
22762,12,7,1,0,4,8
22763,31,12,13,0,6,25
22764,9,3,3,0,3,6
22765,97,39,38,1,19,78
22766,111,65,23,6,17,94
22767,16,8,4,0,4,12
22768,14,9,2,0,3,11
22769,203,82,32,40,49,154
22770,31,5,18,0,8,23
22771,91,69,3,0,19,72
22772,33,4,18,1,10,23
22773,46,18,20,0,8,38
22774,76,36,21,2,17,59
22775,46,38,1,0,7,39
22776,18,6,9,0,3,15
22777,80,27,25,6,22,58
22778,215,52,30,98,35,180
22779,35,13,13,0,9,26
22780,46,31,7,0,8,38
22781,72,30,14,7,21,51
22782,3,1,2,0,0,3
22783,89,43,20,4,22,67
22784,54,25,21,0,8,46
22785,15,4,6,0,5,10
22786,136,81,30,0,25,111
22787,24,9,3,8,4,20
22788,30,20,6,4,0,30
22789,142,62,44,10,26,116
22790,31,2,23,0,6,25
22791,661,378,153,22,108,553
22792,47,23,14,2,8,39
22793,98,52,21,9,16,82
22794,41,13,10,4,14,27
22795,12,3,4,0,5,7
22796,10,3,4,0,3,7
22797,22,6,9,0,7,15
22798,115,93,3,0,19,96
22799,27,8,13,0,6,21
22800,149,88,39,13,9,140
22801,32,21,9,0,2,30
22802,32,21,9,0,2,30
22803,87,40,26,0,21,66
22804,27,14,6,3,4,23
22805,17,11,1,0,5,12
22806,408,235,89,15,69,339
22807,97,43,34,4,16,81
22808,17,6,3,5,3,14
22809,183,146,9,0,28,155
22810,32,21,9,0,2,30
22811,97,68,11,0,18,79
22812,62,26,18,4,14,48
22813,39,2,19,12,6,33
22814,58,26,17,0,15,43
22815,253,61,130,7,55,198
22816,179,65,62,17,35,144
22817,13,2,7,1,3,10
22818,30,6,14,3,7,23
22819,71,34,12,7,18,53
22820,38,6,3,20,9,29
22821,13,1,8,0,4,9
22822,43,22,11,4,6,37
22823,32,21,9,0,2,30
22824,347,188,88,15,56,291
22825,111,57,22,10,22,89
22826,242,100,15,83,44,198
22827,41,2,23,12,4,37
22828,41,8,25,4,4,37
22829,84,38,28,4,14,70
22830,44,16,19,3,6,38
22831,160,124,8,4,24,136
22832,68,33,21,1,13,55
22833,73,37,19,3,14,59
22834,17,11,3,0,3,14
22835,44,18,19,1,6,38
22836,70,41,14,0,15,55
22837,62,35,18,0,9,53
22838,50,33,9,0,8,42
22839,10,2,8,0,0,10
22840,42,8,26,1,7,35
22841,54,0,34,3,17,37
22842,27,11,10,2,4,23
22843,56,23,20,3,10,46
22844,49,32,10,0,7,42
22845,49,28,14,0,7,42
22846,51,35,11,0,5,46
22847,266,104,106,5,51,215
22848,85,55,15,0,15,70
22849,126,29,42,30,25,101
22850,46,15,19,4,8,38
22851,79,28,31,4,16,63
22852,69,26,20,13,10,59
22853,276,25,193,2,56,220
22854,42,4,29,2,7,35
22855,95,51,30,1,13,82
22856,4,0,3,0,1,3
22857,58,12,35,0,11,47
22858,85,55,15,0,15,70
22859,447,208,152,7,80,367
22860,139,105,4,3,27,112
22861,137,57,54,1,25,112
22862,3,1,2,0,0,3
22863,239,100,15,80,44,195
22864,94,50,19,3,22,72
22865,90,65,6,0,19,71
22866,101,62,16,3,20,81
22867,155,97,32,1,25,130
22868,229,156,31,0,42,187
22869,57,15,22,0,20,37
22870,164,126,4,0,34,130
22871,90,67,16,2,5,85
22872,84,54,12,9,9,75
22873,226,75,85,15,51,175
22874,224,123,32,25,44,180
22875,45,6,29,5,5,40
22876,88,31,21,13,23,65
22877,47,34,10,3,0,47
22878,32,21,9,0,2,30
22879,15,4,4,3,4,11
22880,32,21,9,0,2,30
22881,60,42,8,3,7,53
22882,191,90,57,0,44,147
22883,23,9,8,0,6,17
22884,110,54,37,1,18,92
22885,44,12,25,1,6,38
22886,68,38,16,0,14,54
22887,81,43,14,5,19,62
22888,88,36,37,0,15,73
22889,340,161,114,1,64,276
22890,80,34,26,5,15,65
22891,84,44,31,2,7,77
22892,38,19,11,0,8,30
22893,101,35,23,24,19,82
22894,55,22,13,9,11,44
22895,36,22,3,0,11,25
22896,446,248,92,10,96,350
22897,29,17,3,3,6,23
22898,33,17,14,0,2,31
22899,38,16,11,3,8,30
22900,190,63,58,25,44,146
22901,46,18,20,0,8,38
22902,48,20,15,3,10,38
22903,533,375,46,1,111,422
22904,109,59,24,4,22,87
22905,84,18,52,6,8,76
22906,359,197,89,15,58,301
22907,54,26,16,0,12,42
22908,75,56,6,0,13,62
22909,92,56,19,0,17,75
22910,4,2,1,0,1,3
22911,160,12,113,0,35,125
22912,114,67,18,7,22,92
22913,339,143,120,5,71,268
22914,6,1,4,0,1,5
22915,46,18,20,0,8,38
22916,101,47,33,1,20,81
22917,55,11,40,0,4,51
22918,13,0,9,0,4,9
22919,46,12,25,1,8,38
22920,91,60,12,11,8,83
22921,203,105,34,26,38,165
22922,68,30,23,0,15,53
22923,44,20,14,1,9,35
22924,29,10,11,0,8,21
22925,447,135,185,34,93,354
22926,97,25,35,13,24,73
22927,40,25,7,1,7,33
22928,33,24,4,0,5,28
22929,50,23,16,5,6,44
22930,94,30,47,2,15,79
22931,43,7,16,7,13,30
22932,426,204,144,6,72,354
22933,41,6,24,0,11,30
22934,20,4,14,0,2,18
22935,97,42,25,10,20,77
22936,17,7,7,0,3,14
22937,218,99,65,13,41,177
22938,89,64,6,0,19,70
22939,13,5,3,1,4,9
22940,333,140,121,10,62,271
22941,100,46,15,24,15,85
22942,4,0,3,0,1,3
22943,46,18,20,0,8,38
22944,53,13,29,2,9,44
22945,183,65,51,27,40,143
22946,18,6,9,0,3,15
22947,84,46,16,2,20,64
22948,61,26,16,4,15,46
22949,76,36,16,0,24,52
22950,273,24,196,2,51,222
22951,25,4,18,0,3,22
22952,89,47,11,2,29,60
22953,18,9,5,1,3,15
22954,209,134,59,4,12,197
22955,14,3,5,1,5,9
22956,63,12,30,5,16,47
22957,32,21,9,0,2,30
22958,73,19,25,12,17,56
22959,67,33,12,5,17,50
22960,58,20,26,0,12,46
22961,140,37,47,21,35,105
22962,72,48,7,0,17,55
22963,143,51,46,17,29,114
22964,49,23,21,0,5,44
22965,259,129,62,16,52,207
22966,72,40,13,8,11,61
22967,244,167,57,3,17,227
22968,13,0,6,4,3,10
22969,28,12,8,0,8,20
22970,20,4,9,1,6,14
22971,131,67,30,4,30,101
22972,37,8,17,4,8,29
22973,54,20,20,1,13,41
22974,30,3,21,0,6,24
22975,31,23,1,3,4,27
22976,23,3,12,1,7,16
22977,123,60,25,15,23,100
22978,57,38,8,1,10,47
22979,34,14,12,2,6,28
22980,45,2,35,0,8,37
22981,109,45,28,12,24,85
22982,61,36,14,1,10,51
22983,257,62,132,7,56,201
22984,75,43,13,1,18,57
22985,74,24,33,4,13,61
22986,15,8,1,5,1,14
22987,160,114,11,0,35,125
22988,13,0,11,1,1,12
22989,32,21,9,0,2,30
22990,11,2,4,1,4,7
22991,29,12,10,0,7,22
22992,38,11,21,0,6,32
22993,64,41,7,1,15,49
22994,55,34,6,0,15,40
22995,37,14,9,3,11,26
22996,180,46,89,3,42,138
22997,92,47,13,2,30,62
22998,66,27,19,9,11,55
22999,7,5,2,0,0,7
23000,59,14,33,0,12,47
23001,46,18,20,0,8,38
23002,148,90,31,0,27,121
23003,59,36,14,0,9,50
23004,30,20,4,0,6,24
23005,101,94,0,7,0,101
23006,135,89,28,3,15,120
23007,51,32,5,0,14,37
23008,76,12,8,35,21,55
23009,58,43,2,0,13,45
23010,139,57,52,3,27,112
23011,112,78,16,8,10,102
23012,58,22,24,2,10,48
23013,39,14,15,0,10,29
23014,57,8,31,4,14,43
23015,41,1,36,0,4,37
23016,491,247,91,51,102,389
23017,48,32,10,1,5,43
23018,51,8,31,3,9,42
23019,248,188,18,2,40,208
23020,29,20,4,0,5,24
23021,24,3,18,0,3,21
23022,311,104,102,35,70,241
23023,61,16,30,1,14,47
23024,57,7,31,7,12,45
23025,107,71,17,0,19,88
23026,29,8,13,2,6,23
23027,32,21,9,0,2,30
23028,32,21,9,0,2,30
23029,157,80,45,1,31,126
23030,33,8,17,4,4,29
23031,58,2,47,1,8,50
23032,32,18,7,0,7,25
23033,36,16,11,0,9,27
23034,8,5,0,1,2,6
23035,190,60,91,0,39,151
23036,189,145,17,0,27,162
23037,55,32,15,2,6,49
23038,45,30,6,0,9,36
23039,61,40,13,1,7,54
23040,184,125,18,0,41,143
23041,65,17,8,27,13,52
23042,55,33,10,0,12,43
23043,58,35,12,0,11,47
23044,12,7,4,0,1,11
23045,64,14,37,0,13,51
23046,56,35,6,0,15,41
23047,74,24,27,12,11,63
23048,46,18,20,0,8,38
23049,68,45,5,3,15,53
23050,46,18,20,0,8,38
23051,32,21,9,0,2,30
23052,75,34,24,0,17,58
23053,31,24,3,0,4,27
23054,46,16,16,0,14,32
23055,32,21,9,0,2,30
23056,64,17,33,4,10,54
23057,201,135,20,0,46,155
23058,22,14,3,0,5,17
23059,207,137,22,0,48,159
23060,19,16,0,0,3,16
23061,278,155,34,32,57,221
23062,12,1,6,0,5,7
23063,108,68,4,10,26,82
23064,53,27,10,7,9,44
23065,38,15,11,0,12,26
23066,454,140,191,29,94,360
23067,523,229,127,48,119,404
23068,27,9,12,2,4,23
23069,117,66,30,0,21,96
23070,614,361,138,15,100,514
23071,347,150,122,6,69,278
23072,271,110,100,16,45,226
23073,38,14,12,5,7,31
23074,377,275,18,2,82,295
23075,27,5,13,1,8,19
23076,196,101,35,26,34,162
23077,36,18,12,0,6,30
23078,50,25,13,0,12,38
23079,47,15,20,3,9,38
23080,12,0,11,0,1,11
23081,122,37,44,15,26,96
23082,28,13,5,3,7,21
23083,106,83,3,0,20,86
23084,147,62,33,18,34,113
23085,15,7,3,0,5,10
23086,46,20,10,7,9,37
23087,186,104,35,1,46,140
23088,71,34,12,7,18,53
23089,46,28,9,0,9,37
23090,35,14,10,2,9,26
23091,14,3,8,1,2,12
23092,116,48,15,19,34,82
23093,8,4,2,0,2,6
23094,52,29,9,3,11,41
23095,0,0,0,0,0,0
23096,431,202,145,9,75,356
23097,32,22,2,0,8,24
23098,28,6,17,0,5,23
23099,118,42,30,17,29,89
23100,63,29,20,0,14,49
23101,13,0,11,1,1,12
23102,32,21,9,0,2,30
23103,108,59,10,19,20,88
23104,0,0,0,0,0,0
23105,281,85,132,18,46,235
23106,57,20,22,6,9,48
23107,29,6,15,2,6,23
23108,153,64,33,19,37,116
23109,29,17,6,1,5,24
23110,45,28,7,1,9,36
23111,40,13,16,3,8,32
23112,163,112,25,0,26,137
23113,75,50,7,0,18,57
23114,61,17,32,1,11,50
23115,46,18,20,0,8,38
23116,16,6,3,1,6,10
23117,111,105,0,6,0,111
23118,557,403,33,1,120,437
23119,11,7,4,0,0,11
23120,13,7,4,0,2,11
23121,81,30,37,4,10,71
23122,94,41,27,1,25,69
23123,56,18,13,13,12,44
23124,59,35,15,2,7,52
23125,93,68,1,0,24,69
23126,37,25,4,0,8,29
23127,127,97,5,0,25,102
23128,662,388,141,17,116,546
23129,54,33,10,0,11,43
23130,90,39,26,4,21,69
23131,59,14,29,2,14,45
23132,102,67,1,12,22,80
23133,79,49,18,0,12,67
23134,176,95,24,24,33,143
23135,51,14,24,2,11,40
23136,432,214,104,29,85,347
23137,34,19,7,0,8,26
23138,46,18,20,0,8,38
23139,41,11,27,0,3,38
23140,3,1,1,0,1,2
23141,103,38,18,13,34,69
23142,364,187,107,5,65,299
23143,80,67,0,1,12,68
23144,55,24,14,2,15,40
23145,24,6,16,0,2,22
23146,153,61,41,19,32,121
23147,54,24,8,11,11,43
23148,63,35,18,0,10,53
23149,228,153,34,0,41,187
23150,46,16,13,5,12,34
23151,75,40,18,0,17,58
23152,341,142,122,6,71,270
23153,168,76,50,8,34,134
23154,32,21,9,0,2,30
23155,67,38,8,9,12,55
23156,179,127,15,2,35,144
23157,35,16,11,3,5,30
23158,139,44,30,39,26,113
23159,142,78,35,0,29,113
23160,33,0,29,1,3,30
23161,18,1,10,5,2,16
23162,70,47,7,1,15,55
23163,18,14,1,0,3,15
23164,225,97,14,76,38,187
23165,30,20,4,0,6,24
23166,102,22,47,11,22,80
23167,28,3,15,2,8,20
23168,69,31,15,13,10,59
23169,40,12,19,1,8,32
23170,179,53,26,69,31,148
23171,136,73,29,7,27,109
23172,44,12,23,1,8,36
23173,252,181,14,5,52,200
23174,56,39,11,5,1,55
23175,124,43,31,21,29,95
23176,389,224,86,0,79,310
23177,58,23,24,0,11,47
23178,510,237,114,54,105,405
23179,22,13,5,0,4,18
23180,177,85,52,4,36,141
23181,36,4,23,4,5,31
23182,56,26,19,0,11,45
23183,25,11,6,3,5,20
23184,66,32,12,0,22,44
23185,8,0,6,0,2,6
23186,28,10,12,0,6,22
23187,95,53,24,4,14,81
23188,199,78,37,33,51,148
23189,54,32,10,0,12,42
23190,74,53,7,3,11,63
23191,52,22,21,0,9,43
23192,192,78,27,54,33,159
23193,122,42,45,8,27,95
23194,20,8,9,1,2,18
23195,7,3,1,2,1,6
23196,129,93,6,3,27,102
23197,301,152,81,16,52,249
23198,40,18,13,0,9,31
23199,107,37,47,6,17,90
23200,142,111,6,0,25,117
23201,10,4,4,0,2,8
23202,10,3,4,0,3,7
23203,32,21,9,0,2,30
23204,8,3,2,2,1,7
23205,84,29,24,12,19,65
23206,8,0,6,0,2,6
23207,3,2,1,0,0,3
23208,98,38,34,14,12,86
23209,52,0,41,2,9,43
23210,24,12,6,0,6,18
23211,22,13,8,0,1,21
23212,80,27,28,1,24,56
23213,32,21,9,0,2,30
23214,202,84,49,24,45,157
23215,20,9,6,3,2,18
23216,8,6,0,0,2,6
23217,140,47,45,21,27,113
23218,241,106,90,1,44,197
23219,198,53,39,66,40,158
23220,47,28,2,11,6,41
23221,46,18,20,0,8,38
23222,192,136,11,7,38,154
23223,216,51,31,96,38,178
23224,22,6,14,0,2,20
23225,187,142,18,0,27,160
23226,109,53,38,1,17,92
23227,10,7,1,0,2,8
23228,91,37,31,5,18,73
23229,77,24,33,8,12,65
23230,115,33,44,10,28,87
23231,129,74,33,10,12,117
23232,17,11,2,0,4,13
23233,42,11,22,1,8,34
23234,8,2,2,3,1,7
23235,182,51,50,45,36,146
23236,37,12,19,0,6,31
23237,16,6,3,2,5,11
23238,128,24,43,23,38,90
23239,43,20,15,0,8,35
23240,47,18,22,1,6,41
23241,45,27,10,0,8,37
23242,25,9,10,0,6,19
23243,92,62,8,0,22,70
23244,4,1,1,0,2,2
23245,90,51,24,4,11,79
23246,32,12,13,0,7,25
23247,171,120,14,1,36,135
23248,104,43,38,3,20,84
23249,22,14,6,1,1,21
23250,41,12,20,2,7,34
23251,442,317,38,1,86,356
23252,31,7,18,1,5,26
23253,278,75,149,1,53,225
23254,44,36,3,0,5,39
23255,87,77,2,0,8,79
23256,1,0,1,0,0,1
23257,123,39,67,0,17,106
23258,27,8,9,3,7,20
23259,105,68,9,6,22,83
23260,46,23,10,0,13,33
23261,88,24,39,8,17,71
23262,145,95,28,0,22,123
23263,33,14,12,0,7,26
23264,542,382,47,1,112,430
23265,21,6,14,0,1,20
23266,89,68,1,0,20,69
23267,68,41,13,0,14,54
23268,40,23,8,0,9,31
23269,122,72,27,0,23,99
23270,72,37,21,0,14,58
23271,12,5,4,0,3,9
23272,401,107,160,46,88,313
23273,312,162,75,19,56,256
23274,83,43,26,0,14,69
23275,40,18,13,2,7,33
23276,481,235,97,55,94,387
23277,46,18,20,0,8,38
23278,72,37,23,1,11,61
23279,38,22,5,3,8,30
23280,102,93,0,9,0,102
23281,216,62,21,98,35,181
23282,44,24,10,1,9,35
23283,25,13,8,2,2,23
23284,15,10,2,0,3,12
23285,30,7,14,1,8,22
23286,63,28,24,0,11,52
23287,84,26,43,1,14,70
23288,38,22,5,3,8,30
23289,76,9,48,5,14,62
23290,174,50,50,39,35,139
23291,44,25,15,0,4,40
23292,115,33,52,3,27,88
23293,243,100,15,83,45,198
23294,89,71,0,4,14,75
23295,54,10,28,11,5,49
23296,41,15,18,0,8,33
23297,136,37,46,18,35,101
23298,29,12,12,0,5,24
23299,66,49,12,0,5,61
23300,75,22,34,2,17,58
23301,23,2,15,0,6,17
23302,96,50,28,1,17,79
23303,51,23,13,9,6,45
23304,8,4,1,0,3,5
23305,144,36,77,1,30,114
23306,346,188,88,15,55,291
23307,6,4,0,1,1,5
23308,130,33,48,16,33,97
23309,52,28,12,0,12,40
23310,1,0,1,0,0,1
23311,36,19,8,0,9,27
23312,11,6,2,2,1,10
23313,9,4,2,0,3,6
23314,38,20,9,0,9,29
23315,15,4,6,0,5,10
23316,11,4,5,2,0,11
23317,62,41,12,0,9,53
23318,70,39,11,4,16,54
23319,12,0,10,0,2,10
23320,19,5,13,0,1,18
23321,32,21,9,0,2,30
23322,92,54,16,1,21,71
23323,247,103,15,82,47,200
23324,6,0,5,0,1,5
23325,24,16,2,0,6,18
23326,10,3,4,0,3,7
23327,109,46,38,2,23,86
23328,346,165,113,1,67,279
23329,124,61,28,14,21,103
23330,59,26,9,10,14,45
23331,237,169,22,4,42,195
23332,109,31,48,6,24,85
23333,35,14,11,0,10,25
23334,71,24,35,2,10,61
23335,70,39,10,1,20,50
23336,50,31,9,0,10,40
23337,70,36,16,1,17,53
23338,68,39,15,0,14,54
23339,128,82,18,3,25,103
23340,40,30,6,4,0,40
23341,109,34,53,1,21,88
23342,105,30,54,0,21,84
23343,193,88,47,20,38,155
23344,65,18,22,15,10,55
23345,18,16,0,0,2,16
23346,46,12,25,0,9,37
23347,33,5,23,1,4,29
23348,84,53,16,0,15,69
23349,93,39,33,8,13,80
23350,64,32,18,0,14,50
23351,22,9,8,0,5,17
23352,207,48,22,102,35,172
23353,20,3,13,1,3,17
23354,51,22,19,2,8,43
23355,17,9,1,0,7,10
23356,44,8,23,0,13,31
23357,13,0,11,1,1,12
23358,15,3,7,3,2,13
23359,675,386,161,22,106,569
23360,60,31,13,3,13,47
23361,18,5,10,0,3,15
23362,51,15,18,6,12,39
23363,37,9,13,6,9,28
23364,49,27,11,0,11,38
23365,22,9,6,3,4,18
23366,218,54,112,3,49,169
23367,69,35,13,8,13,56
23368,38,23,9,4,2,36
23369,88,52,13,11,12,76
23370,54,36,7,1,10,44
23371,31,10,6,10,5,26
23372,199,109,39,14,37,162
23373,30,14,10,3,3,27
23374,358,205,78,17,58,300
23375,213,146,24,0,43,170
23376,32,25,3,0,4,28
23377,225,122,35,23,45,180
23378,33,12,9,5,7,26
23379,16,3,6,3,4,12
23380,235,136,44,10,45,190
23381,17,9,0,3,5,12
23382,205,13,153,0,39,166
23383,357,157,125,6,69,288
23384,44,20,14,0,10,34
23385,16,3,6,1,6,10
23386,57,40,3,0,14,43
23387,34,18,11,0,5,29
23388,40,10,22,2,6,34
23389,56,3,40,1,12,44
23390,33,7,18,1,7,26
23391,196,85,67,4,40,156
23392,31,9,15,0,7,24
23393,28,12,2,11,3,25
23394,83,38,8,18,19,64
23395,67,27,14,14,12,55
23396,32,7,14,3,8,24
23397,186,48,64,31,43,143
23398,24,11,10,0,3,21
23399,31,20,3,0,8,23
23400,80,37,5,16,22,58
23401,58,14,28,1,15,43
23402,72,38,17,4,13,59
23403,71,34,12,7,18,53
23404,9,3,1,1,4,5
23405,345,145,126,6,68,277
23406,19,3,11,0,5,14
23407,183,119,30,5,29,154
23408,63,30,14,5,14,49
23409,42,10,10,9,13,29
23410,33,15,13,0,5,28
23411,109,59,24,4,22,87
23412,36,7,19,0,10,26
23413,93,32,42,1,18,75
23414,94,65,5,0,24,70
23415,92,32,37,7,16,76
23416,46,18,20,0,8,38
23417,51,17,26,0,8,43
23418,46,28,12,0,6,40
23419,44,20,18,0,6,38
23420,45,19,9,8,9,36
23421,98,36,41,1,20,78
23422,27,11,9,1,6,21
23423,38,22,5,3,8,30
23424,37,11,14,3,9,28
23425,9,7,0,0,2,7
23426,75,50,17,5,3,72
23427,83,39,19,2,23,60
23428,110,104,0,6,0,110
23429,20,3,13,0,4,16
23430,29,20,2,2,5,24
23431,162,68,53,2,39,123
23432,14,9,0,1,4,10
23433,80,17,47,1,15,65
23434,263,196,15,0,52,211
23435,16,12,3,1,0,16
23436,60,33,13,2,12,48
23437,18,8,4,0,6,12
23438,24,17,3,0,4,20
23439,60,23,27,1,9,51
23440,145,95,28,0,22,123
23441,70,25,30,1,14,56
23442,44,23,5,7,9,35
23443,178,116,46,4,12,166
23444,48,27,13,0,8,40
23445,53,30,14,1,8,45
23446,47,28,13,0,6,41
23447,15,3,7,3,2,13
23448,31,14,12,0,5,26
23449,47,29,6,5,7,40
23450,30,9,11,2,8,22
23451,175,107,6,20,42,133
23452,22,11,4,4,3,19
23453,37,15,4,9,9,28
23454,100,58,26,13,3,97
23455,14,5,3,3,3,11
23456,59,43,5,4,7,52
23457,24,12,6,0,6,18
23458,22,12,5,2,3,19
23459,87,21,48,3,15,72
23460,68,8,53,0,7,61
23461,32,21,9,0,2,30
23462,35,23,4,1,7,28
23463,333,92,158,7,76,257
23464,61,29,23,2,7,54
23465,17,3,11,1,2,15
23466,35,23,7,1,4,31
23467,671,392,138,20,121,550
23468,110,44,47,3,16,94
23469,74,45,20,1,8,66
23470,68,28,29,0,11,57
23471,12,1,6,0,5,7
23472,67,48,2,0,17,50
23473,91,34,36,4,17,74
23474,216,80,61,30,45,171
23475,53,16,24,0,13,40
23476,42,23,9,0,10,32
23477,103,29,57,0,17,86
23478,12,5,6,0,1,11
23479,110,64,23,6,17,93
23480,46,18,24,0,4,42
23481,33,21,7,0,5,28
23482,46,18,20,0,8,38
23483,74,31,9,18,16,58
23484,124,45,58,0,21,103
23485,51,16,23,2,10,41
23486,98,43,26,12,17,81
23487,101,28,56,0,17,84
23488,33,8,3,16,6,27
23489,13,5,5,2,1,12
23490,49,32,6,2,9,40
23491,40,18,11,0,11,29
23492,44,7,28,5,4,40
23493,292,47,183,4,58,234
23494,44,11,25,1,7,37
23495,51,9,18,19,5,46
23496,119,46,26,24,23,96
23497,2,0,2,0,0,2
23498,62,28,21,1,12,50
23499,28,13,6,1,8,20
23500,46,13,24,0,9,37
23501,61,20,17,15,9,52
23502,158,92,37,1,28,130
23503,7,3,3,1,0,7
23504,98,68,8,3,19,79
23505,33,23,4,0,6,27
23506,366,213,80,16,57,309
23507,19,8,5,0,6,13
23508,59,35,13,0,11,48
23509,21,8,4,2,7,14
23510,25,12,5,6,2,23
23511,459,230,120,14,95,364
23512,25,6,13,0,6,19
23513,62,36,10,2,14,48
23514,183,123,17,0,43,140
23515,62,30,8,8,16,46
23516,47,14,13,7,13,34
23517,98,79,3,0,16,82
23518,10,0,9,0,1,9
23519,50,18,20,1,11,39
23520,265,176,20,4,65,200
23521,79,51,17,0,11,68
23522,51,27,10,2,12,39
23523,146,36,68,4,38,108
23524,22,8,3,3,8,14
23525,48,18,16,1,13,35
23526,6,6,0,0,0,6
23527,52,32,11,1,8,44
23528,48,16,17,2,13,35
23529,277,93,126,15,43,234
23530,50,23,17,1,9,41
23531,19,9,3,0,7,12
23532,36,16,14,0,6,30
23533,104,43,12,16,33,71
23534,58,22,17,4,15,43
23535,56,42,9,5,0,56
23536,75,37,19,2,17,58
23537,34,22,3,0,9,25
23538,45,19,18,0,8,37
23539,96,30,33,12,21,75
23540,20,10,4,1,5,15
23541,296,217,19,2,58,238
23542,66,23,27,1,15,51
23543,48,34,5,2,7,41
23544,203,112,29,22,40,163
23545,212,109,35,33,35,177
23546,32,21,9,0,2,30
23547,64,33,14,0,17,47
23548,125,27,43,30,25,100
23549,7,5,1,0,1,6
23550,22,2,14,1,5,17
23551,71,36,19,0,16,55
23552,118,37,43,13,25,93
23553,35,7,20,1,7,28
23554,42,4,28,2,8,34
23555,64,25,26,1,12,52
23556,49,15,14,10,10,39
23557,56,37,12,0,7,49
23558,100,34,37,6,23,77
23559,68,22,29,2,15,53
23560,15,12,0,0,3,12
23561,97,65,8,4,20,77
23562,37,2,25,0,10,27
23563,47,19,22,0,6,41
23564,44,25,14,0,5,39
23565,195,132,45,3,15,180
23566,36,20,8,0,8,28
23567,20,3,0,9,8,12
23568,83,20,32,12,19,64
23569,13,1,9,0,3,10
23570,30,22,0,0,8,22
23571,97,33,41,10,13,84
23572,223,74,83,15,51,172
23573,188,47,28,79,34,154
23574,30,17,10,0,3,27
23575,104,24,58,3,19,85
23576,3,2,1,0,0,3
23577,7,5,0,0,2,5
23578,10,4,6,0,0,10
23579,27,17,3,0,7,20
23580,188,87,47,16,38,150
23581,25,9,8,1,7,18
23582,74,27,31,2,14,60
23583,17,4,7,1,5,12
23584,63,18,33,1,11,52
23585,139,64,46,5,24,115
23586,287,149,78,12,48,239
23587,160,93,37,1,29,131
23588,8,0,6,0,2,6
23589,156,68,31,23,34,122
23590,54,28,15,0,11,43
23591,36,23,7,0,6,30
23592,221,89,86,4,42,179
23593,61,17,32,1,11,50
23594,16,10,2,0,4,12
23595,123,58,29,9,27,96
23596,39,16,10,3,10,29
23597,33,9,15,1,8,25
23598,40,13,14,2,11,29
23599,86,42,4,27,13,73
23600,87,54,18,2,13,74
23601,25,7,11,1,6,19
23602,32,23,4,0,5,27
23603,70,34,24,1,11,59
23604,1,1,0,0,0,1
23605,60,38,11,1,10,50
23606,205,100,38,32,35,170
23607,72,60,2,0,10,62
23608,126,11,68,18,29,97
23609,46,18,20,0,8,38
23610,4,2,1,0,1,3
23611,212,111,34,26,41,171
23612,175,54,76,8,37,138
23613,388,170,133,12,73,315
23614,75,7,41,14,13,62
23615,30,17,4,0,9,21
23616,70,33,15,12,10,60
23617,31,14,5,5,7,24
23618,169,31,104,1,33,136
23619,35,20,7,0,8,27
23620,192,88,47,19,38,154
23621,49,9,29,1,10,39
23622,44,15,22,0,7,37
23623,32,19,3,0,10,22
23624,14,2,7,3,2,12
23625,11,10,0,0,1,10
23626,90,25,53,2,10,80
23627,62,28,22,0,12,50
23628,10,2,5,1,2,8
23629,49,24,15,0,10,39
23630,65,21,35,0,9,56
23631,32,21,9,0,2,30
23632,84,44,25,4,11,73
23633,136,41,65,1,29,107
23634,67,38,8,9,12,55
23635,237,58,33,107,39,198
23636,231,123,35,28,45,186
23637,73,33,21,0,19,54
23638,14,9,4,0,1,13
23639,124,54,19,18,33,91
23640,43,31,5,0,7,36
23641,33,12,9,7,5,28
23642,551,399,33,1,118,433
23643,67,25,16,7,19,48
23644,32,21,9,0,2,30
23645,144,27,51,25,41,103
23646,22,1,16,0,5,17
23647,36,5,13,10,8,28
23648,8,5,2,0,1,7
23649,25,3,14,2,6,19
23650,30,8,7,5,10,20
23651,61,28,19,0,14,47
23652,246,166,59,3,18,228
23653,49,15,28,1,5,44
23654,29,10,7,5,7,22
23655,356,157,122,11,66,290
23656,12,2,9,0,1,11
23657,87,42,18,7,20,67
23658,151,24,98,1,28,123
23659,52,21,15,3,13,39
23660,109,40,25,23,21,88
23661,38,15,16,0,7,31
23662,166,53,76,0,37,129
23663,23,6,13,0,4,19
23664,196,148,7,0,41,155
23665,13,6,5,0,2,11
23666,65,14,41,0,10,55
23667,126,46,47,13,20,106
23668,9,3,3,1,2,7
23669,71,36,9,15,11,60
23670,507,370,31,1,105,402
23671,65,21,27,3,14,51
23672,132,41,48,17,26,106
23673,26,6,15,0,5,21
23674,41,18,10,5,8,33
23675,38,13,20,1,4,34
23676,39,19,11,0,9,30
23677,70,24,14,20,12,58
23678,171,81,53,1,36,135
23679,98,41,40,0,17,81
23680,28,19,4,0,5,23
23681,159,108,26,0,25,134
23682,65,42,11,2,10,55
23683,46,18,20,0,8,38
23684,63,30,20,0,13,50
23685,357,109,163,6,79,278
23686,51,6,32,0,13,38
23687,134,92,17,2,23,111
23688,83,66,4,2,11,72
23689,124,28,41,30,25,99
23690,33,9,8,7,9,24
23691,21,2,14,0,5,16
23692,256,15,192,1,48,208
23693,36,12,14,0,10,26
23694,85,31,35,6,13,72
23695,13,3,7,0,3,10
23696,32,21,9,0,2,30
23697,16,3,6,3,4,12
23698,214,93,62,20,39,175
23699,38,10,22,0,6,32
23700,182,84,51,8,39,143
23701,4,1,2,0,1,3
23702,557,390,47,1,119,438
23703,258,194,15,0,49,209
23704,430,134,188,12,96,334
23705,27,18,4,2,3,24
23706,70,20,32,1,17,53
23707,19,2,10,0,7,12
23708,5,1,3,0,1,4
23709,67,14,35,1,17,50
23710,75,8,43,5,19,56
23711,144,58,56,8,22,122
23712,467,249,119,20,79,388
23713,37,9,24,1,3,34
23714,115,70,22,0,23,92
23715,106,50,35,1,20,86
23716,63,39,13,1,10,53
23717,32,21,9,0,2,30
23718,54,28,13,5,8,46
23719,58,17,25,4,12,46
23720,31,12,15,0,4,27
23721,41,3,28,0,10,31
23722,46,25,9,0,12,34
23723,164,96,38,1,29,135
23724,16,6,2,3,5,11
23725,119,53,17,18,31,88
23726,322,167,85,15,55,267
23727,34,5,24,1,4,30
23728,50,35,4,3,8,42
23729,37,16,13,0,8,29
23730,20,8,8,0,4,16
23731,60,29,21,0,10,50
23732,14,3,2,6,3,11
23733,76,39,17,0,20,56
23734,190,108,26,21,35,155
23735,34,14,11,1,8,26
23736,46,22,9,6,9,37
23737,36,9,18,0,9,27
23738,88,46,17,8,17,71
23739,16,9,4,1,2,14
23740,5,4,0,0,1,4
23741,37,32,3,0,2,35
23742,130,83,16,4,27,103
23743,37,8,14,3,12,25
23744,45,29,8,0,8,37
23745,127,37,57,7,26,101
23746,142,55,46,9,32,110
23747,49,38,1,0,10,39
23748,19,3,15,0,1,18
23749,67,18,22,18,9,58
23750,16,6,8,0,2,14
23751,183,148,11,1,23,160
23752,9,3,3,0,3,6
23753,36,17,10,3,6,30
23754,1,0,0,1,0,1
23755,32,21,9,0,2,30
23756,50,33,9,0,8,42
23757,73,49,7,1,16,57
23758,46,35,4,0,7,39
23759,106,26,52,2,26,80
23760,211,109,49,0,53,158
23761,17,8,6,0,3,14
23762,42,15,15,2,10,32
23763,29,9,14,0,6,23
23764,287,196,68,3,20,267
23765,32,21,9,0,2,30
23766,96,42,34,3,17,79
23767,201,82,36,34,49,152
23768,27,15,9,0,3,24
23769,37,15,14,0,8,29
23770,26,16,4,1,5,21
23771,29,11,8,0,10,19
23772,21,17,2,2,0,21
23773,26,5,18,0,3,23
23774,14,6,3,2,3,11
23775,49,22,15,2,10,39
23776,61,37,10,5,9,52
23777,136,99,5,0,32,104
23778,51,35,2,1,13,38
23779,22,1,17,0,4,18
23780,98,53,19,5,21,77
23781,50,20,19,1,10,40
23782,162,68,34,21,39,123
23783,55,33,14,0,8,47
23784,225,169,9,0,47,178
23785,236,125,70,0,41,195
23786,45,18,13,0,14,31
23787,76,39,23,0,14,62
23788,42,23,5,3,11,31
23789,84,56,13,0,15,69
23790,155,93,49,1,12,143
23791,21,7,4,5,5,16
23792,18,3,9,1,5,13
23793,38,3,27,1,7,31
23794,30,10,11,0,9,21
23795,253,127,74,11,41,212
23796,12,7,2,0,3,9
23797,57,19,31,0,7,50
23798,105,74,12,11,8,97
23799,350,175,99,2,74,276
23800,32,16,7,4,5,27
23801,60,21,24,1,14,46
23802,114,49,24,16,25,89
23803,71,38,18,0,15,56
23804,9,2,4,0,3,6
23805,152,119,6,0,27,125
23806,68,31,18,0,19,49
23807,32,14,4,6,8,24
23808,21,2,11,1,7,14
23809,29,11,11,1,6,23
23810,57,15,16,15,11,46
23811,48,33,3,3,9,39
23812,79,24,41,0,14,65
23813,56,21,17,4,14,42
23814,19,1,13,1,4,15
23815,151,63,55,7,26,125
23816,45,20,14,2,9,36
23817,110,37,51,1,21,89
23818,91,32,23,11,25,66
23819,19,8,5,0,6,13
23820,106,81,5,0,20,86
23821,39,10,20,0,9,30
23822,81,36,22,10,13,68
23823,210,112,33,21,44,166
23824,88,46,12,2,28,60
23825,20,13,6,1,0,20
23826,56,32,13,0,11,45
23827,106,44,38,2,22,84
23828,87,32,38,2,15,72
23829,164,124,2,1,37,127
23830,46,14,16,8,8,38
23831,152,89,36,0,27,125
23832,33,3,6,16,8,25
23833,135,54,40,15,26,109
23834,32,21,9,0,2,30
23835,22,17,0,0,5,17
23836,26,6,10,6,4,22
23837,64,26,20,2,16,48
23838,101,94,0,7,0,101
23839,216,123,48,4,41,175
23840,204,30,94,33,47,157
23841,35,9,22,0,4,31
23842,42,18,14,0,10,32
23843,260,191,13,1,55,205
23844,22,14,3,2,3,19
23845,164,65,32,26,41,123
23846,173,82,52,4,35,138
23847,287,154,69,0,64,223
23848,28,14,9,2,3,25
23849,25,3,13,1,8,17
23850,28,9,7,9,3,25
23851,50,15,24,3,8,42
23852,42,36,1,0,5,37
23853,7,4,2,0,1,6
23854,4,1,3,0,0,4
23855,29,4,23,0,2,27
23856,122,42,56,4,20,102
23857,21,8,9,2,2,19
23858,50,15,15,10,10,40
23859,8,1,3,0,4,4
23860,174,136,15,1,22,152
23861,194,39,55,60,40,154
23862,384,202,89,17,76,308
23863,62,23,28,2,9,53
23864,109,58,25,4,22,87
23865,407,229,96,0,82,325
23866,190,136,7,3,44,146
23867,28,13,10,0,5,23
23868,80,61,1,0,18,62
23869,64,29,19,4,12,52
23870,189,83,66,11,29,160
23871,86,25,30,11,20,66
23872,123,50,36,13,24,99
23873,279,185,71,3,20,259
23874,186,126,17,0,43,143
23875,34,1,8,18,7,27
23876,180,101,32,1,46,134
23877,556,403,36,1,116,440
23878,234,164,52,2,16,218
23879,24,10,9,1,4,20
23880,71,29,24,0,18,53
23881,69,31,26,2,10,59
23882,48,11,25,0,12,36
23883,101,49,26,5,21,80
23884,15,0,11,0,4,11
23885,317,87,149,6,75,242
23886,285,215,18,0,52,233
23887,63,31,7,5,20,43
23888,75,33,30,0,12,63
23889,13,5,8,0,0,13
23890,156,46,54,21,35,121
23891,26,13,6,1,6,20
23892,664,384,153,20,107,557
23893,147,37,75,1,34,113
23894,219,92,14,76,37,182
23895,45,22,10,3,10,35
23896,86,46,20,4,16,70
23897,17,13,2,0,2,15
23898,2,2,0,0,0,2
23899,123,45,33,18,27,96
23900,39,19,12,0,8,31
23901,28,7,11,1,9,19
23902,65,41,13,1,10,55
23903,32,21,9,0,2,30
23904,117,80,16,3,18,99
23905,92,39,32,8,13,79
23906,19,8,5,0,6,13
23907,141,76,38,8,19,122
23908,64,48,6,2,8,56
23909,220,149,30,0,41,179
23910,569,329,116,18,106,463
23911,233,73,109,12,39,194
23912,133,37,44,18,34,99
23913,24,2,17,0,5,19
23914,42,24,9,0,9,33
23915,210,55,26,92,37,173
23916,200,47,40,76,37,163
23917,13,4,3,0,6,7
23918,57,36,8,2,11,46
23919,23,7,12,1,3,20
23920,60,22,12,17,9,51
23921,2,0,2,0,0,2
23922,34,15,12,1,6,28
23923,30,1,21,0,8,22
23924,150,38,76,1,35,115
23925,22,7,6,2,7,15
23926,138,34,46,29,29,109
23927,53,36,3,1,13,40
23928,39,4,27,0,8,31
23929,161,108,27,0,26,135
23930,85,60,7,0,18,67
23931,9,1,5,1,2,7
23932,81,23,39,2,17,64
23933,629,366,143,16,104,525
23934,29,2,21,1,5,24
23935,312,143,93,14,62,250
23936,8,5,3,0,0,8
23937,22,14,4,1,3,19
23938,43,16,19,1,7,36
23939,510,269,87,48,106,404
23940,62,9,37,4,12,50
23941,55,32,15,2,6,49
23942,28,10,11,0,7,21
23943,17,6,4,1,6,11
23944,16,7,5,0,4,12
23945,71,33,18,3,17,54
23946,68,43,11,3,11,57
23947,61,21,18,11,11,50
23948,220,149,30,0,41,179
23949,111,49,41,2,19,92
23950,14,7,2,2,3,11
23951,37,15,8,3,11,26
23952,61,17,31,1,12,49
23953,53,36,4,1,12,41
23954,41,4,28,0,9,32
23955,55,32,15,2,6,49
23956,46,31,5,0,10,36
23957,62,25,19,1,17,45
23958,89,36,18,17,18,71
23959,67,46,8,0,13,54
23960,8,5,1,0,2,6
23961,432,198,140,8,86,346
23962,79,35,21,12,11,68
23963,59,11,34,4,10,49
23964,151,51,71,0,29,122
23965,31,7,19,0,5,26
23966,33,7,17,1,8,25
23967,87,61,6,0,20,67
23968,102,54,21,6,21,81
23969,38,0,25,0,13,25
23970,73,40,17,0,16,57
23971,133,72,23,13,25,108
23972,14,7,4,0,3,11
23973,165,124,7,0,34,131
23974,82,34,22,12,14,68
23975,190,72,48,29,41,149
23976,99,22,44,13,20,79
23977,21,13,3,0,5,16
23978,102,66,15,3,18,84
23979,130,68,28,6,28,102
23980,13,6,0,3,4,9
23981,94,34,36,10,14,80
23982,70,45,15,7,3,67
23983,247,188,13,0,46,201
23984,47,11,27,1,8,39
23985,65,40,7,3,15,50
23986,8,1,5,0,2,6
23987,19,6,5,1,7,12
23988,56,31,18,0,7,49
23989,131,42,35,28,26,105
23990,39,18,12,2,7,32
23991,24,5,13,0,6,18
23992,12,4,2,2,4,8
23993,42,14,15,1,12,30
23994,82,26,43,0,13,69
23995,68,30,23,0,15,53
23996,91,38,32,1,20,71
23997,114,107,0,7,0,114
23998,94,63,11,1,19,75
23999,19,5,12,1,1,18
24000,13,2,11,0,0,13
24001,77,30,33,0,14,63
24002,54,24,19,1,10,44
24003,275,126,99,5,45,230
24004,56,24,9,14,9,47
24005,111,65,19,7,20,91
24006,93,47,13,2,31,62
24007,34,0,28,0,6,28
24008,70,48,9,3,10,60
24009,446,320,35,0,91,355
24010,73,24,21,10,18,55
24011,37,17,16,0,4,33
24012,15,7,4,0,4,11
24013,136,44,36,29,27,109
24014,51,34,8,0,9,42
24015,1,0,1,0,0,1
24016,38,21,3,0,14,24
24017,22,14,3,0,5,17
24018,68,29,24,0,15,53
24019,70,34,18,3,15,55
24020,9,1,6,0,2,7
24021,118,56,29,9,24,94
24022,21,4,13,1,3,18
24023,48,29,7,0,12,36
24024,57,32,12,0,13,44
24025,15,4,8,0,3,12
24026,39,8,19,0,12,27
24027,220,59,117,5,39,181
24028,132,87,26,3,16,116
24029,77,19,37,7,14,63
24030,39,23,11,1,4,35
24031,7,4,1,0,2,5
24032,59,35,15,3,6,53
24033,391,222,88,0,81,310
24034,256,189,15,0,52,204
24035,36,2,24,0,10,26
24036,57,10,23,12,12,45
24037,157,51,46,33,27,130
24038,41,17,10,6,8,33
24039,41,25,11,1,4,37
24040,39,23,8,0,8,31
24041,17,4,7,1,5,12
24042,140,66,42,10,22,118
24043,28,9,8,1,10,18
24044,67,23,26,2,16,51
24045,65,48,12,0,5,60
24046,90,37,37,3,13,77
24047,99,52,27,0,20,79
24048,57,39,4,1,13,44
24049,55,38,6,1,10,45
24050,632,375,112,9,136,496
24051,104,87,3,2,12,92
24052,148,100,22,0,26,122
24053,422,195,112,29,86,336
24054,176,75,26,30,45,131
24055,112,71,25,0,16,96
24056,43,15,18,0,10,33
24057,40,20,11,1,8,32
24058,7,2,3,1,1,6
24059,17,6,8,0,3,14
24060,31,17,9,0,5,26
24061,17,7,8,0,2,15
24062,44,5,16,11,12,32
24063,502,354,39,1,108,394
24064,14,8,4,0,2,12
24065,56,30,13,0,13,43
24066,33,13,11,0,9,24
24067,25,9,12,0,4,21
24068,48,29,12,0,7,41
24069,46,18,20,0,8,38
24070,53,21,19,0,13,40
24071,140,77,24,7,32,108
24072,114,27,53,5,29,85
24073,55,24,13,6,12,43
24074,70,18,27,11,14,56
24075,128,88,22,0,18,110
24076,440,211,119,14,96,344
24077,31,9,7,10,5,26
24078,79,27,31,8,13,66
24079,356,161,119,5,71,285
24080,60,34,17,1,8,52
24081,32,1,24,1,6,26
24082,50,10,26,0,14,36
24083,12,0,10,0,2,10
24084,70,29,22,4,15,55
24085,13,7,3,0,3,10
24086,59,46,5,0,8,51
24087,16,6,6,0,4,12
24088,19,15,1,0,3,16
24089,69,40,14,3,12,57
24090,9,0,7,0,2,7
24091,80,31,25,8,16,64
24092,106,64,25,8,9,97
24093,80,58,9,5,8,72
24094,75,20,31,11,13,62
24095,56,33,15,2,6,50
24096,74,41,7,5,21,53
24097,13,6,3,0,4,9
24098,203,5,162,0,36,167
24099,168,50,57,26,35,133
24100,31,17,2,4,8,23
24101,39,20,15,0,4,35
24102,10,5,5,0,0,10
24103,78,32,12,17,17,61
24104,29,18,4,0,7,22
24105,48,32,7,1,8,40
24106,83,23,38,3,19,64
24107,19,0,17,0,2,17
24108,46,18,20,0,8,38
24109,40,8,19,5,8,32
24110,52,21,19,0,12,40
24111,29,15,8,2,4,25
24112,10,2,7,0,1,9
24113,489,271,77,41,100,389
24114,146,84,21,3,38,108
24115,4,2,1,0,1,3
24116,46,18,20,0,8,38
24117,19,11,4,0,4,15
24118,130,41,50,14,25,105
24119,46,18,20,0,8,38
24120,24,10,10,1,3,21
24121,6,1,0,4,1,5
24122,87,67,0,4,16,71
24123,22,0,18,2,2,20
24124,54,22,23,0,9,45
24125,101,53,26,4,18,83
24126,38,12,16,0,10,28
24127,40,22,7,4,7,33
24128,73,30,20,1,22,51
24129,42,21,16,1,4,38
24130,63,30,23,0,10,53
24131,218,147,30,0,41,177
24132,58,40,11,5,2,56
24133,151,113,9,5,24,127
24134,33,24,5,0,4,29
24135,97,40,29,8,20,77
24136,12,4,4,0,4,8
24137,83,36,33,1,13,70
24138,12,3,7,0,2,10
24139,77,17,18,32,10,67
24140,499,233,110,52,104,395
24141,91,53,20,0,18,73
24142,15,3,5,3,4,11
24143,202,13,150,0,39,163
24144,306,150,96,5,55,251
24145,135,91,19,1,24,111
24146,64,26,19,5,14,50
24147,31,1,23,1,6,25
24148,22,9,5,2,6,16
24149,26,16,6,0,4,22
24150,2,1,0,0,1,1
24151,672,388,144,20,120,552
24152,62,20,30,2,10,52
24153,65,17,28,2,18,47
24154,30,3,19,2,6,24
24155,46,26,15,0,5,41
24156,49,32,6,2,9,40
24157,68,40,15,6,7,61
24158,15,3,7,0,5,10
24159,27,24,1,0,2,25
24160,64,22,31,2,9,55
24161,120,44,32,15,29,91
24162,76,5,54,1,16,60
24163,5,1,0,1,3,2
24164,450,236,105,13,96,354
24165,139,61,39,13,26,113
24166,102,57,19,4,22,80
24167,129,28,60,18,23,106
24168,345,186,88,15,56,289
24169,198,99,49,0,50,148
24170,107,21,62,1,23,84
24171,265,16,196,2,51,214
24172,40,22,14,1,3,37
24173,32,21,9,0,2,30
24174,132,100,4,2,26,106
24175,641,370,149,17,105,536
24176,59,31,20,0,8,51
24177,197,100,33,28,36,161
24178,473,219,159,13,82,391
24179,54,22,13,9,10,44
24180,129,77,27,0,25,104
24181,33,19,6,0,8,25
24182,102,65,22,0,15,87
24183,65,27,22,3,13,52
24184,115,74,10,13,18,97
24185,71,27,6,23,15,56
24186,50,30,12,0,8,42
24187,465,129,197,38,101,364
24188,264,181,61,2,20,244
24189,50,5,31,0,14,36
24190,69,7,7,35,20,49
24191,49,36,8,1,4,45
24192,288,131,80,25,52,236
24193,22,8,9,2,3,19
24194,139,38,44,21,36,103
24195,23,13,0,5,5,18
24196,21,11,2,5,3,18
24197,174,85,54,7,28,146
24198,369,187,98,19,65,304
24199,74,26,29,3,16,58
24200,23,14,6,1,2,21
24201,46,18,20,0,8,38
24202,158,26,102,1,29,129
24203,39,25,8,0,6,33
24204,204,33,90,32,49,155
24205,34,14,12,1,7,27
24206,36,2,28,0,6,30
24207,412,190,120,12,90,322
24208,51,24,10,5,12,39
24209,107,56,22,7,22,85
24210,419,196,121,14,88,331
24211,138,104,12,0,22,116
24212,65,20,23,8,14,51
24213,46,13,18,4,11,35
24214,21,1,4,12,4,17
24215,34,3,22,0,9,25
24216,131,35,67,1,28,103
24217,53,22,13,6,12,41
24218,25,12,9,0,4,21
24219,65,33,12,3,17,48
24220,19,6,11,0,2,17
24221,41,27,4,5,5,36
24222,625,369,134,15,107,518
24223,27,14,10,2,1,26
24224,63,42,2,2,17,46
24225,51,5,33,1,12,39
24226,46,19,10,8,9,37
24227,180,127,15,1,37,143
24228,651,374,152,17,108,543
24229,272,141,88,0,43,229
24230,43,28,7,1,7,36
24231,23,9,8,0,6,17
24232,163,63,56,19,25,138
24233,410,233,100,0,77,333
24234,139,55,46,14,24,115
24235,78,44,18,2,14,64
24236,104,30,56,0,18,86
24237,65,32,20,1,12,53
24238,27,1,20,0,6,21
24239,155,47,49,23,36,119
24240,68,46,10,1,11,57
24241,238,109,83,0,46,192
24242,69,14,22,21,12,57
24243,222,149,32,0,41,181
24244,48,32,8,0,8,40
24245,77,37,21,0,19,58
24246,170,81,52,3,34,136
24247,350,183,93,15,59,291
24248,33,8,17,0,8,25
24249,161,106,24,1,30,131
24250,140,65,46,5,24,116
24251,18,1,13,0,4,14
24252,232,126,53,14,39,193
24253,9,7,0,1,1,8
24254,140,68,45,0,27,113
24255,8,1,5,0,2,6
24256,95,39,38,1,17,78
24257,211,114,47,0,50,161
24258,41,25,8,0,8,33
24259,37,23,5,1,8,29
24260,56,37,12,0,7,49
24261,13,7,1,3,2,11
24262,10,3,4,0,3,7
24263,65,35,17,1,12,53
24264,19,11,5,0,3,16
24265,53,15,26,7,5,48
24266,72,5,50,1,16,56
24267,98,42,33,5,18,80
24268,15,3,10,0,2,13
24269,103,24,34,17,28,75
24270,37,14,13,3,7,30
24271,45,32,5,1,7,38
24272,44,22,14,0,8,36
24273,272,100,112,15,45,227
24274,109,69,19,2,19,90
24275,109,90,3,3,13,96
24276,79,60,5,4,10,69
24277,162,93,21,19,29,133
24278,411,109,164,47,91,320
24279,79,38,25,0,16,63
24280,22,8,12,0,2,20
24281,58,34,16,0,8,50
24282,541,397,32,1,111,430
24283,74,23,24,6,21,53
24284,82,22,48,0,12,70
24285,27,12,12,0,3,24
24286,13,4,5,0,4,9
24287,41,2,34,0,5,36
24288,1075,394,432,46,203,872
24289,189,59,61,24,45,144
24290,103,65,11,2,25,78
24291,672,391,141,21,119,553
24292,635,352,159,22,102,533
24293,19,1,15,0,3,16
24294,124,95,2,1,26,98
24295,139,59,40,14,26,113
24296,88,52,20,0,16,72
24297,35,15,12,0,8,27
24298,39,2,19,12,6,33
24299,415,111,168,46,90,325
24300,74,29,25,4,16,58
24301,35,6,23,3,3,32
24302,104,50,36,1,17,87
24303,28,2,21,1,4,24
24304,240,72,114,2,52,188
24305,9,6,0,0,3,6
24306,43,27,8,0,8,35
24307,77,20,26,9,22,55
24308,240,91,54,37,58,182
24309,33,14,12,0,7,26
24310,25,17,0,0,8,17
24311,38,3,28,2,5,33
24312,5,0,4,0,1,4
24313,173,46,92,4,31,142
24314,337,180,87,15,55,282
24315,49,28,13,0,8,41
24316,92,54,19,0,19,73
24317,84,21,43,11,9,75
24318,68,35,23,0,10,58
24319,126,71,31,0,24,102
24320,222,131,18,26,47,175
24321,52,7,34,0,11,41
24322,12,0,11,0,1,11
24323,100,21,64,0,15,85
24324,153,65,48,9,31,122
24325,63,27,9,13,14,49
24326,59,22,30,0,7,52
24327,9,6,2,0,1,8
24328,24,13,8,0,3,21
24329,63,14,17,17,15,48
24330,43,10,21,0,12,31
24331,18,0,6,9,3,15
24332,32,21,9,0,2,30
24333,16,13,2,0,1,15
24334,391,175,96,37,83,308
24335,15,6,3,4,2,13
24336,30,4,16,4,6,24
24337,82,66,2,0,14,68
24338,37,3,26,0,8,29
24339,51,27,8,5,11,40
24340,15,5,8,0,2,13
24341,152,44,61,20,27,125
24342,88,42,27,4,15,73
24343,12,4,3,1,4,8
24344,87,51,19,4,13,74
24345,9,1,6,0,2,7
24346,127,64,22,14,27,100
24347,91,43,27,5,16,75
24348,46,18,20,0,8,38
24349,48,20,16,2,10,38
24350,60,21,25,7,7,53
24351,55,39,10,5,1,54
24352,164,37,16,84,27,137
24353,563,387,51,1,124,439
24354,73,45,10,2,16,57
24355,63,33,19,3,8,55
24356,475,238,119,18,100,375
24357,32,21,9,0,2,30
24358,420,197,137,11,75,345
24359,27,9,7,2,9,18
24360,122,103,2,0,17,105
24361,32,2,15,2,13,19
24362,220,117,34,26,43,177
24363,119,71,25,0,23,96
24364,46,13,21,0,12,34
24365,59,6,49,0,4,55
24366,222,75,82,15,50,172
24367,24,5,17,0,2,22
24368,45,24,16,0,5,40
24369,23,8,2,7,6,17
24370,48,9,25,2,12,36
24371,53,37,4,1,11,42
24372,71,36,13,7,15,56
24373,141,95,3,10,33,108
24374,205,87,43,26,49,156
24375,155,69,26,23,37,118
24376,40,28,2,0,10,30
24377,43,25,5,3,10,33
24378,29,19,6,0,4,25
24379,63,22,14,8,19,44
24380,38,21,3,0,14,24
24381,81,41,16,7,17,64
24382,43,4,30,0,9,34
24383,46,24,3,11,8,38
24384,111,53,42,3,13,98
24385,95,61,11,2,21,74
24386,43,25,10,0,8,35
24387,190,13,138,0,39,151
24388,97,48,30,1,18,79
24389,133,94,6,3,30,103
24390,95,64,6,0,25,70
24391,32,16,10,0,6,26
24392,80,36,22,12,10,70
24393,61,15,33,4,9,52
24394,27,12,9,2,4,23
24395,425,194,138,8,85,340
24396,48,22,15,2,9,39
24397,67,10,49,0,8,59
24398,3,0,3,0,0,3
24399,33,8,11,6,8,25
24400,139,45,71,0,23,116
24401,17,4,9,0,4,13
24402,92,75,3,0,14,78
24403,46,13,16,11,6,40
24404,25,9,7,0,9,16
24405,16,2,9,1,4,12
24406,40,6,5,19,10,30
24407,159,96,40,13,10,149
24408,32,21,9,0,2,30
24409,29,13,7,1,8,21
24410,57,19,30,1,7,50
24411,68,49,2,0,17,51
24412,24,9,9,0,6,18
24413,63,47,6,0,10,53
24414,102,10,58,15,19,83
24415,175,126,16,3,30,145
24416,82,54,11,0,17,65
24417,15,11,0,1,3,12
24418,10,1,9,0,0,10
24419,46,25,11,2,8,38
24420,146,61,31,19,35,111
24421,74,39,23,0,12,62
24422,94,31,37,6,20,74
24423,105,29,57,0,19,86
24424,32,13,10,0,9,23
24425,52,23,21,0,8,44
24426,40,19,9,3,9,31
24427,67,26,28,1,12,55
24428,30,0,24,0,6,24
24429,33,3,6,16,8,25
24430,269,202,14,0,53,216
24431,48,16,20,1,11,37
24432,231,152,35,1,43,188
24433,98,52,12,18,16,82
24434,137,77,23,3,34,103
24435,32,7,19,1,5,27
24436,45,7,25,6,7,38
24437,81,55,15,1,10,71
24438,49,16,22,1,10,39
24439,279,16,209,0,54,225
24440,66,2,43,15,6,60
24441,99,49,27,5,18,81
24442,53,34,5,0,14,39
24443,120,74,23,0,23,97
24444,515,356,48,1,110,405
24445,83,37,37,1,8,75
24446,39,25,6,4,4,35
24447,289,82,144,4,59,230
24448,79,38,17,0,24,55
24449,33,7,13,2,11,22
24450,60,10,30,4,16,44
24451,136,47,55,0,34,102
24452,27,7,6,7,7,20
24453,655,377,152,19,107,548
24454,200,57,105,5,33,167
24455,72,38,18,3,13,59
24456,342,152,114,9,67,275
24457,87,39,33,1,14,73
24458,134,75,22,4,33,101
24459,95,45,35,0,15,80
24460,58,26,8,11,13,45
24461,34,7,21,1,5,29
24462,95,42,24,12,17,78
24463,180,78,30,28,44,136
24464,91,72,6,1,12,79
24465,63,22,29,0,12,51
24466,6,4,0,0,2,4
24467,51,27,13,4,7,44
24468,49,34,5,0,10,39
24469,46,18,20,0,8,38
24470,50,14,23,2,11,39
24471,132,70,42,9,11,121
24472,40,8,22,3,7,33
24473,46,32,8,0,6,40
24474,89,29,43,2,15,74
24475,16,10,3,0,3,13
24476,143,95,22,1,25,118
24477,129,50,44,15,20,109
24478,39,23,6,2,8,31
24479,143,65,41,0,37,106
24480,148,83,36,0,29,119
24481,32,21,9,0,2,30
24482,160,114,11,0,35,125
24483,32,21,9,0,2,30
24484,36,6,18,1,11,25
24485,26,1,11,7,7,19
24486,233,155,32,0,46,187
24487,28,14,6,3,5,23
24488,64,12,40,0,12,52
24489,200,134,19,2,45,155
24490,28,4,20,1,3,25
24491,49,10,28,1,10,39
24492,21,9,6,0,6,15
24493,46,31,5,3,7,39
24494,1025,386,401,46,192,833
24495,220,149,30,0,41,179
24496,41,0,27,0,14,27
24497,81,11,47,6,17,64
24498,365,158,128,11,68,297
24499,58,19,23,4,12,46
24500,456,164,154,41,97,359
24501,32,21,9,0,2,30
24502,25,15,6,0,4,21
24503,40,12,20,1,7,33
24504,287,31,198,4,54,233
24505,33,23,8,2,0,33
24506,127,65,12,22,28,99
24507,47,29,11,1,6,41
24508,45,31,0,0,14,31
24509,45,24,12,0,9,36
24510,294,25,209,2,58,236
24511,104,30,39,13,22,82
24512,30,14,14,1,1,29
24513,26,13,7,0,6,20
24514,19,15,0,0,4,15
24515,370,214,79,0,77,293
24516,38,20,10,0,8,30
24517,87,50,23,1,13,74
24518,39,21,9,0,9,30
24519,70,27,25,4,14,56
24520,55,38,6,1,10,45
24521,1,0,1,0,0,1
24522,53,22,22,2,7,46
24523,43,5,29,0,9,34
24524,233,163,25,3,42,191
24525,31,10,10,4,7,24
24526,101,51,24,0,26,75
24527,81,45,16,2,18,63
24528,350,148,89,37,76,274
24529,16,1,10,0,5,11
24530,27,10,11,2,4,23
24531,38,9,21,4,4,34
24532,65,27,19,2,17,48
24533,110,58,14,13,25,85
24534,63,12,13,28,10,53
24535,32,21,9,0,2,30
24536,37,21,6,2,8,29
24537,29,8,13,2,6,23
24538,30,22,3,1,4,26
24539,5,4,0,0,1,4
24540,88,61,5,9,13,75
24541,23,11,8,2,2,21
24542,55,12,38,0,5,50
24543,40,1,34,4,1,39
24544,55,33,10,0,12,43
24545,29,6,20,0,3,26
24546,143,86,30,0,27,116
24547,74,28,23,4,19,55
24548,57,29,13,5,10,47
24549,500,242,104,56,98,402
24550,36,1,27,1,7,29
24551,3,3,0,0,0,3
24552,68,47,5,0,16,52
24553,84,27,29,11,17,67
24554,127,74,22,3,28,99
24555,273,125,98,6,44,229
24556,426,239,100,0,87,339
24557,69,33,17,8,11,58
24558,83,63,5,4,11,72
24559,118,55,34,6,23,95
24560,20,0,15,2,3,17
24561,11,3,7,1,0,11
24562,5,1,3,0,1,4
24563,44,35,2,0,7,37
24564,8,1,1,0,6,2
24565,241,56,24,121,40,201
24566,42,29,4,1,8,34
24567,32,9,15,3,5,27
24568,42,0,31,0,11,31
24569,222,75,82,15,50,172
24570,101,37,38,6,20,81
24571,47,26,13,0,8,39
24572,206,125,41,3,37,169
24573,60,14,40,0,6,54
24574,139,105,9,2,23,116
24575,25,7,11,0,7,18
24576,39,35,0,0,4,35
24577,14,3,10,0,1,13
24578,60,14,40,0,6,54
24579,73,43,13,0,17,56
24580,49,33,5,2,9,40
24581,37,22,3,0,12,25
24582,195,98,34,28,35,160
24583,55,29,8,3,15,40
24584,195,76,34,34,51,144
24585,191,106,28,22,35,156
24586,111,73,16,1,21,90
24587,554,326,103,10,115,439
24588,30,8,13,4,5,25
24589,111,80,9,4,18,93
24590,49,30,7,8,4,45
24591,59,43,4,0,12,47
24592,59,42,10,5,2,57
24593,121,46,44,13,18,103
24594,10,5,0,0,5,5
24595,22,3,9,4,6,16
24596,32,9,15,0,8,24
24597,32,21,9,0,2,30
24598,51,29,16,0,6,45
24599,502,268,85,48,101,401
24600,58,35,6,7,10,48
24601,85,56,14,0,15,70
24602,39,21,16,0,2,37
24603,48,28,9,2,9,39
24604,170,60,75,0,35,135
24605,81,29,38,1,13,68
24606,131,63,17,19,32,99
24607,12,2,8,1,1,11
24608,27,2,19,2,4,23
24609,98,29,48,1,20,78
24610,90,70,0,4,16,74
24611,211,152,11,7,41,170
24612,44,18,19,0,7,37
24613,36,11,16,1,8,28
24614,46,18,20,0,8,38
24615,262,193,16,0,53,209
24616,223,90,41,37,55,168
24617,237,133,57,0,47,190
24618,55,39,5,2,9,46
24619,55,25,17,1,12,43
24620,71,47,7,0,17,54
24621,194,135,45,2,12,182
24622,74,29,9,17,19,55
24623,119,58,22,16,23,96
24624,27,17,3,0,7,20
24625,123,55,46,1,21,102
24626,118,49,36,14,19,99
24627,64,37,13,0,14,50
24628,161,115,11,0,35,126
24629,10,1,7,0,2,8
24630,187,12,140,0,35,152
24631,375,117,153,24,81,294
24632,31,22,3,0,6,25
24633,32,7,17,1,7,25
24634,24,13,4,0,7,17
24635,51,22,15,5,9,42
24636,9,2,7,0,0,9
24637,57,7,35,5,10,47
24638,127,107,2,0,18,109
24639,177,136,3,1,37,140
24640,94,37,22,17,18,76
24641,65,30,19,1,15,50
24642,37,3,25,0,9,28
24643,55,15,25,0,15,40
24644,138,81,31,0,26,112
24645,12,6,4,2,0,12
24646,44,23,5,7,9,35
24647,285,149,94,0,42,243
24648,81,31,33,2,15,66
24649,64,49,11,0,4,60
24650,29,2,19,2,6,23
24651,46,18,20,0,8,38
24652,394,204,114,3,73,321
24653,97,27,51,0,19,78
24654,121,67,30,2,22,99
24655,74,27,19,18,10,64
24656,53,20,21,1,11,42
24657,385,198,90,21,76,309
24658,59,19,25,1,14,45
24659,19,11,5,0,3,16
24660,94,46,5,28,15,79
24661,68,32,27,0,9,59
24662,46,26,13,0,7,39
24663,34,8,16,0,10,24
24664,59,46,2,0,11,48
24665,272,66,72,77,57,215
24666,32,21,9,0,2,30
24667,33,9,12,4,8,25
24668,64,22,27,1,14,50
24669,61,20,29,2,10,51
24670,41,12,21,1,7,34
24671,24,6,13,1,4,20
24672,21,8,9,0,4,17
24673,72,35,17,8,12,60
24674,107,70,8,5,24,83
24675,108,23,50,14,21,87
24676,89,39,28,3,19,70
24677,36,17,10,0,9,27
24678,60,26,16,3,15,45
24679,1309,528,184,337,260,1049
24680,323,145,104,6,68,255
24681,156,121,7,0,28,128
24682,74,37,22,0,15,59
24683,137,77,23,3,34,103
24684,115,77,23,3,12,103
24685,96,53,18,0,25,71
24686,66,27,15,10,14,52
24687,22,3,13,0,6,16
24688,82,41,15,10,16,66
24689,12,6,3,3,0,12
24690,39,5,26,0,8,31
24691,37,11,16,0,10,27
24692,26,5,16,0,5,21
24693,44,27,5,6,6,38
24694,99,41,19,13,26,73
24695,7,0,4,0,3,4
24696,60,30,3,14,13,47
24697,31,15,12,3,1,30
24698,18,12,1,1,4,14
24699,73,28,7,22,16,57
24700,14,4,4,0,6,8
24701,132,103,10,0,19,113
24702,6,2,1,0,3,3
24703,25,14,2,5,4,21
24704,54,35,12,0,7,47
24705,68,53,1,0,14,54
24706,6,3,3,0,0,6
24707,3,1,0,1,1,2
24708,58,13,28,8,9,49
24709,59,40,7,0,12,47
24710,49,33,2,1,13,36
24711,109,56,29,5,19,90
24712,56,15,28,0,13,43
24713,1297,525,179,336,257,1040
24714,46,18,20,0,8,38
24715,101,26,51,3,21,80
24716,18,7,5,2,4,14
24717,38,23,7,0,8,30
24718,32,21,9,0,2,30
24719,87,34,31,4,18,69
24720,32,21,9,0,2,30
24721,85,35,30,5,15,70
24722,118,93,5,0,20,98
24723,47,20,19,0,8,39
24724,32,21,9,0,2,30
24725,32,15,9,3,5,27
24726,37,11,19,0,7,30
24727,201,98,59,1,43,158
24728,23,9,7,1,6,17
24729,30,0,6,19,5,25
24730,527,230,131,49,117,410
24731,64,21,31,2,10,54
24732,27,11,9,0,7,20
24733,54,33,3,9,9,45
24734,43,19,8,0,16,27
24735,58,26,23,2,7,51
24736,82,30,35,2,15,67
24737,28,13,6,0,9,19
24738,35,30,0,0,5,30
24739,23,13,2,3,5,18
24740,4,0,4,0,0,4
24741,68,23,35,1,9,59
24742,220,89,39,38,54,166
24743,51,31,6,3,11,40
24744,81,32,8,18,23,58
24745,592,413,51,1,127,465
24746,142,61,32,17,32,110
24747,30,2,21,1,6,24
24748,261,134,88,0,39,222
24749,43,21,11,0,11,32
24750,111,39,42,11,19,92
24751,30,12,15,0,3,27
24752,5,0,5,0,0,5
24753,25,16,5,0,4,21
24754,67,14,31,9,13,54
24755,32,21,9,0,2,30
24756,29,7,15,0,7,22
24757,121,44,40,15,22,99
24758,22,2,16,0,4,18
24759,54,8,33,2,11,43
24760,45,19,14,3,9,36
24761,129,66,12,23,28,101
24762,120,55,38,1,26,94
24763,31,13,7,5,6,25
24764,29,0,22,3,4,25
24765,81,41,15,10,15,66
24766,11,10,0,0,1,10
24767,421,236,85,13,87,334
24768,49,25,20,0,4,45
24769,18,3,8,4,3,15
24770,25,9,4,8,4,21
24771,33,3,5,17,8,25
24772,597,436,40,1,120,477
24773,48,25,14,2,7,41
24774,90,47,24,1,18,72
24775,6,2,2,0,2,4
24776,464,246,103,17,98,366
24777,48,33,6,3,6,42
24778,23,6,13,0,4,19
24779,37,10,19,4,4,33
24780,22,11,8,0,3,19
24781,190,87,51,13,39,151
24782,32,15,14,1,2,30
24783,47,23,14,1,9,38
24784,60,45,1,0,14,46
24785,39,9,4,18,8,31
24786,23,13,4,0,6,17
24787,53,29,11,1,12,41
24788,157,48,82,4,23,134
24789,332,165,104,5,58,274
24790,65,14,28,9,14,51
24791,30,7,15,0,8,22
24792,344,179,97,1,67,277
24793,42,34,0,0,8,34
24794,32,21,9,0,2,30
24795,37,14,14,0,9,28
24796,128,70,30,0,28,100
24797,53,7,36,0,10,43
24798,92,40,34,4,14,78
24799,356,204,76,17,59,297
24800,41,23,4,3,11,30
24801,376,219,79,0,78,298
24802,49,12,23,1,13,36
24803,88,38,33,1,16,72
24804,46,18,20,0,8,38
24805,36,14,14,1,7,29
24806,32,21,9,0,2,30
24807,37,17,13,1,6,31
24808,41,13,19,0,9,32
24809,106,58,22,7,19,87
24810,274,187,63,3,21,253
24811,379,287,20,0,72,307
24812,58,30,14,1,13,45
24813,52,32,7,2,11,41
24814,62,19,32,2,9,53
24815,46,18,20,0,8,38
24816,61,50,0,1,10,51
24817,93,65,10,1,17,76
24818,76,19,26,16,15,61
24819,13,3,5,0,5,8
24820,67,38,15,0,14,53
24821,38,6,23,4,5,33
24822,133,48,62,0,23,110
24823,122,91,4,2,25,97
24824,26,7,9,2,8,18
24825,67,31,17,8,11,56
24826,234,125,35,29,45,189
24827,69,19,39,1,10,59
24828,18,4,11,0,3,15
24829,558,400,41,1,116,442
24830,6,5,0,1,0,6
24831,17,10,4,0,3,14
24832,435,216,113,11,95,340
24833,141,108,3,2,28,113
24834,136,59,30,16,31,105
24835,60,25,24,0,11,49
24836,18,9,6,1,2,16
24837,7,3,2,0,2,5
24838,64,21,26,4,13,51
24839,655,387,140,18,110,545
24840,31,26,0,0,5,26
24841,41,15,13,5,8,33
24842,49,5,31,1,12,37
24843,61,26,22,1,12,49
24844,27,14,10,0,3,24
24845,104,38,40,11,15,89
24846,49,30,8,2,9,40
24847,245,175,22,5,43,202
24848,173,116,11,10,36,137
24849,93,30,4,45,14,79
24850,11,5,5,0,1,10
24851,40,31,1,0,8,32
24852,117,87,8,0,22,95
24853,34,14,11,0,9,25
24854,29,17,6,0,6,23
24855,46,18,20,0,8,38
24856,233,64,119,4,46,187
24857,91,39,33,1,18,73
24858,56,27,17,0,12,44
24859,10,4,3,0,3,7
24860,24,11,7,2,4,20
24861,75,42,10,7,16,59
24862,93,44,34,0,15,78
24863,259,54,153,4,48,211
24864,26,4,13,0,9,17
24865,72,36,15,0,21,51
24866,444,224,114,12,94,350
24867,27,16,7,0,4,23
24868,218,93,54,25,46,172
24869,73,41,17,1,14,59
24870,13,2,8,0,3,10
24871,261,51,156,3,51,210
24872,75,26,30,2,17,58
24873,17,3,10,0,4,13
24874,83,42,4,24,13,70
24875,10,3,4,1,2,8
24876,2,1,0,0,1,1
24877,30,20,3,0,7,23
24878,87,35,36,1,15,72
24879,42,27,5,4,6,36
24880,35,12,14,0,9,26
24881,165,24,102,1,38,127
24882,82,41,26,0,15,67
24883,14,1,8,3,2,12
24884,65,48,12,0,5,60
24885,14,3,2,6,3,11
24886,1,0,1,0,0,1
24887,44,9,27,1,7,37
24888,36,8,17,3,8,28
24889,10,4,1,2,3,7
24890,238,126,35,29,48,190
24891,73,44,13,2,14,59
24892,13,3,7,1,2,11
24893,65,38,18,0,9,56
24894,89,27,44,2,16,73
24895,95,60,17,0,18,77
24896,27,23,0,0,4,23
24897,5,4,0,0,1,4
24898,17,1,13,0,3,14
24899,283,159,35,32,57,226
24900,50,28,14,0,8,42
24901,49,28,10,3,8,41
24902,84,27,29,11,17,67
24903,67,29,19,3,16,51
24904,588,411,50,1,126,462
24905,87,67,0,4,16,71
24906,474,217,161,12,84,390
24907,11,3,3,1,4,7
24908,93,39,25,12,17,76
24909,35,15,10,0,10,25
24910,40,19,11,2,8,32
24911,74,31,30,3,10,64
24912,291,142,84,4,61,230
24913,31,19,3,0,9,22
24914,24,5,15,0,4,20
24915,98,25,50,3,20,78
24916,92,25,45,7,15,77
24917,85,33,32,10,10,75
24918,292,36,201,2,53,239
24919,288,210,18,2,58,230
24920,2,1,1,0,0,2
24921,210,84,38,34,54,156
24922,620,422,62,2,134,486
24923,113,41,28,24,20,93
24924,140,80,23,3,34,106
24925,57,6,35,1,15,42
24926,28,4,8,10,6,22
24927,41,27,9,0,5,36
24928,103,38,47,0,18,85
24929,32,16,14,0,2,30
24930,67,22,6,22,17,50
24931,41,10,10,15,6,35
24932,46,18,20,0,8,38
24933,108,41,39,6,22,86
24934,76,61,5,0,10,66
24935,30,16,5,0,9,21
24936,158,125,5,5,23,135
24937,56,39,11,5,1,55
24938,33,13,12,1,7,26
24939,99,33,26,21,19,80
24940,10,3,5,1,1,9
24941,109,45,39,2,23,86
24942,59,31,20,0,8,51
24943,50,28,14,0,8,42
24944,8,3,3,0,2,6
24945,63,32,17,1,13,50
24946,10,0,9,0,1,9
24947,10,2,8,0,0,10
24948,32,21,9,0,2,30
24949,6,2,0,2,2,4
24950,103,69,8,5,21,82
24951,140,81,22,3,34,106
24952,26,4,14,0,8,18
24953,231,86,91,13,41,190
24954,136,46,49,7,34,102
24955,32,21,9,0,2,30
24956,41,26,2,3,10,31
24957,40,24,10,4,2,38
24958,8,0,5,1,2,6
24959,8,4,3,0,1,7
24960,170,112,27,1,30,140
24961,447,236,117,18,76,371
24962,25,13,9,1,2,23
24963,64,19,32,1,12,52
24964,13,4,3,1,5,8
24965,69,47,8,4,10,59
24966,112,59,16,15,22,90
24967,31,22,0,2,7,24
24968,12,3,4,1,4,8
24969,94,22,52,3,17,77
24970,46,13,24,0,9,37
24971,110,80,5,1,24,86
24972,49,17,21,2,9,40
24973,117,52,26,12,27,90
24974,80,54,16,1,9,71
24975,192,139,14,1,38,154
24976,64,39,12,2,11,53
24977,35,20,7,0,8,27
24978,48,11,28,1,8,40
24979,46,36,1,0,9,37
24980,198,88,52,20,38,160
24981,80,38,24,0,18,62
24982,91,57,17,2,15,76
24983,84,46,3,16,19,65
24984,257,195,12,0,50,207
24985,5,5,0,0,0,5
24986,59,7,35,1,16,43
24987,50,26,14,1,9,41
24988,26,5,19,0,2,24
24989,25,2,17,1,5,20
24990,49,14,28,1,6,43
24991,16,5,9,0,2,14
24992,19,4,9,0,6,13
24993,72,22,22,21,7,65
24994,36,17,11,0,8,28
24995,77,19,37,7,14,63
24996,17,1,13,0,3,14
24997,29,6,16,0,7,22
24998,9,6,2,1,0,9
24999,250,184,15,0,51,199
25000,9,7,0,0,2,7
25001,22,4,15,0,3,19
25002,88,46,11,2,29,59
25003,21,8,7,2,4,17
25004,31,5,17,4,5,26
25005,39,13,17,0,9,30
25006,74,36,20,0,18,56
25007,219,60,108,14,37,182
25008,68,17,3,32,16,52
25009,106,83,8,0,15,91
25010,94,59,12,2,21,73
25011,17,4,7,0,6,11
25012,92,33,29,10,20,72
25013,167,81,52,3,31,136
25014,112,106,0,6,0,112
25015,206,96,73,1,36,170
25016,57,23,11,8,15,42
25017,629,349,157,22,101,528
25018,7,5,0,1,1,6
25019,46,18,20,0,8,38
25020,185,124,12,10,39,146
25021,56,20,25,0,11,45
25022,51,26,10,6,9,42
25023,357,195,89,15,58,299
25024,74,42,6,6,20,54
25025,41,17,14,1,9,32
25026,97,51,28,1,17,80
25027,150,24,97,1,28,122
25028,228,123,35,26,44,184
25029,64,34,9,6,15,49
25030,43,35,1,0,7,36
25031,305,101,128,13,63,242
25032,51,22,22,1,6,45
25033,13,6,7,0,0,13
25034,19,3,10,0,6,13
25035,111,85,4,2,20,91
25036,78,52,7,1,18,60
25037,13,8,2,2,1,12
25038,195,55,32,74,34,161
25039,11,1,9,0,1,10
25040,8,0,2,0,6,2
25041,154,47,49,23,35,119
25042,39,19,10,0,10,29
25043,54,22,23,0,9,45
25044,53,22,20,1,10,43
25045,64,33,6,8,17,47
25046,46,25,5,6,10,36
25047,27,12,8,0,7,20
25048,12,5,4,2,1,11
25049,291,79,148,2,62,229
25050,204,96,62,1,45,159
25051,3,2,0,0,1,2
25052,26,10,11,0,5,21
25053,19,6,8,0,5,14
25054,160,114,11,0,35,125
25055,16,8,5,0,3,13
25056,44,11,10,13,10,34
25057,28,12,8,2,6,22
25058,37,9,21,0,7,30
25059,53,22,14,6,11,42
25060,40,7,24,0,9,31
25061,46,18,20,0,8,38
25062,5,3,0,0,2,3
25063,106,39,25,19,23,83
25064,84,32,16,15,21,63
25065,450,137,185,32,96,354
25066,62,31,18,4,9,53
25067,29,11,11,0,7,22
25068,53,40,2,2,9,44
25069,140,93,28,11,8,132
25070,77,40,26,0,11,66
25071,170,54,90,4,22,148
25072,53,36,4,1,12,41
25073,429,236,93,12,88,341
25074,138,104,5,2,27,111
25075,251,133,60,13,45,206
25076,54,17,18,4,15,39
25077,21,6,9,0,6,15
25078,191,88,47,18,38,153
25079,45,11,14,8,12,33
25080,99,41,21,17,20,79
25081,48,3,9,20,16,32
25082,30,7,11,5,7,23
25083,74,5,52,1,16,58
25084,28,6,17,0,5,23
25085,112,42,41,6,23,89
25086,15,4,8,2,1,14
25087,239,179,18,2,40,199
25088,217,116,65,0,36,181
25089,13,6,4,1,2,11
25090,44,16,16,6,6,38
25091,73,41,25,2,5,68
25092,80,33,21,12,14,66
25093,41,20,12,1,8,33
25094,55,16,31,1,7,48
25095,32,17,13,0,2,30
25096,38,7,23,0,8,30
25097,58,26,21,0,11,47
25098,29,11,11,1,6,23
25099,10,2,5,0,3,7
25100,74,53,7,3,11,63
25101,34,13,12,2,7,27
25102,59,6,37,1,15,44
25103,40,8,10,15,7,33
25104,36,21,6,2,7,29
25105,19,9,8,0,2,17
25106,19,8,7,0,4,15
25107,439,137,184,20,98,341
25108,74,26,36,0,12,62
25109,90,32,18,10,30,60
25110,63,43,11,0,9,54
25111,23,12,6,0,5,18
25112,29,13,11,0,5,24
25113,36,5,26,1,4,32
25114,46,18,20,0,8,38
25115,543,388,40,1,114,429
25116,119,35,51,7,26,93
25117,214,118,32,23,41,173
25118,76,25,31,7,13,63
25119,77,17,46,0,14,63
25120,58,31,16,1,10,48
25121,31,18,3,0,10,21
25122,79,47,20,0,12,67
25123,39,16,14,2,7,32
25124,51,32,4,6,9,42
25125,7,5,0,0,2,5
25126,111,49,15,22,25,86
25127,80,27,36,4,13,67
25128,54,9,38,1,6,48
25129,49,32,6,2,9,40
25130,27,15,6,0,6,21
25131,146,82,37,0,27,119
25132,418,281,41,1,95,323
25133,10,0,8,0,2,8
25134,36,16,8,3,9,27
25135,193,140,14,1,38,155
25136,191,75,34,34,48,143
25137,120,51,10,29,30,90
25138,127,39,65,0,23,104
25139,138,52,40,17,29,109
25140,4,2,0,1,1,3
25141,12,1,9,1,1,11
25142,61,26,22,1,12,49
25143,102,51,25,0,26,76
25144,120,37,45,5,33,87
25145,197,47,103,14,33,164
25146,265,195,15,0,55,210
25147,40,3,30,1,6,34
25148,56,36,13,0,7,49
25149,107,39,44,10,14,93
25150,67,19,36,1,11,56
25151,55,23,21,0,11,44
25152,41,13,11,2,15,26
25153,22,5,12,0,5,17
25154,55,33,14,2,6,49
25155,14,6,6,0,2,12
25156,113,77,14,1,21,92
25157,41,19,14,0,8,33
25158,175,135,7,0,33,142
25159,69,40,9,4,16,53
25160,69,13,36,5,15,54
25161,37,9,24,1,3,34
25162,25,16,3,1,5,20
25163,8,2,3,0,3,5
25164,22,12,6,0,4,18
25165,55,37,5,0,13,42
25166,421,219,93,13,96,325
25167,88,39,23,3,23,65
25168,46,7,28,0,11,35
25169,14,8,3,0,3,11
25170,91,61,12,2,16,75
25171,135,103,12,0,20,115
25172,62,31,23,2,6,56
25173,32,21,9,0,2,30
25174,53,16,26,0,11,42
25175,137,72,34,0,31,106
25176,673,392,142,21,118,555
25177,50,19,21,1,9,41
25178,69,45,14,10,0,69
25179,186,75,43,22,46,140
25180,133,78,28,0,27,106
25181,56,1,46,0,9,47
25182,267,200,15,0,52,215
25183,108,77,11,1,19,89
25184,44,19,13,6,6,38
25185,64,38,18,2,6,58
25186,118,38,43,6,31,87
25187,25,4,19,0,2,23
25188,25,9,9,3,4,21
25189,1,0,0,0,1,0
25190,348,176,103,4,65,283
25191,12,1,9,0,2,10
25192,60,29,21,2,8,52
25193,40,18,12,2,8,32
25194,412,125,185,10,92,320
25195,31,15,12,0,4,27
25196,8,1,5,0,2,6
25197,36,20,7,1,8,28
25198,110,34,54,4,18,92
25199,32,22,0,0,10,22
25200,23,9,11,0,3,20
25201,313,152,67,35,59,254
25202,77,61,5,0,11,66
25203,199,150,7,0,42,157
25204,71,47,9,2,13,58
25205,12,1,8,0,3,9
25206,17,2,9,0,6,11
25207,16,8,5,0,3,13
25208,68,44,12,0,12,56
25209,74,31,24,3,16,58
25210,35,15,10,0,10,25
25211,105,91,3,0,11,94
25212,78,53,6,0,19,59
25213,220,90,85,4,41,179
25214,42,25,7,4,6,36
25215,35,9,15,3,8,27
25216,51,25,10,7,9,42
25217,11,7,1,0,3,8
25218,126,49,26,22,29,97
25219,137,37,45,21,34,103
25220,56,24,15,4,13,43
25221,130,100,8,2,20,110
25222,38,15,13,1,9,29
25223,34,16,11,0,7,27
25224,68,31,18,0,19,49
25225,40,26,7,0,7,33
25226,26,10,5,7,4,22
25227,60,30,5,4,21,39
25228,118,67,30,0,21,97
25229,61,43,9,2,7,54
25230,104,34,44,12,14,90
25231,445,205,138,12,90,355
25232,31,11,17,1,2,29
25233,18,2,9,1,6,12
25234,158,70,52,6,30,128
25235,24,18,3,2,1,23
25236,77,63,2,2,10,67
25237,50,22,13,3,12,38
25238,6,5,1,0,0,6
25239,62,19,32,1,10,52
25240,70,20,38,0,12,58
25241,11,2,8,0,1,10
25242,306,148,99,5,54,252
25243,207,87,66,19,35,172
25244,1034,390,406,46,192,842
25245,161,73,49,7,32,129
25246,90,29,18,23,20,70
25247,40,25,12,1,2,38
25248,295,78,32,136,49,246
25249,20,11,2,0,7,13
25250,98,45,29,5,19,79
25251,106,73,23,1,9,97
25252,30,16,11,2,1,29
25253,139,101,9,0,29,110
25254,14,1,10,2,1,13
25255,29,15,7,2,5,24
25256,144,28,50,25,41,103
25257,41,12,19,0,10,31
25258,42,20,15,0,7,35
25259,51,18,21,1,11,40
25260,367,215,77,0,75,292
25261,81,53,17,1,10,71
25262,58,20,20,5,13,45
25263,36,19,9,3,5,31
25264,16,6,7,0,3,13
25265,14,5,3,3,3,11
25266,46,11,22,1,12,34
25267,204,135,53,4,12,192
25268,64,41,5,0,18,46
25269,50,24,13,0,13,37
25270,42,13,15,6,8,34
25271,5,3,1,0,1,4
25272,48,8,26,5,9,39
25273,35,15,10,0,10,25
25274,216,145,30,0,41,175
25275,234,101,15,78,40,194
25276,105,36,37,6,26,79
25277,342,146,120,6,70,272
25278,120,66,23,5,26,94
25279,11,3,5,0,3,8
25280,80,33,5,30,12,68
25281,48,30,12,1,5,43
25282,46,18,20,0,8,38
25283,15,5,7,0,3,12
25284,23,4,4,7,8,15
25285,630,363,146,17,104,526
25286,32,21,9,0,2,30
25287,32,21,9,0,2,30
25288,94,64,12,3,15,79
25289,154,71,43,0,40,114
25290,219,136,3,31,49,170
25291,32,21,9,0,2,30
25292,214,141,56,1,16,198
25293,154,118,9,3,24,130
25294,108,27,52,4,25,83
25295,84,31,28,3,22,62
25296,75,40,18,4,13,62
25297,102,27,25,28,22,80
25298,1,0,0,0,1,0
25299,97,61,20,0,16,81
25300,46,18,20,0,8,38
25301,192,107,24,21,40,152
25302,181,86,27,24,44,137
25303,147,59,57,8,23,124
25304,77,64,2,0,11,66
25305,16,1,10,1,4,12
25306,166,69,33,19,45,121
25307,64,31,11,0,22,42
25308,98,48,33,0,17,81
25309,59,32,17,0,10,49
25310,68,27,20,3,18,50
25311,111,49,29,13,20,91
25312,30,22,0,0,8,22
25313,44,35,2,0,7,37
25314,166,130,2,2,32,134
25315,106,69,16,3,18,88
25316,118,64,36,8,10,108
25317,188,126,20,0,42,146
25318,67,44,13,0,10,57
25319,42,2,32,0,8,34
25320,57,28,13,2,14,43
25321,13,7,2,1,3,10
25322,45,23,7,8,7,38
25323,47,13,25,1,8,39
25324,51,24,16,5,6,45
25325,68,53,1,0,14,54
25326,94,42,24,12,16,78
25327,15,4,8,0,3,12
25328,103,58,19,4,22,81
25329,29,6,13,0,10,19
25330,87,56,8,3,20,67
25331,46,24,3,11,8,38
25332,1,0,1,0,0,1
25333,96,68,17,1,10,86
25334,46,18,20,0,8,38
25335,11,2,7,1,1,10
25336,47,31,1,2,13,34
25337,227,60,117,4,46,181
25338,228,83,53,37,55,173
25339,11,10,0,0,1,10
25340,104,33,42,10,19,85
25341,62,43,14,5,0,62
25342,3,1,1,0,1,2
25343,38,26,8,0,4,34
25344,459,226,118,20,95,364
25345,183,99,25,23,36,147
25346,301,215,14,2,70,231
25347,91,49,11,10,21,70
25348,54,27,14,0,13,41
25349,516,286,115,17,98,418
25350,59,22,25,0,12,47
25351,57,6,39,0,12,45
25352,143,61,31,17,34,109
25353,13,6,4,1,2,11
25354,23,11,2,7,3,20
25355,13,9,2,0,2,11
25356,64,29,24,1,10,54
25357,78,33,19,11,15,63
25358,476,230,94,49,103,373
25359,67,24,26,7,10,57
25360,125,90,4,5,26,99
25361,42,14,15,5,8,34
25362,116,59,34,0,23,93
25363,28,2,11,8,7,21
25364,99,45,34,4,16,83
25365,353,193,89,15,56,297
25366,3,2,0,0,1,2
25367,166,98,38,1,29,137
25368,87,27,33,3,24,63
25369,101,37,37,5,22,79
25370,199,101,49,0,49,150
25371,28,6,7,6,9,19
25372,64,48,12,0,4,60
25373,12,6,3,1,2,10
25374,167,124,6,1,36,131
25375,5,1,4,0,0,5
25376,127,90,10,1,26,101
25377,32,13,8,6,5,27
25378,92,30,46,0,16,76
25379,29,22,2,0,5,24
25380,7,3,4,0,0,7
25381,152,101,28,0,23,129
25382,46,27,15,0,4,42
25383,164,77,48,6,33,131
25384,97,56,23,3,15,82
25385,31,14,9,3,5,26
25386,635,368,146,16,105,530
25387,100,23,53,2,22,78
25388,158,76,25,26,31,127
25389,49,13,24,3,9,40
25390,154,66,53,15,20,134
25391,31,12,9,0,10,21
25392,44,22,12,0,10,34
25393,41,29,4,0,8,33
25394,43,12,20,0,11,32
25395,27,1,19,0,7,20
25396,218,55,68,45,50,168
25397,64,39,11,3,11,53
25398,382,165,134,11,72,310
25399,117,41,40,12,24,93
25400,135,53,54,2,26,109
25401,3,1,0,0,2,1
25402,286,180,44,0,62,224
25403,46,18,20,0,8,38
25404,186,50,92,1,43,143
25405,96,43,33,3,17,79
25406,35,17,9,0,9,26
25407,37,22,1,6,8,29
25408,10,2,5,0,3,7
25409,27,1,17,0,9,18
25410,49,35,3,1,10,39
25411,266,61,141,7,57,209
25412,211,72,79,15,45,166
25413,46,18,20,0,8,38
25414,28,13,11,0,4,24
25415,45,13,14,10,8,37
25416,33,15,15,0,3,30
25417,142,86,28,5,23,119
25418,34,0,28,0,6,28
25419,9,6,2,0,1,8
25420,13,10,2,0,1,12
25421,168,74,54,7,33,135
25422,150,24,64,24,38,112
25423,181,53,44,47,37,144
25424,56,20,25,0,11,45
25425,28,16,7,0,5,23
25426,103,30,44,10,19,84
25427,52,29,6,5,12,40
25428,143,84,35,1,23,120
25429,334,140,124,10,60,274
25430,38,29,1,0,8,30
25431,52,12,31,0,9,43
25432,39,11,23,0,5,34
25433,87,40,28,4,15,72
25434,42,4,31,3,4,38
25435,27,19,4,0,4,23
25436,86,63,5,5,13,73
25437,155,29,94,1,31,124
25438,44,35,2,0,7,37
25439,38,10,24,0,4,34
25440,20,6,10,0,4,16
25441,90,27,37,4,22,68
25442,58,14,30,8,6,52
25443,70,29,27,3,11,59
25444,31,18,4,2,7,24
25445,131,78,28,0,25,106
25446,46,5,29,0,12,34
25447,16,6,8,0,2,14
25448,31,4,24,0,3,28
25449,47,33,5,0,9,38
25450,39,20,11,3,5,34
25451,31,9,5,7,10,21
25452,7,3,1,2,1,6
25453,49,33,6,1,9,40
25454,46,13,19,1,13,33
25455,7,5,1,0,1,6
25456,39,28,0,0,11,28
25457,25,16,4,1,4,21
25458,55,43,1,0,11,44
25459,181,69,47,26,39,142
25460,328,193,57,6,72,256
25461,154,120,9,3,22,132
25462,82,38,5,16,23,59
25463,32,21,9,0,2,30
25464,44,20,6,7,11,33
25465,378,214,85,0,79,299
25466,90,23,47,0,20,70
25467,25,10,4,1,10,15
25468,27,10,8,2,7,20
25469,99,53,22,1,23,76
25470,38,21,7,0,10,28
25471,579,339,103,9,128,451
25472,185,58,76,14,37,148
25473,228,83,52,37,56,172
25474,75,47,11,2,15,60
25475,121,89,14,0,18,103
25476,76,8,44,5,19,57
25477,10,0,9,0,1,9
25478,52,23,16,3,10,42
25479,49,17,23,0,9,40
25480,32,21,9,0,2,30
25481,5,5,0,0,0,5
25482,61,25,16,11,9,52
25483,150,100,28,0,22,128
25484,76,5,54,1,16,60
25485,32,21,9,0,2,30
25486,65,17,3,30,15,50
25487,80,19,36,3,22,58
25488,40,25,4,0,11,29
25489,152,4,126,0,22,130
25490,13,3,3,2,5,8
25491,6,0,4,0,2,4
25492,299,121,122,3,53,246
25493,211,135,23,3,50,161
25494,13,1,7,0,5,8
25495,19,9,7,1,2,17
25496,79,48,21,1,9,70
25497,11,6,2,0,3,8
25498,30,8,7,5,10,20
25499,83,41,17,5,20,63
25500,98,64,14,0,20,78
25501,53,17,23,1,12,41
25502,26,10,9,0,7,19
25503,95,70,7,1,17,78
25504,34,13,15,1,5,29
25505,19,2,12,0,5,14
25506,31,20,5,0,6,25
25507,152,63,32,23,34,118
25508,22,9,8,2,3,19
25509,35,15,12,1,7,28
25510,15,2,8,3,2,13
25511,250,187,11,1,51,199
25512,153,87,25,12,29,124
25513,110,80,7,0,23,87
25514,59,30,8,9,12,47
25515,84,53,16,0,15,69
25516,54,24,19,1,10,44
25517,61,31,14,4,12,49
25518,505,352,41,1,111,394
25519,20,6,7,0,7,13
25520,28,2,23,0,3,25
25521,557,306,119,13,119,438
25522,49,33,6,1,9,40
25523,103,41,35,6,21,82
25524,48,32,2,2,12,36
25525,227,55,118,5,49,178
25526,66,12,42,0,12,54
25527,63,19,32,1,11,52
25528,425,122,163,47,93,332
25529,91,56,19,0,16,75
25530,28,6,17,0,5,23
25531,73,34,21,5,13,60
25532,33,16,9,1,7,26
25533,66,5,45,0,16,50
25534,111,26,51,16,18,93
25535,54,33,14,0,7,47
25536,442,322,28,1,91,351
25537,130,67,12,23,28,102
25538,34,2,26,0,6,28
25539,65,34,15,4,12,53
25540,45,21,20,0,4,41
25541,217,20,156,2,39,178
25542,178,126,14,1,37,141
25543,453,241,117,18,77,376
25544,56,9,37,0,10,46
25545,38,9,22,4,3,35
25546,9,7,0,0,2,7
25547,80,49,14,0,17,63
25548,72,26,33,3,10,62
25549,34,20,5,1,8,26
25550,94,62,14,0,18,76
25551,25,5,1,15,4,21
25552,57,23,23,0,11,46
25553,74,36,23,0,15,59
25554,604,351,111,13,129,475
25555,27,14,11,0,2,25
25556,15,4,10,0,1,14
25557,8,0,7,0,1,7
25558,24,13,6,0,5,19
25559,29,18,5,0,6,23
25560,13,1,8,0,4,9
25561,148,109,6,0,33,115
25562,27,14,6,1,6,21
25563,493,271,88,35,99,394
25564,38,23,5,2,8,30
25565,28,2,20,1,5,23
25566,68,15,41,1,11,57
25567,45,29,1,3,12,33
25568,184,49,100,3,32,152
25569,20,4,11,1,4,16
25570,51,20,23,0,8,43
25571,5,0,3,1,1,4
25572,39,10,24,0,5,34
25573,34,21,4,0,9,25
25574,67,10,36,5,16,51
25575,48,12,28,1,7,41
25576,41,2,8,22,9,32
25577,118,38,50,6,24,94
25578,25,15,5,1,4,21
25579,38,17,13,0,8,30
25580,186,61,87,2,36,150
25581,69,40,12,2,15,54
25582,201,52,104,5,40,161
25583,52,22,15,1,14,38
25584,42,2,32,0,8,34
25585,13,2,8,0,3,10
25586,38,13,20,1,4,34
25587,71,34,29,1,7,64
25588,215,43,132,2,38,177
25589,17,7,6,1,3,14
25590,23,3,13,0,7,16
25591,6,0,4,1,1,5
25592,156,76,48,1,31,125
25593,61,44,3,0,14,47
25594,60,32,13,1,14,46
25595,196,49,21,96,30,166
25596,32,16,6,1,9,23
25597,32,21,9,0,2,30
25598,11,11,0,0,0,11
25599,46,26,9,0,11,35
25600,29,15,8,0,6,23
25601,76,47,15,0,14,62
25602,137,84,28,0,25,112
25603,123,63,22,12,26,97
25604,94,56,20,0,18,76
25605,57,26,15,3,13,44
25606,239,166,29,2,42,197
25607,43,30,2,0,11,32
25608,79,46,19,0,14,65
25609,122,58,25,16,23,99
25610,149,96,3,16,34,115
25611,21,8,9,0,4,17
25612,107,31,55,0,21,86
25613,5,1,2,0,2,3
25614,75,32,23,7,13,62
25615,10,5,1,1,3,7
25616,8,2,4,1,1,7
25617,83,29,21,10,23,60
25618,45,29,5,0,11,34
25619,24,10,8,1,5,19
25620,33,15,3,6,9,24
25621,25,7,8,1,9,16
25622,80,37,5,25,13,67
25623,32,13,11,2,6,26
25624,348,83,168,7,90,258
25625,67,18,27,6,16,51
25626,69,45,7,1,16,53
25627,3,2,0,0,1,2
25628,8,4,1,2,1,7
25629,34,15,12,1,6,28
25630,59,25,19,5,10,49
25631,30,14,13,0,3,27
25632,85,31,34,4,16,69
25633,67,4,51,2,10,57
25634,461,211,146,13,91,370
25635,90,61,10,0,19,71
25636,24,13,8,0,3,21
25637,28,10,11,1,6,22
25638,88,58,9,5,16,72
25639,8,1,3,3,1,7
25640,34,24,3,2,5,29
25641,97,28,48,7,14,83
25642,281,104,117,15,45,236
25643,89,34,40,4,11,78
25644,25,13,6,0,6,19
25645,15,6,2,3,4,11
25646,57,26,16,3,12,45
25647,88,40,27,3,18,70
25648,103,65,24,0,14,89
25649,109,60,36,5,8,101
25650,66,36,15,2,13,53
25651,38,10,16,5,7,31
25652,181,108,37,6,30,151
25653,53,27,15,0,11,42
25654,118,47,40,3,28,90
25655,62,34,10,5,13,49
25656,281,65,162,1,53,228
25657,66,33,16,4,13,53
25658,150,90,29,0,31,119
25659,97,55,18,7,17,80
25660,68,27,20,3,18,50
25661,70,49,11,1,9,61
25662,53,38,8,0,7,46
25663,54,30,13,2,9,45
25664,68,32,20,4,12,56
25665,46,29,2,6,9,37
25666,39,17,10,2,10,29
25667,61,40,14,4,3,58
25668,40,30,1,2,7,33
25669,321,151,91,17,62,259
25670,147,72,20,22,33,114
25671,72,49,6,0,17,55
25672,51,22,21,0,8,43
25673,34,6,19,0,9,25
25674,424,212,102,25,85,339
25675,72,49,13,0,10,62
25676,69,47,13,0,9,60
25677,57,32,10,0,15,42
25678,69,33,25,1,10,59
25679,68,24,6,22,16,52
25680,63,23,28,1,11,52
25681,23,4,9,5,5,18
25682,86,41,26,4,15,71
25683,16,15,0,0,1,15
25684,63,41,4,0,18,45
25685,39,28,6,0,5,34
25686,59,36,7,8,8,51
25687,350,185,90,15,60,290
25688,32,7,17,0,8,24
25689,73,19,44,1,9,64
25690,62,26,21,4,11,51
25691,32,17,8,2,5,27
25692,476,276,82,7,111,365
25693,46,18,20,0,8,38
25694,24,9,11,1,3,21
25695,50,23,17,0,10,40
25696,327,196,60,0,71,256
25697,128,54,33,14,27,101
25698,30,15,9,0,6,24
25699,140,63,54,6,17,123
25700,46,15,19,4,8,38
25701,290,53,177,4,56,234
25702,40,19,11,2,8,32
25703,37,25,5,2,5,32
25704,57,12,34,1,10,47
25705,32,21,9,0,2,30
25706,345,146,122,6,71,274
25707,80,24,34,3,19,61
25708,153,64,62,8,19,134
25709,31,15,14,1,1,30
25710,59,35,14,0,10,49
25711,45,6,29,0,10,35
25712,55,38,6,1,10,45
25713,37,5,19,5,8,29
25714,140,49,36,29,26,114
25715,559,396,44,1,118,441
25716,33,19,7,0,7,26
25717,82,50,17,3,12,70
25718,25,8,13,1,3,22
25719,137,46,65,0,26,111
25720,163,76,47,7,33,130
25721,59,26,15,4,14,45
25722,19,8,8,1,2,17
25723,9,1,4,0,4,5
25724,44,35,2,0,7,37
25725,132,47,55,12,18,114
25726,17,5,4,3,5,12
25727,11,5,3,0,3,8
25728,75,50,8,0,17,58
25729,56,3,40,1,12,44
25730,22,4,13,0,5,17
25731,54,10,35,0,9,45
25732,47,27,10,1,9,38
25733,157,81,44,1,31,126
25734,32,21,9,0,2,30
25735,244,19,182,0,43,201
25736,91,43,5,27,16,75
25737,125,46,39,15,25,100
25738,89,37,37,2,13,76
25739,35,16,10,0,9,26
25740,57,24,14,3,16,41
25741,216,71,83,13,49,167
25742,125,74,18,11,22,103
25743,32,8,19,0,5,27
25744,167,120,5,2,40,127
25745,75,41,11,5,18,57
25746,72,8,42,4,18,54
25747,57,30,14,0,13,44
25748,94,39,30,11,14,80
25749,38,17,16,0,5,33
25750,75,45,21,1,8,67
25751,85,25,22,20,18,67
25752,11,8,0,0,3,8
25753,195,88,49,20,38,157
25754,83,66,0,4,13,70
25755,75,47,14,0,14,61
25756,141,86,30,1,24,117
25757,195,45,48,66,36,159
25758,60,20,24,7,9,51
25759,10,0,9,0,1,9
25760,340,170,96,1,73,267
25761,52,15,29,1,7,45
25762,105,43,47,0,15,90
25763,93,22,43,3,25,68
25764,87,41,24,0,22,65
25765,12,5,4,1,2,10
25766,83,27,33,6,17,66
25767,60,30,11,2,17,43
25768,147,80,29,1,37,110
25769,65,30,22,0,13,52
25770,36,14,13,0,9,27
25771,78,58,6,0,14,64
25772,156,56,43,31,26,130
25773,16,4,8,0,4,12
25774,74,53,7,3,11,63
25775,62,2,42,13,5,57
25776,213,114,47,0,52,161
25777,30,9,16,1,4,26
25778,101,34,26,16,25,76
25779,67,21,34,1,11,56
25780,43,15,18,0,10,33
25781,40,21,12,1,6,34
25782,533,318,105,11,99,434
25783,55,24,13,6,12,43
25784,442,254,82,12,94,348
25785,14,2,11,0,1,13
25786,15,4,7,0,4,11
25787,87,32,37,5,13,74
25788,41,4,32,0,5,36
25789,2,1,1,0,0,2
25790,55,34,7,2,12,43
25791,31,6,17,1,7,24
25792,51,34,5,1,11,40
25793,67,37,17,1,12,55
25794,75,42,16,3,14,61
25795,20,10,6,2,2,18
25796,18,8,7,0,3,15
25797,53,11,24,8,10,43
25798,84,20,45,7,12,72
25799,86,36,35,0,15,71
25800,672,393,142,18,119,553
25801,90,54,20,1,15,75
25802,296,215,13,3,65,231
25803,72,20,26,8,18,54
25804,46,18,20,0,8,38
25805,32,21,9,0,2,30
25806,179,128,10,6,35,144
25807,26,10,9,5,2,24
25808,14,2,7,3,2,12
25809,28,9,15,0,4,24
25810,46,18,20,0,8,38
25811,22,9,10,0,3,19
25812,31,15,6,0,10,21
25813,14,8,2,0,4,10
25814,38,24,4,0,10,28
25815,21,12,7,0,2,19
25816,130,59,31,9,31,99
25817,32,21,9,0,2,30
25818,35,15,10,0,10,25
25819,8,5,2,0,1,7
25820,168,82,52,3,31,137
25821,64,30,11,9,14,50
25822,33,2,23,0,8,25
25823,45,11,20,1,13,32
25824,454,141,187,26,100,354
25825,107,84,5,11,7,100
25826,37,18,9,1,9,28
25827,230,157,31,0,42,188
25828,49,18,19,0,12,37
25829,200,109,30,21,40,160
25830,124,65,29,6,24,100
25831,50,15,22,0,13,37
25832,462,233,119,14,96,366
25833,75,40,15,2,18,57
25834,54,16,22,2,14,40
25835,32,21,9,0,2,30
25836,73,5,51,1,16,57
25837,19,2,12,0,5,14
25838,169,127,5,1,36,133
25839,351,238,38,1,74,277
25840,457,228,116,17,96,361
25841,536,380,42,1,113,423
25842,166,97,39,1,29,137
25843,7,3,4,0,0,7
25844,0,0,0,0,0,0
25845,408,136,162,19,91,317
25846,38,19,9,1,9,29
25847,14,10,2,0,2,12
25848,19,7,6,1,5,14
25849,5,0,5,0,0,5
25850,51,20,19,2,10,41
25851,14,6,2,0,6,8
25852,235,64,125,6,40,195
25853,32,7,17,1,7,25
25854,368,277,21,0,70,298
25855,145,109,8,0,28,117
25856,61,34,16,0,11,50
25857,155,52,78,4,21,134
25858,164,122,4,1,37,127
25859,190,60,79,12,39,151
25860,156,97,31,1,27,129
25861,37,9,18,1,9,28
25862,37,1,26,3,7,30
25863,90,27,45,2,16,74
25864,12,0,11,0,1,11
25865,138,59,38,15,26,112
25866,28,13,11,0,4,24
25867,73,33,23,2,15,58
25868,230,160,49,4,17,213
25869,210,57,53,59,41,169
25870,56,3,40,1,12,44
25871,677,397,149,20,111,566
25872,44,25,12,0,7,37
25873,621,370,107,9,135,486
25874,121,54,50,3,14,107
25875,51,20,14,1,16,35
25876,79,38,17,0,24,55
25877,169,51,93,4,21,148
25878,29,15,5,0,9,20
25879,197,105,59,0,33,164
25880,33,10,10,6,7,26
25881,172,123,16,3,30,142
25882,157,71,51,6,29,128
25883,63,41,4,0,18,45
25884,32,21,9,0,2,30
25885,8,2,0,4,2,6
25886,213,162,5,2,44,169
25887,21,1,13,1,6,15
25888,153,40,86,2,25,128
25889,57,20,25,0,12,45
25890,32,21,9,0,2,30
25891,60,34,7,8,11,49
25892,136,60,29,15,32,104
25893,73,49,9,3,12,61
25894,73,5,44,6,18,55
25895,188,107,23,23,35,153
25896,29,13,8,0,8,21
25897,42,18,18,0,6,36
25898,64,35,19,0,10,54
25899,115,64,30,0,21,94
25900,23,8,2,7,6,17
25901,127,74,22,3,28,99
25902,526,245,120,49,112,414
25903,35,6,20,0,9,26
25904,47,3,34,6,4,43
25905,212,140,23,0,49,163
25906,157,84,31,7,35,122
25907,341,143,121,6,71,270
25908,207,137,53,1,16,191
25909,616,343,152,21,100,516
25910,31,19,5,0,7,24
25911,32,21,9,0,2,30
25912,42,22,10,0,10,32
25913,114,107,0,7,0,114
25914,127,64,15,18,30,97
25915,46,18,20,0,8,38
25916,65,28,23,0,14,51
25917,96,52,17,10,17,79
25918,45,4,32,2,7,38
25919,61,23,25,0,13,48
25920,96,54,20,7,15,81
25921,44,17,18,0,9,35
25922,36,23,7,4,2,34
25923,23,4,3,10,6,17
25924,31,13,6,4,8,23
25925,97,41,18,13,25,72
25926,56,10,32,0,14,42
25927,92,29,47,0,16,76
25928,46,18,20,0,8,38
25929,30,12,10,2,6,24
25930,71,35,25,0,11,60
25931,16,4,8,1,3,13
25932,102,83,4,9,6,96
25933,24,5,14,1,4,20
25934,147,71,27,16,33,114
25935,110,30,57,0,23,87
25936,112,66,22,7,17,95
25937,58,32,16,0,10,48
25938,158,76,48,1,33,125
25939,63,38,13,1,11,52
25940,16,11,2,0,3,13
25941,49,7,33,0,9,40
25942,89,29,43,1,16,73
25943,10,3,3,0,4,6
25944,70,22,33,2,13,57
25945,42,23,4,7,8,34
25946,129,61,35,0,33,96
25947,113,60,36,4,13,100
25948,57,22,4,21,10,47
25949,96,55,24,1,16,80
25950,90,31,30,9,20,70
25951,22,15,2,0,5,17
25952,31,24,3,0,4,27
25953,77,27,28,6,16,61
25954,156,75,28,26,27,129
25955,75,19,27,0,29,46
25956,28,1,18,0,9,19
25957,42,26,5,0,11,31
25958,57,30,13,1,13,44
25959,19,6,11,0,2,17
25960,8,2,4,2,0,8
25961,4,2,2,0,0,4
25962,21,2,15,0,4,17
25963,3,2,0,0,1,2
25964,33,15,8,0,10,23
25965,68,27,30,0,11,57
25966,39,14,20,1,4,35
25967,132,77,41,0,14,118
25968,140,91,29,0,20,120
25969,27,8,13,0,6,21
25970,39,17,14,1,7,32
25971,119,60,27,5,27,92
25972,131,34,69,1,27,104
25973,262,13,200,0,49,213
25974,63,41,4,0,18,45
25975,53,11,31,0,11,42
25976,60,28,14,1,17,43
25977,8,2,4,0,2,6
25978,152,84,17,25,26,126
25979,202,89,55,20,38,164
25980,171,111,44,2,14,157
25981,59,27,8,8,16,43
25982,25,5,1,15,4,21
25983,14,8,3,0,3,11
25984,36,25,4,0,7,29
25985,71,37,13,3,18,53
25986,52,15,26,0,11,41
25987,30,20,0,0,10,20
25988,59,13,40,0,6,53
25989,42,10,4,20,8,34
25990,27,15,6,0,6,21
25991,16,2,8,3,3,13
25992,39,17,13,0,9,30
25993,141,53,48,17,23,118
25994,181,7,142,0,32,149
25995,66,36,19,2,9,57
25996,84,50,22,11,1,83
25997,27,6,16,2,3,24
25998,67,13,32,4,18,49
25999,233,100,47,27,59,174
26000,48,26,10,0,12,36
26001,158,71,51,5,31,127
26002,46,27,9,4,6,40
26003,104,27,38,13,26,78
26004,82,34,31,5,12,70
26005,1,1,0,0,0,1
26006,325,173,76,20,56,269
26007,186,128,11,9,38,148
26008,202,89,56,19,38,164
26009,320,201,49,8,62,258
26010,74,56,7,0,11,63
26011,33,8,12,6,7,26
26012,48,28,12,0,8,40
26013,168,107,13,10,38,130
26014,668,398,132,20,118,550
26015,120,73,16,4,27,93
26016,40,8,17,0,15,25
26017,280,134,93,4,49,231
26018,80,48,16,3,13,67
26019,52,10,30,2,10,42
26020,78,40,19,2,17,61
26021,82,48,23,1,10,72
26022,49,8,28,2,11,38
26023,82,45,24,0,13,69
26024,177,101,31,0,45,132
26025,655,383,142,17,113,542
26026,44,36,1,0,7,37
26027,69,17,36,1,15,54
26028,42,0,32,2,8,34
26029,668,388,146,17,117,551
26030,174,124,11,8,31,143
26031,44,8,18,8,10,34
26032,35,12,14,2,7,28
26033,11,6,2,1,2,9
26034,3,1,0,0,2,1
26035,21,0,19,0,2,19
26036,49,35,4,0,10,39
26037,46,18,20,0,8,38
26038,82,65,4,2,11,71
26039,509,242,105,58,104,405
26040,206,87,65,19,35,171
26041,49,24,3,14,8,41
26042,120,72,25,0,23,97
26043,139,65,45,5,24,115
26044,135,64,25,16,30,105
26045,86,56,12,0,18,68
26046,51,34,3,1,13,38
26047,64,11,40,0,13,51
26048,32,7,17,1,7,25
26049,9,6,0,1,2,7
26050,92,32,19,10,31,61
26051,43,24,8,2,9,34
26052,46,18,20,0,8,38
26053,145,58,57,8,22,123
26054,50,18,22,0,10,40
26055,257,141,68,8,40,217
26056,32,6,14,4,8,24
26057,235,154,21,3,57,178
26058,74,28,26,3,17,57
26059,43,4,30,0,9,34
26060,34,20,6,1,7,27
26061,39,14,12,1,12,27
26062,17,6,4,5,2,15
26063,77,29,29,5,14,63
26064,46,32,4,0,10,36
26065,91,27,40,7,17,74
26066,37,26,0,1,10,27
26067,80,55,6,0,19,61
26068,97,27,40,9,21,76
26069,66,52,2,0,12,54
26070,581,327,143,20,91,490
26071,493,231,107,53,102,391
26072,132,100,12,0,20,112
26073,224,57,121,7,39,185
26074,46,18,20,0,8,38
26075,92,69,7,1,15,77
26076,13,5,4,0,4,9
26077,168,79,51,3,35,133
26078,187,100,56,0,31,156
26079,128,101,7,0,20,108
26080,117,54,46,3,14,103
26081,15,8,3,0,4,11
26082,60,42,8,0,10,50
26083,386,128,156,13,89,297
26084,58,20,23,2,13,45
26085,104,38,33,13,20,84
26086,1305,527,180,339,259,1046
26087,75,26,30,2,17,58
26088,52,30,10,0,12,40
26089,414,227,93,11,83,331
26090,58,26,19,0,13,45
26091,64,23,20,5,16,48
26092,175,90,47,0,38,137
26093,335,159,93,11,72,263
26094,13,6,4,2,1,12
26095,76,74,0,2,0,76
26096,199,89,56,12,42,157
26097,503,225,136,35,107,396
26098,213,115,62,0,36,177
26099,39,18,13,1,7,32
26100,66,36,9,8,13,53
26101,139,51,60,5,23,116
26102,29,4,22,0,3,26
26103,21,9,7,2,3,18
26104,8,2,0,4,2,6
26105,8,3,1,0,4,4
26106,67,5,45,4,13,54
26107,35,13,15,0,7,28
26108,25,15,5,0,5,20
26109,123,82,28,0,13,110
26110,102,29,32,16,25,77
26111,57,30,21,0,6,51
26112,21,5,12,0,4,17
26113,26,24,0,0,2,24
26114,327,139,113,6,69,258
26115,132,87,29,3,13,119
26116,113,66,29,9,9,104
26117,36,22,7,1,6,30
26118,62,7,41,3,11,51
26119,45,21,14,0,10,35
26120,1273,511,173,336,253,1020
26121,85,51,18,4,12,73
26122,25,14,7,2,2,23
26123,30,6,14,2,8,22
26124,5,5,0,0,0,5
26125,63,32,22,0,9,54
26126,208,156,21,1,30,178
26127,155,9,91,22,33,122
26128,59,7,34,2,16,43
26129,23,2,15,0,6,17
26130,245,123,65,0,57,188
26131,75,34,24,0,17,58
26132,81,51,20,6,4,77
26133,54,6,41,1,6,48
26134,39,7,23,2,7,32
26135,32,21,9,0,2,30
26136,49,23,14,0,12,37
26137,46,33,4,3,6,40
26138,40,20,15,0,5,35
26139,87,30,38,1,18,69
26140,20,18,0,0,2,18
26141,83,40,24,2,17,66
26142,27,15,9,0,3,24
26143,22,10,9,1,2,20
26144,63,12,37,1,13,50
26145,74,39,22,3,10,64
26146,32,21,9,0,2,30
26147,39,3,30,1,5,34
26148,25,6,16,0,3,22
26149,48,32,6,4,6,42
26150,167,47,12,80,28,139
26151,146,50,50,20,26,120
26152,76,32,26,2,16,60
26153,32,21,9,0,2,30
26154,33,1,26,0,6,27
26155,126,41,34,28,23,103
26156,7,1,3,0,3,4
26157,17,7,3,1,6,11
26158,46,19,10,8,9,37
26159,79,1,61,0,17,62
26160,8,4,3,0,1,7
26161,14,8,4,1,1,13
26162,21,8,3,6,4,17
26163,36,6,25,3,2,34
26164,429,314,23,0,92,337
26165,50,10,29,1,10,40
26166,81,49,18,0,14,67
26167,76,23,34,3,16,60
26168,110,37,43,11,19,91
26169,16,3,5,0,8,8
26170,46,17,15,3,11,35
26171,283,97,126,16,44,239
26172,40,4,30,0,6,34
26173,55,33,14,2,6,49
26174,92,28,25,20,19,73
26175,189,79,39,27,44,145
26176,81,42,16,8,15,66
26177,26,9,13,0,4,22
26178,52,32,6,1,13,39
26179,92,45,24,5,18,74
26180,55,36,12,0,7,48
26181,130,63,42,0,25,105
26182,125,83,15,5,22,103
26183,79,62,2,2,13,66
26184,135,56,44,8,27,108
26185,61,23,6,18,14,47
26186,483,250,116,17,100,383
26187,140,85,28,0,27,113
26188,38,17,16,0,5,33
26189,160,27,102,1,30,130
26190,97,23,32,25,17,80
26191,72,49,8,0,15,57
26192,510,281,114,17,98,412
26193,83,39,30,4,10,73
26194,24,8,12,1,3,21
26195,75,43,10,0,22,53
26196,382,183,107,19,73,309
26197,146,67,43,11,25,121
26198,46,22,8,4,12,34
26199,73,30,26,0,17,56
26200,46,18,20,0,8,38
26201,39,2,30,1,6,33
26202,104,34,32,11,27,77
26203,63,21,26,2,14,49
26204,72,50,8,0,14,58
26205,223,129,25,25,44,179
26206,25,12,6,1,6,19
26207,513,272,87,46,108,405
26208,124,41,32,28,23,101
26209,111,34,41,12,24,87
26210,182,92,53,0,37,145
26211,47,14,26,1,6,41
26212,85,55,15,0,15,70
26213,38,19,9,0,10,28
26214,52,26,17,0,9,43
26215,73,35,22,0,16,57
26216,194,141,15,1,37,157
26217,50,35,3,1,11,39
26218,1032,382,408,46,196,836
26219,32,15,8,4,5,27
26220,2,0,1,1,0,2
26221,19,12,4,0,3,16
26222,119,52,36,2,29,90
26223,59,18,15,14,12,47
26224,401,230,90,0,81,320
26225,20,0,14,0,6,14
26226,153,40,86,0,27,126
26227,277,186,70,3,18,259
26228,71,29,16,14,12,59
26229,59,31,18,0,10,49
26230,59,35,13,0,11,48
26231,62,36,17,0,9,53
26232,34,17,10,0,7,27
26233,32,21,9,0,2,30
26234,79,64,3,2,10,69
26235,69,23,35,1,10,59
26236,51,20,13,3,15,36
26237,38,15,15,0,8,30
26238,143,58,31,25,29,114
26239,17,7,6,1,3,14
26240,105,38,38,9,20,85
26241,38,19,14,0,5,33
26242,120,51,31,14,24,96
26243,69,30,26,2,11,58
26244,40,13,16,2,9,31
26245,67,32,19,1,15,52
26246,46,18,20,0,8,38
26247,54,0,34,3,17,37
26248,167,108,23,5,31,136
26249,102,67,1,12,22,80
26250,99,27,35,15,22,77
26251,123,73,20,5,25,98
26252,595,339,125,17,114,481
26253,206,34,90,33,49,157
26254,64,35,17,0,12,52
26255,75,30,34,0,11,64
26256,32,21,9,0,2,30
26257,176,106,46,13,11,165
26258,217,147,55,1,14,203
26259,31,6,21,2,2,29
26260,99,59,22,4,14,85
26261,10,3,4,0,3,7
26262,113,61,24,0,28,85
26263,46,18,20,0,8,38
26264,50,25,4,3,18,32
26265,166,61,53,21,31,135
26266,41,5,27,0,9,32
26267,42,19,14,0,9,33
26268,112,46,15,16,35,77
26269,74,37,23,4,10,64
26270,37,11,20,0,6,31
26271,213,86,36,41,50,163
26272,112,45,29,13,25,87
26273,60,31,9,8,12,48
26274,97,56,9,10,22,75
26275,147,49,49,19,30,117
26276,126,74,21,3,28,98
26277,67,18,23,9,17,50
26278,178,100,33,0,45,133
26279,6,3,3,0,0,6
26280,160,72,30,18,40,120
26281,34,2,27,0,5,29
26282,78,52,6,2,18,60
26283,62,38,13,1,10,52
26284,176,54,89,0,33,143
26285,10,3,7,0,0,10
26286,437,213,105,21,98,339
26287,27,23,0,0,4,23
26288,50,23,18,0,9,41
26289,30,14,10,0,6,24
26290,73,43,9,11,10,63
26291,43,18,18,0,7,36
26292,266,116,88,17,45,221
26293,91,66,6,0,19,72
26294,341,145,120,6,70,271
26295,56,38,9,0,9,47
26296,97,25,53,0,19,78
26297,622,408,72,6,136,486
26298,448,139,184,25,100,348
26299,134,92,24,0,18,116
26300,43,28,5,1,9,34
26301,38,7,23,1,7,31
26302,12,3,6,1,2,10
26303,482,234,94,47,107,375
26304,640,379,140,18,103,537
26305,55,25,15,1,14,41
26306,82,41,20,0,21,61
26307,18,7,4,0,7,11
26308,86,44,31,2,9,77
26309,49,32,6,2,9,40
26310,190,83,62,13,32,158
26311,22,3,13,0,6,16
26312,67,29,22,5,11,56
26313,78,31,8,18,21,57
26314,54,15,18,8,13,41
26315,68,21,30,8,9,59
26316,49,9,31,0,9,40
26317,26,10,9,1,6,20
26318,27,17,3,0,7,20
26319,238,135,45,8,50,188
26320,135,61,42,10,22,113
26321,95,49,22,5,19,76
26322,417,206,107,12,92,325
26323,87,40,32,1,14,73
26324,76,38,17,2,19,57
26325,33,13,14,2,4,29
26326,32,22,3,0,7,25
26327,2,0,2,0,0,2
26328,32,21,9,0,2,30
26329,154,58,39,22,35,119
26330,433,200,105,37,91,342
26331,485,267,103,15,100,385
26332,126,65,35,0,26,100
26333,17,7,6,0,4,13
26334,90,35,16,10,29,61
26335,22,1,17,0,4,18
26336,6,3,3,0,0,6
26337,66,33,24,1,8,58
26338,26,4,14,2,6,20
26339,34,14,8,0,12,22
26340,64,24,23,5,12,52
26341,43,13,7,13,10,33
26342,119,2,98,0,19,100
26343,277,27,196,2,52,225
26344,168,46,91,4,27,141
26345,20,13,4,0,3,17
26346,76,26,30,3,17,59
26347,70,48,8,4,10,60
26348,39,24,4,0,11,28
26349,20,3,11,0,6,14
26350,75,29,23,8,15,60
26351,114,31,45,19,19,95
26352,472,183,141,45,103,369
26353,68,32,22,1,13,55
26354,25,9,9,4,3,22
26355,94,43,31,4,16,78
26356,56,17,26,4,9,47
26357,183,121,12,11,39,144
26358,118,33,42,15,28,90
26359,31,4,21,0,6,25
26360,45,20,8,8,9,36
26361,41,18,17,0,6,35
26362,130,54,33,19,24,106
26363,36,10,11,5,10,26
26364,147,61,31,19,36,111
26365,65,19,36,1,9,56
26366,105,26,48,7,24,81
26367,22,6,7,0,9,13
26368,60,31,10,2,17,43
26369,17,10,4,1,2,15
26370,354,153,126,6,69,285
26371,31,9,16,0,6,25
26372,511,263,94,49,105,406
26373,46,0,37,0,9,37
26374,120,47,28,19,26,94
26375,156,76,47,1,32,124
26376,191,104,56,0,31,160
26377,100,36,39,10,15,85
26378,72,57,2,0,13,59
26379,282,176,42,0,64,218
26380,63,32,22,0,9,54
26381,9,6,0,0,3,6
26382,94,90,0,4,0,94
26383,110,105,0,5,0,110
26384,2,0,1,0,1,1
26385,222,150,31,0,41,181
26386,133,62,38,0,33,100
26387,103,46,29,1,27,76
26388,53,12,27,4,10,43
26389,91,57,15,0,19,72
26390,55,44,0,1,10,45
26391,456,218,140,13,85,371
26392,25,10,8,3,4,21
26393,54,19,16,4,15,39
26394,109,55,31,4,19,90
26395,98,81,3,3,11,87
26396,60,35,15,0,10,50
26397,85,43,4,25,13,72
26398,22,7,8,1,6,16
26399,80,37,5,16,22,58
26400,17,3,14,0,0,17
26401,18,7,6,0,5,13
26402,45,25,9,0,11,34
26403,114,80,9,2,23,91
26404,42,8,24,3,7,35
26405,94,32,44,2,16,78
26406,48,28,9,1,10,38
26407,13,13,0,0,0,13
26408,15,9,4,0,2,13
26409,37,10,10,13,4,33
26410,55,33,10,0,12,43
26411,46,18,20,0,8,38
26412,32,21,9,0,2,30
26413,15,3,10,0,2,13
26414,125,61,25,15,24,101
26415,31,17,5,0,9,22
26416,58,21,5,21,11,47
26417,20,11,7,0,2,18
26418,46,10,25,0,11,35
26419,485,267,134,0,84,401
26420,141,94,22,0,25,116
26421,157,78,47,1,31,126
26422,15,4,8,1,2,13
26423,50,26,9,4,11,39
26424,59,1,49,0,9,50
26425,278,154,35,32,57,221
26426,52,35,5,3,9,43
26427,50,28,10,0,12,38
26428,7,2,4,0,1,6
26429,12,2,8,0,2,10
26430,34,18,11,0,5,29
26431,339,139,123,6,71,268
26432,12,9,1,0,2,10
26433,90,37,32,4,17,73
26434,103,22,45,14,22,81
26435,52,19,16,6,11,41
26436,42,25,5,6,6,36
26437,30,9,7,4,10,20
26438,50,25,8,6,11,39
26439,42,26,7,2,7,35
26440,46,36,5,3,2,44
26441,91,38,10,24,19,72
26442,27,8,5,7,7,20
26443,21,8,8,0,5,16
26444,86,38,26,4,18,68
26445,376,161,136,9,70,306
26446,131,51,44,15,21,110
26447,32,21,9,0,2,30
26448,58,10,14,15,19,39
26449,88,23,40,5,20,68
26450,155,100,26,3,26,129
26451,22,10,6,2,4,18
26452,37,7,9,16,5,32
26453,32,21,9,0,2,30
26454,76,42,20,0,14,62
26455,27,7,14,0,6,21
26456,32,21,9,0,2,30
26457,36,20,12,0,4,32
26458,35,7,25,0,3,32
26459,25,5,1,15,4,21
26460,228,126,65,0,37,191
26461,43,23,11,0,9,34
26462,78,9,43,8,18,60
26463,22,11,2,2,7,15
26464,106,39,34,14,19,87
26465,67,15,36,1,15,52
26466,80,61,1,0,18,62
26467,225,153,31,0,41,184
26468,9,1,6,0,2,7
26469,43,24,6,2,11,32
26470,32,21,9,0,2,30
26471,143,60,32,17,34,109
26472,63,29,16,5,13,50
26473,154,56,38,28,32,122
26474,32,16,7,0,9,23
26475,37,14,13,3,7,30
26476,20,8,3,3,6,14
26477,417,191,136,8,82,335
26478,211,112,48,0,51,160
26479,111,89,7,2,13,98
26480,17,5,6,1,5,12
26481,84,23,35,3,23,61
26482,95,43,36,0,16,79
26483,160,71,53,7,29,131
26484,33,12,15,0,6,27
26485,72,38,16,0,18,54
26486,54,0,34,3,17,37
26487,158,9,90,27,32,126
26488,78,39,16,5,18,60
26489,116,44,48,11,13,103
26490,76,50,14,0,12,64
26491,116,37,55,3,21,95
26492,89,64,9,5,11,78
26493,458,222,142,13,81,377
26494,39,13,19,0,7,32
26495,77,38,25,0,14,63
26496,166,62,45,21,38,128
26497,46,18,20,0,8,38
26498,40,24,5,1,10,30
26499,4,3,0,0,1,3
26500,331,106,141,15,69,262
26501,137,97,18,0,22,115
26502,82,63,1,0,18,64
26503,12,7,5,0,0,12
26504,17,11,4,0,2,15
26505,52,29,9,3,11,41
26506,46,18,20,0,8,38
26507,141,86,27,0,28,113
26508,145,62,53,1,29,116
26509,85,44,19,2,20,65
26510,223,86,14,81,42,181
26511,343,147,120,6,70,273
26512,99,58,20,0,21,78
26513,170,77,54,4,35,135
26514,50,3,13,25,9,41
26515,66,34,23,0,9,57
26516,41,7,25,1,8,33
26517,42,9,14,8,11,31
26518,46,27,10,0,9,37
26519,99,80,2,2,15,84
26520,219,74,81,15,49,170
26521,52,29,15,0,8,44
26522,120,65,37,1,17,103
26523,43,16,21,0,6,37
26524,160,30,98,1,31,129
26525,174,90,46,0,38,136
26526,160,82,30,23,25,135
26527,90,68,3,0,19,71
26528,87,19,50,9,9,78
26529,89,46,12,2,29,60
26530,14,8,4,0,2,12
26531,36,8,19,0,9,27
26532,78,36,23,0,19,59
26533,84,41,18,2,23,61
26534,46,18,20,0,8,38
26535,135,55,40,14,26,109
26536,48,29,11,0,8,40
26537,40,11,20,1,8,32
26538,7,0,4,0,3,4
26539,158,103,3,16,36,122
26540,158,104,24,1,29,129
26541,108,47,29,12,20,88
26542,2,0,1,0,1,1
26543,157,76,51,5,25,132
26544,7,1,5,0,1,6
26545,55,12,29,1,13,42
26546,82,39,10,8,25,57
26547,14,5,4,2,3,11
26548,46,22,15,0,9,37
26549,96,57,28,7,4,92
26550,67,29,18,4,16,51
26551,381,106,177,8,90,291
26552,89,29,19,21,20,69
26553,141,48,67,0,26,115
26554,57,12,30,6,9,48
26555,14,6,4,0,4,10
26556,174,99,20,15,40,134
26557,100,40,34,10,16,84
26558,1,0,0,0,1,0
26559,116,28,33,22,33,83
26560,146,61,55,6,24,122
26561,192,100,61,0,31,161
26562,197,140,16,2,39,158
26563,22,7,8,2,5,17
26564,130,96,6,0,28,102
26565,138,58,54,1,25,113
26566,45,16,18,3,8,37
26567,41,19,15,0,7,34
26568,179,8,138,0,33,146
26569,39,21,9,1,8,31
26570,39,2,33,0,4,35
26571,111,54,16,14,27,84
26572,52,18,24,2,8,44
26573,31,2,21,0,8,23
26574,326,190,71,4,61,265
26575,550,319,97,9,125,425
26576,87,58,11,0,18,69
26577,195,51,30,80,34,161
26578,21,13,6,0,2,19
26579,179,102,32,0,45,134
26580,64,11,42,1,10,54
26581,42,28,1,0,13,29
26582,38,19,9,1,9,29
26583,72,41,16,0,15,57
26584,74,43,18,0,13,61
26585,49,28,12,3,6,43
26586,52,25,14,5,8,44
26587,147,68,43,11,25,122
26588,46,18,20,0,8,38
26589,160,84,38,0,38,122
26590,381,197,106,16,62,319
26591,570,405,43,1,121,449
26592,10,1,4,0,5,5
26593,90,53,19,0,18,72
26594,15,0,10,0,5,10
26595,43,31,0,2,10,33
26596,21,12,1,0,8,13
26597,35,25,3,0,7,28
26598,15,10,2,0,3,12
26599,62,19,24,6,13,49
26600,23,3,12,1,7,16
26601,442,214,119,14,95,347
26602,494,221,135,33,105,389
26603,138,54,44,9,31,107
26604,140,47,62,6,25,115
26605,34,14,11,0,9,25
26606,46,18,20,0,8,38
26607,75,31,33,1,10,65
26608,41,21,8,2,10,31
26609,92,66,10,1,15,77
26610,104,70,15,0,19,85
26611,54,25,15,6,8,46
26612,221,147,56,2,16,205
26613,61,35,17,0,9,52
26614,94,64,11,10,9,85
26615,40,3,29,2,6,34
26616,155,106,23,0,26,129
26617,331,142,114,6,69,262
26618,21,5,12,0,4,17
26619,95,62,12,3,18,77
26620,120,81,18,3,18,102
26621,248,67,129,7,45,203
26622,83,80,0,3,0,83
26623,29,4,13,4,8,21
26624,46,19,17,0,10,36
26625,49,9,29,1,10,39
26626,5,3,1,0,1,4
26627,82,22,38,8,14,68
26628,91,52,12,3,24,67
26629,10,3,4,0,3,7
26630,104,47,27,12,18,86
26631,489,238,98,56,97,392
26632,32,24,5,0,3,29
26633,127,74,22,3,28,99
26634,179,103,31,0,45,134
26635,100,46,15,24,15,85
26636,98,62,25,0,11,87
26637,78,50,15,0,13,65
26638,43,15,18,2,8,35
26639,77,17,36,5,19,58
26640,270,110,56,38,66,204
26641,54,28,12,3,11,43
26642,55,36,12,0,7,48
26643,61,31,19,1,10,51
26644,219,162,14,0,43,176
26645,121,54,37,5,25,96
26646,10,3,5,1,1,9
26647,93,56,26,7,4,89
26648,44,34,4,0,6,38
26649,74,3,53,0,18,56
26650,164,112,26,0,26,138
26651,8,4,1,2,1,7
26652,96,42,18,11,25,71
26653,61,16,30,1,14,47
26654,126,67,27,5,27,99
26655,32,21,9,0,2,30
26656,225,123,53,0,49,176
26657,53,25,20,1,7,46
26658,220,130,19,26,45,175
26659,295,176,53,0,66,229
26660,397,192,117,14,74,323
26661,45,28,8,0,9,36
26662,87,53,18,4,12,75
26663,38,23,5,0,10,28
26664,195,49,101,5,40,155
26665,106,52,38,4,12,94
26666,136,92,11,5,28,108
26667,13,9,0,0,4,9
26668,92,28,32,11,21,71
26669,71,18,34,2,17,54
26670,215,60,107,1,47,168
26671,27,0,23,0,4,23
26672,262,181,14,5,62,200
26673,41,7,21,1,12,29
26674,27,15,9,0,3,24
26675,156,68,34,22,32,124
26676,100,62,11,2,25,75
26677,13,2,7,0,4,9
26678,150,24,97,1,28,122
26679,32,21,9,0,2,30
26680,21,7,10,0,4,17
26681,49,11,27,1,10,39
26682,26,9,8,3,6,20
26683,32,21,9,0,2,30
26684,9,8,1,0,0,9
26685,63,41,11,1,10,53
26686,15,5,4,0,6,9
26687,212,114,47,0,51,161
26688,36,24,4,1,7,29
26689,29,6,16,0,7,22
26690,42,6,15,11,10,32
26691,180,44,65,27,44,136
26692,25,10,11,0,4,21
26693,169,82,51,3,33,136
26694,378,219,81,16,62,316
26695,53,22,17,4,10,43
26696,116,47,15,18,36,80
26697,108,72,16,0,20,88
26698,203,77,39,38,49,154
26699,59,32,17,0,10,49
26700,24,3,0,12,9,15
26701,17,4,7,0,6,11
26702,12,9,1,0,2,10
26703,25,4,17,0,4,21
26704,42,7,16,8,11,31
26705,36,2,27,0,7,29
26706,43,4,25,7,7,36
26707,58,37,6,0,15,43
26708,32,12,2,14,4,28
26709,73,42,16,3,12,61
26710,11,0,5,0,6,5
26711,11,5,3,0,3,8
26712,65,45,8,0,12,53
26713,84,31,29,4,20,64
26714,136,106,8,0,22,114
26715,165,62,46,27,30,135
26716,79,20,47,0,12,67
26717,54,39,9,6,0,54
26718,56,3,40,1,12,44
26719,143,58,57,5,23,120
26720,35,11,17,0,7,28
26721,26,8,5,7,6,20
26722,26,11,10,0,5,21
26723,58,25,20,0,13,45
26724,65,30,22,0,13,52
26725,13,6,4,0,3,10
26726,80,38,32,1,9,71
26727,66,18,29,10,9,57
26728,104,10,62,10,22,82
26729,143,36,76,1,30,113
26730,194,48,103,11,32,162
26731,49,16,21,0,12,37
26732,65,26,23,4,12,53
26733,6,1,3,0,2,4
26734,54,18,23,2,11,43
26735,28,13,9,0,6,22
26736,171,114,26,1,30,141
26737,114,52,26,14,22,92
26738,139,76,26,6,31,108
26739,39,5,25,0,9,30
26740,481,241,118,19,103,378
26741,35,12,19,0,4,31
26742,28,6,15,1,6,22
26743,64,5,44,0,15,49
26744,79,76,0,3,0,79
26745,64,18,33,1,12,52
26746,73,34,22,0,17,56
26747,32,21,9,0,2,30
26748,57,5,36,1,15,42
26749,176,115,25,3,33,143
26750,19,10,6,0,3,16
26751,26,10,4,9,3,23
26752,33,18,9,1,5,28
26753,69,29,16,10,14,55
26754,245,160,67,2,16,229
26755,13,0,11,1,1,12
26756,138,60,39,14,25,113
26757,38,20,8,1,9,29
26758,52,28,13,3,8,44
26759,3,0,1,0,2,1
26760,49,18,25,0,6,43
26761,157,61,41,20,35,122
26762,118,53,38,4,23,95
26763,9,6,0,0,3,6
26764,36,20,7,2,7,29
26765,16,3,10,0,3,13
26766,312,137,105,10,60,252
26767,47,10,29,1,7,40
26768,13,8,4,0,1,12
26769,49,26,10,2,11,38
26770,12,5,4,2,1,11
26771,12,0,10,0,2,10
26772,90,44,29,1,16,74
26773,201,104,34,30,33,168
26774,21,6,8,0,7,14
26775,39,5,25,0,9,30
26776,314,163,83,15,53,261
26777,46,18,20,0,8,38
26778,90,44,34,2,10,80
26779,19,3,10,3,3,16
26780,53,36,4,1,12,41
26781,48,15,19,6,8,40
26782,30,22,0,0,8,22
26783,132,68,13,23,28,104
26784,35,22,3,0,10,25
26785,93,58,10,2,23,70
26786,80,55,9,3,13,67
26787,136,85,13,10,28,108
26788,205,111,42,15,37,168
26789,85,55,15,0,15,70
26790,7,5,2,0,0,7
26791,130,110,3,0,17,113
26792,14,4,10,0,0,14
26793,48,10,23,4,11,37
26794,87,61,7,0,19,68
26795,73,50,9,0,14,59
26796,38,12,17,0,9,29
26797,510,262,93,52,103,407
26798,27,19,0,0,8,19
26799,5,5,0,0,0,5
26800,81,22,32,17,10,71
26801,566,411,37,1,117,449
26802,73,39,11,4,19,54
26803,168,130,12,1,25,143
26804,13,1,9,0,3,10
26805,121,48,30,22,21,100
26806,5,5,0,0,0,5
26807,17,9,4,1,3,14
26808,93,23,50,3,17,76
26809,22,9,10,2,1,21
26810,72,27,27,4,14,58
26811,52,29,8,6,9,43
26812,5,4,0,0,1,4
26813,9,7,1,0,1,8
26814,249,134,59,13,43,206
26815,29,2,21,1,5,24
26816,38,13,18,2,5,33
26817,356,190,92,15,59,297
26818,30,12,14,0,4,26
26819,448,331,20,0,97,351
26820,150,96,27,1,26,124
26821,57,26,25,0,6,51
26822,36,26,4,5,1,35
26823,22,11,7,0,4,18
26824,32,9,17,2,4,28
26825,45,1,31,0,13,32
26826,473,130,200,39,104,369
26827,49,34,9,1,5,44
26828,29,11,10,2,6,23
26829,89,45,17,7,20,69
26830,55,38,6,1,10,45
26831,15,4,9,0,2,13
26832,69,24,30,1,14,55
26833,56,26,16,3,11,45
26834,39,3,29,2,5,34
26835,155,97,30,1,27,128
26836,158,120,7,0,31,127
26837,53,25,10,3,15,38
26838,65,38,12,0,15,50
26839,96,54,26,0,16,80
26840,37,7,11,7,12,25
26841,33,2,6,17,8,25
26842,1080,392,443,46,199,881
26843,47,35,5,0,7,40
26844,219,80,61,30,48,171
26845,191,61,79,12,39,152
26846,13,1,9,0,3,10
26847,64,33,9,2,20,44
26848,101,23,46,11,21,80
26849,128,76,27,0,25,103
26850,14,1,3,8,2,12
26851,74,22,35,4,13,61
26852,8,0,5,0,3,5
26853,104,64,28,0,12,92
26854,232,179,13,0,40,192
26855,4,0,3,0,1,3
26856,73,44,15,0,14,59
26857,52,31,12,3,6,46
26858,85,23,39,5,18,67
26859,110,41,45,8,16,94
26860,68,45,7,1,15,53
26861,115,55,39,2,19,96
26862,101,42,21,18,20,81
26863,30,22,3,1,4,26
26864,106,32,52,4,18,88
26865,117,62,10,21,24,93
26866,136,77,22,3,34,102
26867,242,20,175,2,45,197
26868,49,20,13,1,15,34
26869,292,149,83,12,48,244
26870,144,93,29,0,22,122
26871,147,109,9,0,29,118
26872,78,48,15,0,15,63
26873,80,51,13,8,8,72
26874,46,5,30,0,11,35
26875,686,395,161,21,109,577
26876,106,41,24,13,28,78
26877,26,16,5,0,5,21
26878,80,37,19,11,13,67
26879,65,41,13,1,10,55
26880,105,48,20,15,22,83
26881,67,27,28,0,12,55
26882,43,17,21,1,4,39
26883,138,67,48,1,22,116
26884,20,11,5,0,4,16
26885,86,33,33,0,20,66
26886,92,32,39,9,12,80
26887,54,21,23,2,8,46
26888,674,393,141,21,119,555
26889,9,7,0,0,2,7
26890,0,0,0,0,0,0
26891,23,1,18,0,4,19
26892,46,29,3,1,13,33
26893,195,54,19,90,32,163
26894,56,36,8,0,12,44
26895,99,44,29,5,21,78
26896,79,43,18,2,16,63
26897,1,1,0,0,0,1
26898,76,31,29,1,15,61
26899,112,66,19,2,25,87
26900,27,15,9,0,3,24
26901,19,15,3,0,1,18
26902,107,37,42,11,17,90
26903,108,70,16,3,19,89
26904,26,10,6,0,10,16
26905,50,5,39,1,5,45
26906,102,32,30,21,19,83
26907,120,53,36,2,29,91
26908,41,13,2,17,9,32
26909,12,5,4,3,0,12
26910,346,149,123,6,68,278
26911,92,29,32,12,19,73
26912,131,99,1,1,30,101
26913,310,134,105,6,65,245
26914,15,9,3,1,2,13
26915,32,21,9,0,2,30
26916,45,31,9,0,5,40
26917,30,19,3,4,4,26
26918,49,14,22,3,10,39
26919,48,34,2,3,9,39
26920,217,137,61,4,15,202
26921,25,4,10,7,4,21
26922,45,25,15,0,5,40
26923,20,3,9,1,7,13
26924,0,0,0,0,0,0
26925,36,31,4,0,1,35
26926,3,2,1,0,0,3
26927,17,10,5,0,2,15
26928,49,23,12,2,12,37
26929,70,54,6,0,10,60
26930,160,94,36,1,29,131
26931,345,186,88,15,56,289
26932,53,23,18,2,10,43
26933,44,12,21,1,10,34
26934,633,366,146,16,105,528
26935,199,79,36,33,51,148
26936,120,95,8,0,17,103
26937,405,228,94,0,83,322
26938,194,88,48,20,38,156
26939,52,11,27,1,13,39
26940,56,39,8,2,7,49
26941,50,0,33,2,15,35
26942,19,13,4,0,2,17
26943,51,23,7,9,12,39
26944,69,20,36,0,13,56
26945,356,269,15,0,72,284
26946,11,2,7,1,1,10
26947,16,6,7,0,3,13
26948,89,48,28,1,12,77
26949,44,15,12,1,16,28
26950,472,218,147,14,93,379
26951,61,36,7,6,12,49
26952,16,11,3,0,2,14
26953,226,97,15,76,38,188
26954,58,39,8,1,10,48
26955,72,54,6,0,12,60
26956,81,40,9,20,12,69
26957,18,8,8,1,1,17
26958,19,6,11,0,2,17
26959,276,22,197,2,55,221
26960,150,108,14,1,27,123
26961,56,32,7,4,13,43
26962,37,17,5,7,8,29
26963,92,73,4,1,14,78
26964,1,0,0,0,1,0
26965,32,21,9,0,2,30
26966,119,54,39,1,25,94
26967,320,133,126,5,56,264
26968,37,20,13,0,4,33
26969,67,35,14,4,14,53
26970,75,53,7,3,12,63
26971,34,18,9,0,7,27
26972,135,90,14,4,27,108
26973,74,53,7,3,11,63
26974,21,7,10,0,4,17
26975,22,15,1,0,6,16
26976,157,49,84,4,20,137
26977,171,113,27,1,30,141
26978,161,111,24,0,26,135
26979,141,62,52,1,26,115
26980,35,14,13,0,8,27
26981,210,114,33,23,40,170
26982,53,3,40,0,10,43
26983,55,21,5,19,10,45
26984,45,18,19,1,7,38
26985,58,10,32,4,12,46
26986,99,33,26,21,19,80
26987,55,12,38,0,5,50
26988,127,75,21,3,28,99
26989,243,107,75,17,44,199
26990,10,1,5,0,4,6
26991,320,181,66,6,67,253
26992,202,103,50,0,49,153
26993,200,82,35,34,49,151
26994,32,21,9,0,2,30
26995,81,15,42,1,23,58
26996,471,216,148,14,93,378
26997,38,18,9,1,10,28
26998,35,18,10,2,5,30
26999,8,0,4,0,4,4
27000,288,193,69,3,23,265
27001,5,3,1,0,1,4
27002,58,13,33,0,12,46
27003,144,47,72,3,22,122
27004,47,11,29,1,6,41
27005,64,42,2,4,16,48
27006,35,23,2,1,9,26
27007,20,9,3,2,6,14
27008,303,162,75,16,50,253
27009,80,37,27,0,16,64
27010,59,29,17,0,13,46
27011,130,67,41,11,11,119
27012,125,40,60,4,21,104
27013,49,19,24,0,6,43
27014,215,51,28,101,35,180
27015,472,220,151,13,88,384
27016,85,35,9,22,19,66
27017,31,12,10,1,8,23
27018,20,4,15,0,1,19
27019,11,7,1,0,3,8
27020,23,10,5,1,7,16
27021,43,11,17,3,12,31
27022,81,51,5,11,14,67
27023,42,18,8,6,10,32
27024,41,9,15,10,7,34
27025,87,54,17,0,16,71
27026,120,83,11,0,26,94
27027,20,12,0,6,2,18
27028,327,161,63,40,63,264
27029,95,56,22,3,14,81
27030,9,3,3,0,3,6
27031,51,14,26,2,9,42
27032,311,156,88,1,66,245
27033,224,112,37,35,40,184
27034,14,1,10,2,1,13
27035,160,67,45,11,37,123
27036,43,11,23,2,7,36
27037,361,175,69,42,75,286
27038,41,9,22,3,7,34
27039,110,30,61,0,19,91
27040,29,14,11,0,4,25
27041,7,2,2,2,1,6
27042,164,60,71,12,21,143
27043,78,37,26,0,15,63
27044,25,21,2,1,1,24
27045,136,61,39,9,27,109
27046,43,9,20,5,9,34
27047,79,38,23,2,16,63
27048,8,6,2,0,0,8
27049,18,8,4,1,5,13
27050,34,16,13,0,5,29
27051,45,20,13,6,6,39
27052,31,20,5,0,6,25
27053,129,53,31,17,28,101
27054,12,1,7,0,4,8
27055,199,50,27,88,34,165
27056,28,11,11,4,2,26
27057,34,4,15,6,9,25
27058,126,46,47,13,20,106
27059,19,9,6,0,4,15
27060,12,9,2,0,1,11
27061,32,4,23,0,5,27
27062,47,32,1,0,14,33
27063,40,15,18,0,7,33
27064,29,8,15,0,6,23
27065,172,59,60,23,30,142
27066,121,53,41,0,27,94
27067,54,14,26,0,14,40
27068,232,120,57,13,42,190
27069,17,12,2,0,3,14
27070,4,1,2,0,1,3
27071,53,29,16,1,7,46
27072,58,25,20,4,9,49
27073,90,29,32,11,18,72
27074,113,45,37,9,22,91
27075,11,2,6,1,2,9
27076,12,2,9,0,1,11
27077,36,16,13,1,6,30
27078,32,21,9,0,2,30
27079,39,26,7,0,6,33
27080,102,31,50,3,18,84
27081,19,5,6,1,7,12
27082,46,18,20,0,8,38
27083,76,48,12,1,15,61
27084,12,5,4,1,2,10
27085,24,12,10,0,2,22
27086,179,76,28,31,44,135
27087,50,15,20,0,15,35
27088,78,34,31,0,13,65
27089,667,368,164,24,111,556
27090,111,88,7,2,14,97
27091,26,13,8,0,5,21
27092,54,25,18,1,10,44
27093,38,10,15,6,7,31
27094,144,58,32,25,29,115
27095,120,45,34,15,26,94
27096,255,116,71,22,46,209
27097,93,41,27,1,24,69
27098,77,29,22,6,20,57
27099,116,79,11,0,26,90
27100,61,17,25,7,12,49
27101,75,36,19,7,13,62
27102,56,27,21,0,8,48
27103,88,40,24,11,13,75
27104,361,197,54,33,77,284
27105,68,33,17,2,16,52
27106,109,76,14,3,16,93
27107,213,128,62,5,18,195
27108,11,9,2,0,0,11
27109,14,3,4,4,3,11
27110,34,25,2,0,7,27
27111,42,24,8,0,10,32
27112,15,4,11,0,0,15
27113,16,4,10,0,2,14
27114,123,95,5,0,23,100
27115,86,19,31,17,19,67
27116,40,8,17,0,15,25
27117,70,19,25,9,17,53
27118,160,114,11,0,35,125
27119,165,98,38,1,28,137
27120,486,267,108,16,95,391
27121,21,6,8,3,4,17
27122,44,6,25,3,10,34
27123,46,18,20,0,8,38
27124,47,26,3,7,11,36
27125,22,10,4,2,6,16
27126,38,9,23,1,5,33
27127,139,50,31,28,30,109
27128,10,3,5,0,2,8
27129,441,229,97,13,102,339
27130,63,41,8,1,13,50
27131,111,45,39,10,17,94
27132,145,63,52,1,29,116
27133,108,46,42,3,17,91
27134,60,34,8,8,10,50
27135,137,56,53,2,26,111
27136,98,60,8,8,22,76
27137,48,23,14,0,11,37
27138,45,12,18,0,15,30
27139,16,8,2,0,6,10
27140,108,47,20,15,26,82
27141,45,20,9,7,9,36
27142,24,12,2,0,10,14
27143,16,7,5,0,4,12
27144,44,25,12,0,7,37
27145,27,12,10,0,5,22
27146,345,204,68,0,73,272
27147,224,116,53,13,42,182
27148,4,4,0,0,0,4
27149,62,23,27,1,11,51
27150,302,171,77,0,54,248
27151,46,22,14,0,10,36
27152,154,99,3,17,35,119
27153,25,14,5,1,5,20
27154,293,146,86,12,49,244
27155,33,6,19,1,7,26
27156,3,0,3,0,0,3
27157,78,29,32,9,8,70
27158,2,1,1,0,0,2
27159,206,119,42,8,37,169
27160,101,63,27,0,11,90
27161,19,11,7,1,0,19
27162,90,24,52,1,13,77
27163,166,5,132,0,29,137
27164,44,35,2,0,7,37
27165,5,5,0,0,0,5
27166,198,97,38,29,34,164
27167,548,276,103,54,115,433
27168,222,74,83,15,50,172
27169,114,47,27,14,26,88
27170,32,21,9,0,2,30
27171,470,222,143,15,90,380
27172,29,8,11,2,8,21
27173,35,15,12,0,8,27
27174,11,8,1,0,2,9
27175,58,34,16,0,8,50
27176,52,41,1,0,10,42
27177,31,20,4,0,7,24
27178,42,11,23,1,7,35
27179,27,0,18,0,9,18
27180,24,13,6,0,5,19
27181,55,37,5,0,13,42
27182,29,1,23,2,3,26
27183,108,46,30,12,20,88
27184,150,24,97,1,28,122
27185,65,24,3,28,10,55
27186,23,11,10,1,1,22
27187,16,7,1,3,5,11
27188,157,80,45,1,31,126
27189,105,37,25,20,23,82
27190,46,18,20,0,8,38
27191,73,50,9,0,14,59
27192,81,40,16,8,17,64
27193,4,1,2,0,1,3
27194,65,36,15,0,14,51
27195,173,125,7,3,38,135
27196,46,20,7,8,11,35
27197,29,6,16,0,7,22
27198,37,18,15,1,3,34
27199,54,14,19,8,13,41
27200,17,7,6,1,3,14
27201,65,5,46,3,11,54
27202,161,67,33,21,40,121
27203,567,398,47,1,121,446
27204,26,17,4,0,5,21
27205,53,22,6,16,9,44
27206,138,90,26,5,17,121
27207,17,7,6,1,3,14
27208,101,95,0,6,0,101
27209,28,11,15,0,2,26
27210,116,82,22,1,11,105
27211,32,8,15,4,5,27
27212,65,37,14,0,14,51
27213,39,11,23,0,5,34
27214,24,13,7,0,4,20
27215,7,1,4,0,2,5
27216,338,162,84,25,67,271
27217,205,86,43,27,49,156
27218,219,91,54,28,46,173
27219,347,250,17,2,78,269
27220,148,51,39,30,28,120
27221,60,31,12,4,13,47
27222,25,6,13,1,5,20
27223,65,6,47,3,9,56
27224,32,21,9,0,2,30
27225,23,2,19,0,2,21
27226,141,79,40,13,9,132
27227,32,25,1,0,6,26
27228,219,149,29,0,41,178
27229,98,43,34,5,16,82
27230,62,24,21,5,12,50
27231,26,0,19,0,7,19
27232,28,15,8,0,5,23
27233,144,78,29,1,36,108
27234,58,23,21,1,13,45
27235,190,145,18,0,27,163
27236,75,23,25,12,15,60
27237,68,39,19,0,10,58
27238,109,61,14,10,24,85
27239,160,114,11,0,35,125
27240,10,5,2,0,3,7
27241,57,35,15,0,7,50
27242,56,36,6,0,14,42
27243,24,12,8,2,2,22
27244,44,8,15,9,12,32
27245,39,11,16,6,6,33
27246,73,30,23,3,17,56
27247,16,5,9,0,2,14
27248,81,65,5,1,10,71
27249,38,8,21,3,6,32
27250,26,11,9,2,4,22
27251,357,157,110,11,79,278
27252,151,24,98,1,28,123
27253,251,59,25,124,43,208
27254,46,26,13,0,7,39
27255,47,24,11,1,11,36
27256,21,7,8,0,6,15
27257,342,146,120,6,70,272
27258,0,0,0,0,0,0
27259,82,38,25,0,19,63
27260,55,31,12,0,12,43
27261,414,170,110,43,91,323
27262,45,21,10,1,13,32
27263,102,26,25,29,22,80
27264,136,47,42,22,25,111
27265,136,81,30,0,25,111
27266,10,8,1,0,1,9
27267,297,24,214,2,57,240
27268,20,8,6,1,5,15
27269,112,56,33,4,19,93
27270,71,28,7,21,15,56
27271,351,173,92,13,73,278
27272,12,2,8,0,2,10
27273,83,42,15,9,17,66
27274,36,26,4,0,6,30
27275,20,4,7,3,6,14
27276,191,39,51,63,38,153
27277,170,112,27,1,30,140
27278,8,1,5,0,2,6
27279,46,18,20,0,8,38
27280,199,147,14,1,37,162
27281,31,19,4,4,4,27
27282,49,25,15,4,5,44
27283,71,45,15,0,11,60
27284,63,32,20,2,9,54
27285,19,2,10,0,7,12
27286,152,59,38,21,34,118
27287,191,146,14,1,30,161
27288,91,36,35,4,16,75
27289,43,13,18,6,6,37
27290,182,129,13,1,39,143
27291,124,61,15,19,29,95
27292,200,43,54,62,41,159
27293,138,54,44,9,31,107
27294,42,7,29,0,6,36
27295,39,2,26,2,9,30
27296,89,39,25,1,24,65
27297,49,26,15,0,8,41
27298,184,96,48,0,40,144
27299,12,6,2,0,4,8
27300,10,7,0,0,3,7
27301,56,10,14,21,11,45
27302,76,26,39,0,11,65
27303,2,0,1,0,1,1
27304,29,11,12,1,5,24
27305,39,4,27,0,8,31
27306,32,8,21,0,3,29
27307,57,42,1,0,14,43
27308,32,21,9,0,2,30
27309,60,26,22,0,12,48
27310,161,35,55,37,34,127
27311,9,4,4,0,1,8
27312,87,51,14,5,17,70
27313,229,20,164,2,43,186
27314,44,8,18,8,10,34
27315,12,4,5,0,3,9
27316,14,5,3,3,3,11
27317,109,57,32,4,16,93
27318,29,16,6,1,6,23
27319,71,47,10,1,13,58
27320,30,29,0,0,1,29
27321,41,5,26,0,10,31
27322,23,3,10,4,6,17
27323,12,4,3,1,4,8
27324,156,24,97,3,32,124
27325,65,15,34,9,7,58
27326,10,4,6,0,0,10
27327,12,11,0,0,1,11
27328,227,78,88,13,48,179
27329,38,14,18,0,6,32
27330,32,21,9,0,2,30
27331,125,57,42,4,22,103
27332,72,62,2,0,8,64
27333,78,25,42,0,11,67
27334,32,12,6,7,7,25
27335,47,27,10,4,6,41
27336,48,12,23,0,13,35
27337,39,19,10,0,10,29
27338,22,7,5,3,7,15
27339,51,29,12,2,8,43
27340,83,28,29,2,24,59
27341,25,8,3,5,9,16
27342,75,35,25,0,15,60
27343,21,9,9,0,3,18
27344,333,166,107,2,58,275
27345,565,416,34,1,114,451
27346,100,46,16,19,19,81
27347,98,63,11,2,22,76
27348,66,20,26,3,17,49
27349,75,31,12,5,27,48
27350,142,66,45,11,20,122
27351,277,94,126,14,43,234
27352,57,7,39,0,11,46
27353,50,25,20,1,4,46
27354,50,19,19,1,11,39
27355,44,5,31,5,3,41
27356,137,49,65,0,23,114
27357,115,37,46,7,25,90
27358,115,38,45,10,22,93
27359,30,21,3,0,6,24
27360,68,47,8,0,13,55
27361,1,1,0,0,0,1
27362,153,47,78,4,24,129
27363,66,28,16,5,17,49
27364,240,99,14,83,44,196
27365,51,21,18,0,12,39
27366,21,13,2,1,5,16
27367,41,18,8,5,10,31
27368,180,100,20,19,41,139
27369,51,25,15,0,11,40
27370,70,14,42,1,13,57
27371,11,6,5,0,0,11
27372,41,17,16,0,8,33
27373,181,42,18,93,28,153
27374,390,166,106,38,80,310
27375,49,23,15,0,11,38
27376,73,30,20,1,22,51
27377,54,14,24,1,15,39
27378,495,263,86,42,104,391
27379,86,70,2,0,14,72
27380,4,1,0,0,3,1
27381,73,47,8,2,16,57
27382,7,4,3,0,0,7
27383,32,21,9,0,2,30
27384,143,10,82,19,32,111
27385,122,54,50,3,15,107
27386,181,118,23,4,36,145
27387,36,9,17,0,10,26
27388,30,21,5,0,4,26
27389,17,9,3,0,5,12
27390,201,86,42,25,48,153
27391,96,48,30,1,17,79
27392,90,39,30,0,21,69
27393,79,53,11,0,15,64
27394,87,53,9,0,25,62
27395,67,24,6,22,15,52
27396,276,51,169,3,53,223
27397,6,1,1,0,4,2
27398,377,193,100,9,75,302
27399,131,76,28,0,27,104
27400,63,11,37,0,15,48
27401,30,16,7,1,6,24
27402,83,40,29,4,10,73
27403,23,7,9,1,6,17
27404,318,190,58,0,70,248
27405,118,41,34,14,29,89
27406,11,8,2,0,1,10
27407,31,15,8,0,8,23
27408,17,4,11,0,2,15
27409,65,49,12,0,4,61
27410,505,359,39,1,106,399
27411,65,44,14,1,6,59
27412,38,5,25,0,8,30
27413,38,5,24,0,9,29
27414,45,24,10,1,10,35
27415,93,40,16,17,20,73
27416,68,15,33,10,10,58
27417,284,152,80,0,52,232
27418,179,116,29,2,32,147
27419,365,180,116,1,68,297
27420,6,3,2,1,0,6
27421,13,11,0,1,1,12
27422,32,21,9,0,2,30
27423,103,36,47,0,20,83
27424,41,23,12,0,6,35
27425,1,0,1,0,0,1
27426,160,122,7,0,31,129
27427,654,383,142,17,112,542
27428,82,38,29,1,14,68
27429,16,12,2,0,2,14
27430,94,57,19,4,14,80
27431,43,14,16,4,9,34
27432,195,88,49,20,38,157
27433,127,80,22,0,25,102
27434,85,24,36,3,22,63
27435,87,45,24,0,18,69
27436,39,2,29,0,8,31
27437,46,18,20,0,8,38
27438,34,2,25,0,7,27
27439,116,71,25,0,20,96
27440,55,26,24,0,5,50
27441,44,32,0,2,10,34
27442,4,2,1,0,1,3
27443,278,94,126,14,44,234
27444,110,38,42,11,19,91
27445,266,182,62,2,20,246
27446,56,25,15,3,13,43
27447,8,2,4,1,1,7
27448,510,222,126,46,116,394
27449,44,22,19,0,3,41
27450,92,45,31,1,15,77
27451,75,39,13,9,14,61
27452,5,3,1,0,1,4
27453,319,156,91,3,69,250
27454,42,19,11,1,11,31
27455,31,10,14,0,7,24
27456,98,94,0,4,0,98
27457,148,74,37,0,37,111
27458,101,54,34,2,11,90
27459,208,137,24,0,47,161
27460,6,0,4,0,2,4
27461,21,1,17,0,3,18
27462,115,43,40,6,26,89
27463,51,39,4,0,8,43
27464,161,94,37,1,29,132
27465,15,9,1,0,5,10
27466,150,108,6,5,31,119
27467,55,30,14,2,9,46
27468,104,34,41,10,19,85
27469,165,67,56,17,25,140
27470,59,19,27,0,13,46
27471,56,24,22,0,10,46
27472,218,91,14,76,37,181
27473,271,30,187,2,52,219
27474,32,21,9,0,2,30
27475,279,95,126,14,44,235
27476,387,211,107,0,69,318
27477,59,35,10,3,11,48
27478,235,50,138,2,45,190
27479,16,5,7,0,4,12
27480,59,27,15,3,14,45
27481,46,34,0,0,12,34
27482,269,105,95,20,49,220
27483,21,14,1,1,5,16
27484,64,34,15,0,15,49
27485,364,207,79,0,78,286
27486,81,21,48,0,12,69
27487,10,0,9,0,1,9
27488,48,33,4,0,11,37
27489,21,8,9,0,4,17
27490,97,33,41,10,13,84
27491,154,56,38,29,31,123
27492,26,15,7,0,4,22
27493,199,90,55,12,42,157
27494,74,33,13,13,15,59
27495,21,18,2,0,1,20
27496,51,26,12,1,12,39
27497,40,20,15,1,4,36
27498,175,82,53,11,29,146
27499,169,83,50,3,33,136
27500,456,119,192,45,100,356
27501,97,54,25,0,18,79
27502,291,40,198,2,51,240
27503,140,70,31,9,30,110
27504,157,51,46,33,27,130
27505,67,44,11,1,11,56
27506,23,13,5,2,3,20
27507,272,20,194,2,56,216
27508,69,21,29,10,9,60
27509,52,0,46,0,6,46
27510,86,51,19,4,12,74
27511,241,182,8,0,51,190
27512,13,3,5,0,5,8
27513,3,2,1,0,0,3
27514,46,18,20,0,8,38
27515,74,42,17,3,12,62
27516,9,4,3,0,2,7
27517,48,30,11,2,5,43
27518,577,337,129,15,96,481
27519,51,23,17,2,9,42
27520,51,23,14,4,10,41
27521,421,209,107,24,81,340
27522,139,56,55,1,27,112
27523,51,15,17,7,12,39
27524,48,39,3,1,5,43
27525,32,21,9,0,2,30
27526,21,11,8,1,1,20
27527,39,12,17,3,7,32
27528,272,129,83,5,55,217
27529,46,12,22,0,12,34
27530,76,48,13,2,13,63
27531,7,5,1,0,1,6
27532,138,56,42,17,23,115
27533,102,54,24,4,20,82
27534,60,15,5,28,12,48
27535,23,14,5,4,0,23
27536,56,21,4,21,10,46
27537,439,112,181,44,102,337
27538,19,7,7,0,5,14
27539,113,59,21,10,23,90
27540,18,0,13,0,5,13
27541,49,20,18,0,11,38
27542,39,16,20,0,3,36
27543,34,4,25,1,4,30
27544,10,3,5,1,1,9
27545,431,177,113,46,95,336
27546,432,104,179,48,101,331
27547,80,41,9,8,22,58
27548,24,20,2,0,2,22
27549,208,54,22,98,34,174
27550,174,99,19,15,41,133
27551,97,56,19,5,17,80
27552,43,37,1,0,5,38
27553,101,52,28,4,17,84
27554,219,148,30,0,41,178
27555,30,8,17,1,4,26
27556,71,7,46,5,13,58
27557,89,40,29,3,17,72
27558,38,5,25,0,8,30
27559,59,38,7,0,14,45
27560,14,6,2,3,3,11
27561,181,111,15,13,42,139
27562,16,9,1,1,5,11
27563,17,2,10,1,4,13
27564,40,27,3,3,7,33
27565,127,66,15,15,31,96
27566,44,10,22,0,12,32
27567,646,384,128,18,116,530
27568,26,12,6,2,6,20
27569,85,24,36,9,16,69
27570,18,12,3,0,3,15
27571,321,93,164,5,59,262
27572,12,4,5,0,3,9
27573,77,20,36,1,20,57
27574,126,83,20,2,21,105
27575,43,13,23,0,7,36
27576,589,432,39,1,117,472
27577,194,61,93,3,37,157
27578,85,55,15,0,15,70
27579,112,77,11,1,23,89
27580,52,35,5,3,9,43
27581,110,54,34,4,18,92
27582,445,211,142,11,81,364
27583,629,416,72,4,137,492
27584,65,33,19,3,10,55
27585,116,33,59,1,23,93
27586,78,43,21,0,14,64
27587,21,18,0,0,3,18
27588,46,7,28,0,11,35
27589,96,44,14,12,26,70
27590,31,7,14,3,7,24
27591,28,19,5,1,3,25
27592,30,14,8,0,8,22
27593,55,38,6,1,10,45
27594,81,54,7,1,19,62
27595,104,56,26,3,19,85
27596,73,31,19,1,22,51
27597,53,35,11,0,7,46
27598,60,2,41,12,5,55
27599,35,21,9,0,5,30
27600,59,34,16,0,9,50
27601,33,3,22,0,8,25
27602,71,49,13,0,9,62
27603,156,81,44,1,30,126
27604,107,33,44,11,19,88
27605,90,28,34,10,18,72
27606,79,15,56,2,6,73
27607,24,0,18,1,5,19
27608,35,6,25,1,3,32
27609,64,35,9,6,14,50
27610,19,4,5,7,3,16
27611,54,28,14,0,12,42
27612,103,37,25,22,19,84
27613,113,93,3,3,14,99
27614,37,3,26,0,8,29
27615,46,18,20,0,8,38
27616,32,21,9,0,2,30
27617,162,84,39,0,39,123
27618,282,146,77,12,47,235
27619,39,10,24,0,5,34
27620,3,0,3,0,0,3
27621,130,68,37,0,25,105
27622,21,8,10,0,3,18
27623,37,9,18,0,10,27
27624,90,72,3,0,15,75
27625,32,15,10,2,5,27
27626,34,17,7,3,7,27
27627,28,7,7,5,9,19
27628,95,48,29,1,17,78
27629,82,46,21,0,15,67
27630,227,88,14,81,44,183
27631,167,73,54,7,33,134
27632,2,0,2,0,0,2
27633,32,16,3,5,8,24
27634,139,55,44,9,31,108
27635,58,25,18,4,11,47
27636,33,0,27,0,6,27
27637,37,7,21,1,8,29
27638,42,20,8,1,13,29
27639,13,2,8,1,2,11
27640,56,17,13,14,12,44
27641,183,66,57,26,34,149
27642,15,12,0,0,3,12
27643,92,26,19,20,27,65
27644,52,14,20,7,11,41
27645,128,39,48,20,21,107
27646,32,17,3,4,8,24
27647,489,244,93,50,102,387
27648,104,50,33,4,17,87
27649,27,11,6,0,10,17
27650,38,17,10,3,8,30
27651,343,152,119,4,68,275
27652,60,36,14,5,5,55
27653,43,14,15,6,8,35
27654,146,96,27,0,23,123
27655,148,13,102,2,31,117
27656,25,4,15,1,5,20
27657,68,37,15,2,14,54
27658,100,44,37,0,19,81
27659,25,5,9,4,7,18
27660,88,40,32,1,15,73
27661,91,54,15,1,21,70
27662,40,3,29,2,6,34
27663,31,5,22,2,2,29
27664,33,11,18,1,3,30
27665,9,6,1,0,2,7
27666,90,32,43,1,14,76
27667,53,28,13,5,7,46
27668,44,26,9,0,9,35
27669,28,14,7,0,7,21
27670,339,204,46,23,66,273
27671,45,15,18,5,7,38
27672,84,48,18,0,18,66
27673,88,39,26,3,20,68
27674,162,42,88,2,30,132
27675,422,312,20,0,90,332
27676,31,17,4,8,2,29
27677,200,51,38,76,35,165
27678,126,61,24,16,25,101
27679,16,2,9,1,4,12
27680,313,163,84,15,51,262
27681,141,104,5,0,32,109
27682,99,31,40,10,18,81
27683,510,277,107,13,113,397
27684,79,33,4,31,11,68
27685,137,93,19,1,24,113
27686,157,82,38,0,37,120
27687,260,185,27,1,47,213
27688,137,72,27,10,28,109
27689,150,109,13,0,28,122
27690,108,29,39,16,24,84
27691,76,43,17,2,14,62
27692,32,21,9,0,2,30
27693,36,16,13,0,7,29
27694,61,28,16,0,17,44
27695,72,4,52,1,15,57
27696,94,47,29,1,17,77
27697,130,63,29,15,23,107
27698,43,15,5,12,11,32
27699,474,218,159,11,86,388
27700,9,4,1,0,4,5
27701,97,26,52,0,19,78
27702,357,158,123,6,70,287
27703,10,1,8,0,1,9
27704,16,5,8,2,1,15
27705,202,79,11,74,38,164
27706,46,18,20,0,8,38
27707,86,27,43,0,16,70
27708,10,5,4,0,1,9
27709,60,13,22,14,11,49
27710,96,65,8,2,21,75
27711,31,15,8,0,8,23
27712,42,18,11,0,13,29
27713,350,150,126,6,68,282
27714,93,62,20,0,11,82
27715,25,20,4,0,1,24
27716,478,225,145,12,96,382
27717,306,102,100,36,68,238
27718,61,27,21,0,13,48
27719,7,0,2,0,5,2
27720,252,171,16,2,63,189
27721,123,45,35,18,25,98
27722,191,138,14,1,38,153
27723,77,44,17,2,14,63
27724,40,24,11,0,5,35
27725,155,115,7,2,31,124
27726,98,76,3,0,19,79
27727,568,351,80,7,130,438
27728,120,53,36,2,29,91
27729,85,58,6,0,21,64
27730,39,3,30,1,5,34
27731,75,38,20,9,8,67
27732,61,38,12,0,11,50
27733,37,7,24,1,5,32
27734,31,15,7,0,9,22
27735,112,64,12,12,24,88
27736,94,42,24,12,16,78
27737,78,51,8,4,15,63
27738,24,14,5,1,4,20
27739,43,9,20,4,10,33
27740,85,52,17,4,12,73
27741,46,12,15,11,8,38
27742,32,21,9,0,2,30
27743,86,25,16,20,25,61
27744,37,15,15,0,7,30
27745,42,8,22,5,7,35
27746,61,33,18,0,10,51
27747,31,12,10,2,7,24
27748,40,6,22,3,9,31
27749,73,44,13,0,16,57
27750,18,7,7,0,4,14
27751,3,1,1,0,1,2
27752,262,15,196,0,51,211
27753,46,16,15,4,11,35
27754,10,6,1,0,3,7
27755,277,149,67,16,45,232
27756,200,101,50,0,49,151
27757,44,18,12,1,13,31
27758,42,3,30,2,7,35
27759,55,38,6,1,10,45
27760,33,3,6,16,8,25
27761,2,1,1,0,0,2
27762,278,95,126,14,43,235
27763,67,17,27,4,19,48
27764,120,52,27,15,26,94
27765,26,7,12,1,6,20
27766,6,2,2,0,2,4
27767,121,61,30,6,24,97
27768,12,2,9,0,1,11
27769,69,33,25,1,10,59
27770,22,10,2,3,7,15
27771,183,82,55,2,44,139
27772,114,90,4,0,20,94
27773,27,9,12,0,6,21
27774,39,1,9,22,7,32
27775,18,0,14,0,4,14
27776,9,8,0,0,1,8
27777,80,39,26,1,14,66
27778,29,6,16,0,7,22
27779,162,64,60,9,29,133
27780,82,27,39,3,13,69
27781,38,1,29,0,8,30
27782,34,17,10,1,6,28
27783,6,1,0,4,1,5
27784,43,4,30,1,8,35
27785,454,136,188,31,99,355
27786,43,14,20,1,8,35
27787,32,21,9,0,2,30
27788,215,91,66,20,38,177
27789,46,18,20,0,8,38
27790,46,18,20,0,8,38
27791,168,126,3,1,38,130
27792,58,24,24,0,10,48
27793,23,8,6,2,7,16
27794,28,18,5,0,5,23
27795,194,93,61,0,40,154
27796,28,14,7,0,7,21
27797,23,11,8,1,3,20
27798,35,16,10,3,6,29
27799,27,19,5,0,3,24
27800,7,3,2,1,1,6
27801,81,15,49,0,17,64
27802,17,1,10,1,5,12
27803,6,0,4,0,2,4
27804,21,7,9,3,2,19
27805,124,25,68,1,30,94
27806,40,28,2,3,7,33
27807,11,3,5,1,2,9
27808,18,8,6,0,4,14
27809,11,2,2,2,5,6
27810,79,41,15,8,15,64
27811,49,25,12,1,11,38
27812,444,142,182,21,99,345
27813,156,72,42,0,42,114
27814,79,44,18,2,15,64
27815,25,0,19,0,6,19
27816,621,348,149,21,103,518
27817,104,43,40,0,21,83
27818,40,17,4,5,14,26
27819,64,20,25,10,9,55
27820,339,160,95,15,69,270
27821,48,37,2,2,7,41
27822,44,16,4,16,8,36
27823,189,88,47,16,38,151
27824,417,132,168,22,95,322
27825,66,33,11,6,16,50
27826,38,12,15,2,9,29
27827,24,10,7,0,7,17
27828,60,44,12,0,4,56
27829,647,378,141,16,112,535
27830,69,39,3,14,13,56
27831,46,18,20,0,8,38
27832,37,10,10,13,4,33
27833,53,17,27,0,9,44
27834,462,259,94,11,98,364
27835,100,26,44,3,27,73
27836,348,153,121,6,68,280
27837,217,52,50,78,37,180
27838,162,118,4,2,38,124
27839,105,24,35,18,28,77
27840,107,46,30,12,19,88
27841,19,7,10,0,2,17
27842,2,0,1,0,1,1
27843,22,17,0,0,5,17
27844,28,6,11,3,8,20
27845,64,23,31,1,9,55
27846,121,39,26,29,27,94
27847,14,4,6,1,3,11
27848,47,5,32,0,10,37
27849,118,99,2,0,17,101
27850,49,23,14,1,11,38
27851,111,55,25,8,23,88
27852,98,43,33,4,18,80
27853,98,48,17,2,31,67
27854,258,95,108,6,49,209
27855,427,205,134,11,77,350
27856,294,79,32,135,48,246
27857,73,26,34,3,10,63
27858,6,0,2,0,4,2
27859,42,11,19,0,12,30
27860,187,72,44,30,41,146
27861,71,6,47,5,13,58
27862,199,79,42,32,46,153
27863,81,23,37,3,18,63
27864,26,14,4,4,4,22
27865,60,7,39,0,14,46
27866,40,24,9,0,7,33
27867,27,12,6,6,3,24
27868,86,51,20,3,12,74
27869,32,14,8,1,9,23
27870,7,5,0,0,2,5
27871,68,39,14,1,14,54
27872,36,7,19,0,10,26
27873,127,74,22,3,28,99
27874,37,21,12,0,4,33
27875,33,25,2,0,6,27
27876,66,21,26,10,9,57
27877,14,5,5,2,2,12
27878,79,41,15,5,18,61
27879,107,57,19,5,26,81
27880,111,84,7,13,7,104
27881,28,14,6,1,7,21
27882,9,1,6,0,2,7
27883,248,11,189,0,48,200
27884,61,5,40,3,13,48
27885,132,31,71,1,29,103
27886,27,5,9,8,5,22
27887,46,18,20,0,8,38
27888,95,24,55,2,14,81
27889,27,1,23,0,3,24
27890,80,20,35,3,22,58
27891,18,9,2,2,5,13
27892,275,64,145,5,61,214
27893,35,22,8,1,4,31
27894,326,160,68,37,61,265
27895,20,18,0,0,2,18
27896,26,4,11,4,7,19
27897,34,5,13,10,6,28
27898,298,140,78,22,58,240
27899,140,52,59,5,24,116
27900,37,21,7,0,9,28
27901,384,177,121,10,76,308
27902,24,4,14,2,4,20
27903,38,24,8,1,5,33
27904,122,99,4,2,17,105
27905,35,23,5,0,7,28
27906,131,40,61,7,23,108
27907,138,69,16,23,30,108
27908,216,38,137,0,41,175
27909,15,3,7,1,4,11
27910,138,104,6,0,28,110
27911,69,16,37,0,16,53
27912,235,51,123,4,57,178
27913,447,148,158,48,93,354
27914,66,38,3,13,12,54
27915,28,11,11,0,6,22
27916,9,1,6,0,2,7
27917,32,4,22,0,6,26
27918,52,12,35,0,5,47
27919,65,50,2,0,13,52
27920,146,58,58,8,22,124
27921,26,16,3,0,7,19
27922,121,82,11,4,24,97
27923,95,51,23,4,17,78
27924,81,27,37,1,16,65
27925,28,9,9,5,5,23
27926,645,400,91,8,146,499
27927,76,37,15,6,18,58
27928,49,12,24,0,13,36
27929,92,28,24,21,19,73
27930,87,54,15,3,15,72
27931,345,95,163,7,80,265
27932,101,35,40,10,16,85
27933,109,34,39,5,31,78
27934,41,7,25,1,8,33
27935,124,93,7,0,24,100
27936,12,6,5,0,1,11
27937,37,4,5,20,8,29
27938,405,208,93,13,91,314
27939,123,94,3,0,26,97
27940,22,4,7,8,3,19
27941,99,26,47,7,19,80
27942,63,47,12,0,4,59
27943,90,29,44,2,15,75
27944,270,18,200,0,52,218
27945,89,41,15,16,17,72
27946,218,152,50,3,13,205
27947,116,54,23,15,24,92
27948,222,61,117,5,39,183
27949,15,8,4,0,3,12
27950,57,28,17,1,11,46
27951,56,3,40,1,12,44
27952,371,174,104,15,78,293
27953,60,22,25,0,13,47
27954,76,40,16,1,19,57
27955,77,43,15,3,16,61
27956,258,196,14,0,48,210
27957,71,48,9,0,14,57
27958,11,7,3,0,1,10
27959,170,82,53,3,32,138
27960,54,24,22,0,8,46
27961,62,41,9,0,12,50
27962,94,23,52,2,17,77
27963,31,11,14,0,6,25
27964,112,80,6,0,26,86
27965,144,70,26,24,24,120
27966,38,1,33,0,4,34
27967,77,35,20,3,19,58
27968,495,342,50,2,101,394
27969,86,43,27,4,12,74
27970,593,407,56,1,129,464
27971,134,75,22,4,33,101
27972,192,89,37,21,45,147
27973,38,17,16,0,5,33
27974,680,396,140,21,123,557
27975,43,24,8,1,10,33
27976,69,38,15,3,13,56
27977,53,23,18,1,11,42
27978,41,15,22,0,4,37
27979,10,8,1,0,1,9
27980,10,4,4,0,2,8
27981,189,86,52,12,39,150
27982,33,3,6,16,8,25
27983,32,21,9,0,2,30
27984,37,15,4,9,9,28
27985,143,27,89,1,26,117
27986,131,85,20,0,26,105
27987,18,1,11,4,2,16
27988,12,6,1,2,3,9
27989,46,28,9,0,9,37
27990,68,47,7,1,13,55
27991,7,4,1,0,2,5
27992,82,65,4,2,11,71
27993,18,10,7,0,1,17
27994,27,17,4,3,3,24
27995,4,0,1,0,3,1
27996,82,40,22,0,20,62
27997,31,12,9,2,8,23
27998,55,39,5,1,10,45
27999,96,51,12,17,16,80
28000,27,13,5,0,9,18
28001,220,51,24,110,35,185
28002,22,7,11,0,4,18
28003,38,18,15,0,5,33
28004,31,13,13,1,4,27
28005,68,40,15,0,13,55
28006,4,1,1,0,2,2
28007,31,4,16,1,10,21
28008,94,61,14,11,8,86
28009,4,1,2,0,1,3
28010,57,19,26,0,12,45
28011,48,29,9,0,10,38
28012,46,18,20,0,8,38
28013,38,19,8,1,10,28
28014,40,4,25,0,11,29
28015,370,181,103,14,72,298
28016,5,3,1,0,1,4
28017,86,54,15,2,15,71
28018,71,13,45,0,13,58
28019,87,54,14,3,16,71
28020,141,94,28,11,8,133
28021,405,304,20,0,81,324
28022,40,14,12,3,11,29
28023,74,41,15,0,18,56
28024,32,21,9,0,2,30
28025,149,86,27,1,35,114
28026,47,2,36,6,3,44
28027,70,19,39,1,11,59
28028,160,50,84,4,22,138
28029,28,19,2,0,7,21
28030,56,35,6,4,11,45
28031,31,2,21,0,8,23
28032,153,60,66,8,19,134
28033,36,21,9,1,5,31
28034,327,134,120,6,67,260
28035,250,154,37,0,59,191
28036,81,47,16,3,15,66
28037,69,37,10,6,16,53
28038,42,19,11,1,11,31
28039,76,18,36,2,20,56
28040,65,33,15,0,17,48
28041,106,56,33,6,11,95
28042,337,139,123,6,69,268
28043,31,16,3,4,8,23
28044,80,55,9,3,13,67
28045,38,5,25,0,8,30
28046,52,17,17,3,15,37
28047,88,28,26,11,23,65
28048,55,6,34,1,14,41
28049,207,75,74,10,48,159
28050,35,10,16,4,5,30
28051,56,3,40,1,12,44
28052,141,79,40,13,9,132
28053,23,14,2,0,7,16
28054,94,59,12,2,21,73
28055,280,73,41,121,45,235
28056,78,50,7,0,21,57
28057,305,158,87,0,60,245
28058,70,28,7,20,15,55
28059,17,6,8,1,2,15
28060,9,1,6,0,2,7
28061,184,71,42,30,41,143
28062,26,10,5,7,4,22
28063,201,85,42,26,48,153
28064,123,27,37,23,36,87
28065,190,103,56,0,31,159
28066,32,21,9,0,2,30
28067,127,41,47,7,32,95
28068,171,74,53,3,41,130
28069,225,98,44,26,57,168
28070,4,1,1,2,0,4
28071,661,389,140,17,115,546
28072,19,6,8,3,2,17
28073,17,3,9,1,4,13
28074,15,3,8,2,2,13
28075,26,10,13,0,3,23
28076,93,43,25,1,24,69
28077,9,2,2,4,1,8
28078,220,149,30,0,41,179
28079,63,23,31,1,8,55
28080,35,6,25,1,3,32
28081,467,233,89,46,99,368
28082,88,24,42,8,14,74
28083,61,27,19,1,14,47
28084,62,34,8,12,8,54
28085,75,44,14,3,14,61
28086,87,51,21,2,13,74
28087,332,137,120,6,69,263
28088,229,130,41,8,50,179
28089,46,18,20,0,8,38
28090,107,59,16,8,24,83
28091,40,20,11,1,8,32
28092,409,236,87,16,70,339
28093,47,43,0,0,4,43
28094,101,52,16,2,31,70
28095,26,8,10,0,8,18
28096,141,47,48,11,35,106
28097,40,7,18,0,15,25
28098,500,364,29,1,106,394
28099,2,1,1,0,0,2
28100,15,2,9,1,3,12
28101,30,13,8,2,7,23
28102,105,38,25,19,23,82
28103,61,18,21,10,12,49
28104,596,434,40,1,121,475
28105,178,84,69,7,18,160
28106,32,21,9,0,2,30
28107,11,7,4,0,0,11
28108,17,4,6,2,5,12
28109,3,0,0,0,3,0
28110,155,74,49,1,31,124
28111,112,71,20,2,19,93
28112,47,16,20,0,11,36
28113,261,154,19,33,55,206
28114,223,74,85,15,49,174
28115,47,13,18,7,9,38
28116,92,54,25,1,12,80
28117,19,11,3,0,5,14
28118,35,2,25,0,8,27
28119,31,8,17,0,6,25
28120,20,1,12,1,6,14
28121,16,5,8,2,1,15
28122,32,21,9,0,2,30
28123,26,8,5,4,9,17
28124,24,9,12,0,3,21
28125,32,21,3,3,5,27
28126,98,51,18,4,25,73
28127,77,75,0,2,0,77
28128,480,188,141,48,103,377
28129,424,205,140,7,72,352
28130,46,19,16,2,9,37
28131,141,25,89,1,26,115
28132,80,23,37,4,16,64
28133,7,1,3,2,1,6
28134,165,82,46,3,34,131
28135,72,45,14,0,13,59
28136,59,14,39,0,6,53
28137,81,33,31,5,12,69
28138,58,1,44,0,13,45
28139,12,0,8,0,4,8
28140,134,91,18,1,24,110
28141,152,109,7,5,31,121
28142,105,32,12,35,26,79
28143,42,34,2,0,6,36
28144,102,26,56,3,17,85
28145,360,181,102,1,76,284
28146,21,7,4,5,5,16
28147,53,21,6,17,9,44
28148,32,7,13,4,8,24
28149,102,65,10,6,21,81
28150,204,96,62,1,45,159
28151,24,5,13,0,6,18
28152,174,121,14,0,39,135
28153,224,170,10,0,44,180
28154,79,53,11,0,15,64
28155,18,9,8,0,1,17
28156,39,11,13,7,8,31
28157,91,56,16,3,16,75
28158,223,75,83,14,51,172
28159,93,40,32,1,20,73
28160,606,345,142,17,102,504
28161,130,46,28,25,31,99
28162,4,0,3,1,0,4
28163,494,229,129,34,102,392
28164,669,382,141,20,126,543
28165,32,12,16,0,4,28
28166,10,5,1,0,4,6
28167,41,25,6,0,10,31
28168,359,155,125,11,68,291
28169,81,29,40,0,12,69
28170,25,9,4,8,4,21
28171,94,43,16,14,21,73
28172,146,63,53,1,29,117
28173,15,4,7,0,4,11
28174,562,350,94,5,113,449
28175,154,81,34,7,32,122
28176,32,0,28,1,3,29
28177,4,1,2,1,0,4
28178,24,12,8,2,2,22
28179,89,42,35,2,10,79
28180,537,375,48,1,113,424
28181,72,40,15,1,16,56
28182,39,8,12,7,12,27
28183,46,18,20,0,8,38
28184,26,17,3,0,6,20
28185,57,19,17,10,11,46
28186,17,4,11,0,2,15
28187,522,211,145,53,113,409
28188,17,0,13,0,4,13
28189,142,93,27,3,19,123
28190,8,2,4,0,2,6
28191,62,34,8,9,11,51
28192,121,44,17,39,21,100
28193,50,20,22,0,8,42
28194,60,40,4,2,14,46
28195,2,2,0,0,0,2
28196,238,174,14,0,50,188
28197,25,5,1,15,4,21
28198,78,24,36,3,15,63
28199,115,77,22,0,16,99
28200,56,2,38,0,16,40
28201,154,61,32,29,32,122
28202,33,17,10,1,5,28
28203,29,9,12,3,5,24
28204,12,2,8,0,2,10
28205,45,19,16,2,8,37
28206,66,33,17,3,13,53
28207,167,128,14,1,24,143
28208,58,10,21,15,12,46
28209,29,20,3,0,6,23
28210,27,10,12,1,4,23
28211,90,65,10,0,15,75
28212,54,36,10,1,7,47
28213,12,2,8,0,2,10
28214,53,15,29,0,9,44
28215,57,24,19,0,14,43
28216,425,201,116,20,88,337
28217,83,51,22,9,1,82
28218,44,8,28,0,8,36
28219,34,13,15,1,5,29
28220,40,30,1,2,7,33
28221,26,8,12,0,6,20
28222,84,50,18,4,12,72
28223,107,34,37,13,23,84
28224,52,2,36,3,11,41
28225,50,29,11,0,10,40
28226,29,22,1,2,4,25
28227,350,186,92,15,57,293
28228,11,2,9,0,0,11
28229,48,30,8,0,10,38
28230,37,22,6,1,8,29
28231,31,6,13,5,7,24
28232,167,31,103,1,32,135
28233,4,0,2,2,0,4
28234,48,33,9,1,5,43
28235,140,30,86,1,23,117
28236,67,45,11,1,10,57
28237,6,0,4,1,1,5
28238,32,21,9,0,2,30
28239,32,21,9,0,2,30
28240,39,12,17,0,10,29
28241,52,15,13,17,7,45
28242,62,29,6,13,14,48
28243,15,5,8,0,2,13
28244,7,2,3,1,1,6
28245,75,35,21,0,19,56
28246,357,157,124,6,70,287
28247,51,17,12,8,14,37
28248,35,12,9,6,8,27
28249,127,45,55,2,25,102
28250,682,396,153,20,113,569
28251,126,48,34,15,29,97
28252,39,14,19,0,6,33
28253,422,196,92,48,86,336
28254,22,10,7,0,5,17
28255,37,6,22,2,7,30
28256,38,12,12,10,4,34
28257,92,34,35,9,14,78
28258,471,122,203,37,109,362
28259,104,61,18,7,18,86
28260,8,1,5,0,2,6
28261,138,80,17,22,19,119
28262,42,31,2,0,9,33
28263,21,15,2,1,3,18
28264,75,43,19,0,13,62
28265,15,4,10,0,1,14
28266,31,5,22,2,2,29
28267,186,68,49,28,41,145
28268,345,186,89,15,55,290
28269,103,22,47,9,25,78
28270,4,2,2,0,0,4
28271,40,19,10,0,11,29
28272,500,283,99,14,104,396
28273,350,188,92,15,55,295
28274,44,7,29,4,4,40
28275,12,7,4,0,1,11
28276,43,22,6,6,9,34
28277,141,79,40,13,9,132
28278,58,41,6,1,10,48
28279,56,38,11,0,7,49
28280,72,48,6,0,18,54
28281,97,66,7,4,20,77
28282,94,47,33,0,14,80
28283,47,10,26,1,10,37
28284,15,2,2,9,2,13
28285,32,21,9,0,2,30
28286,62,40,10,2,10,52
28287,406,184,98,37,87,319
28288,466,218,144,12,92,374
28289,47,18,24,0,5,42
28290,328,193,57,5,73,255
28291,87,36,22,12,17,70
28292,243,55,34,113,41,202
28293,28,3,19,0,6,22
28294,65,36,12,1,16,49
28295,7,4,0,0,3,4
28296,11,1,6,0,4,7
28297,25,14,5,3,3,22
28298,163,48,52,25,38,125
28299,46,18,20,0,8,38
28300,128,82,16,4,26,102
28301,41,8,24,3,6,35
28302,64,24,32,1,7,57
28303,24,10,8,0,6,18
28304,46,18,20,0,8,38
28305,21,6,10,1,4,17
28306,64,35,10,4,15,49
28307,60,28,23,2,7,53
28308,471,215,160,10,86,385
28309,53,34,8,1,10,43
28310,87,57,14,0,16,71
28311,22,12,5,0,5,17
28312,103,20,50,15,18,85
28313,54,14,26,0,14,40
28314,199,100,50,0,49,150
28315,31,0,10,16,5,26
28316,24,9,7,3,5,19
28317,13,7,4,0,2,11
28318,40,8,22,3,7,33
28319,55,33,13,0,9,46
28320,39,19,9,3,8,31
28321,79,23,42,1,13,66
28322,14,5,4,1,4,10
28323,128,89,20,0,19,109
28324,50,12,23,4,11,39
28325,10,1,7,0,2,8
28326,178,47,56,39,36,142
28327,58,21,22,1,14,44
28328,63,47,12,0,4,59
28329,179,64,51,26,38,141
28330,219,63,21,100,35,184
28331,96,31,40,1,24,72
28332,121,44,31,17,29,92
28333,46,18,11,10,7,39
28334,50,5,7,25,13,37
28335,20,4,12,0,4,16
28336,14,8,4,0,2,12
28337,234,103,74,16,41,193
28338,23,2,13,2,6,17
28339,4,1,3,0,0,4
28340,35,2,25,0,8,27
28341,93,26,42,6,19,74
28342,366,163,127,6,70,296
28343,30,22,2,0,6,24
28344,32,21,9,0,2,30
28345,85,40,31,3,11,74
28346,684,404,139,21,120,564
28347,46,18,20,0,8,38
28348,55,34,7,0,14,41
28349,32,21,9,0,2,30
28350,96,53,24,4,15,81
28351,16,12,3,0,1,15
28352,68,30,20,2,16,52
28353,50,24,18,0,8,42
28354,20,12,3,3,2,18
28355,236,155,35,0,46,190
28356,32,21,9,0,2,30
28357,62,40,5,4,13,49
28358,39,27,5,6,1,38
28359,150,51,39,32,28,122
28360,21,1,4,12,4,17
28361,349,158,116,6,69,280
28362,320,237,19,2,62,258
28363,37,21,9,1,6,31
28364,24,7,14,0,3,21
28365,55,38,6,1,10,45
28366,437,201,146,9,81,356
28367,21,1,4,12,4,17
28368,87,45,24,0,18,69
28369,37,17,10,3,7,30
28370,350,189,91,15,55,295
28371,132,28,43,25,36,96
28372,83,30,25,6,22,61
28373,78,34,35,1,8,70
28374,39,19,10,1,9,30
28375,73,34,15,0,24,49
28376,353,194,79,8,72,281
28377,113,27,63,1,22,91
28378,38,19,10,0,9,29
28379,62,32,8,9,13,49
28380,91,43,22,2,24,67
28381,62,35,14,0,13,49
28382,20,13,1,6,0,20
28383,7,4,1,1,1,6
28384,18,1,13,0,4,14
28385,146,80,28,1,37,109
28386,113,45,37,8,23,90
28387,44,19,15,2,8,36
28388,16,4,8,0,4,12
28389,32,21,9,0,2,30
28390,10,2,8,0,0,10
28391,360,156,125,11,68,292
28392,120,87,18,3,12,108
28393,50,2,36,0,12,38
28394,104,56,22,7,19,85
28395,176,92,31,25,28,148
28396,7,2,2,0,3,4
28397,100,54,19,8,19,81
28398,35,15,9,2,9,26
28399,13,1,8,0,4,9
28400,105,38,25,19,23,82
28401,79,46,19,0,14,65
28402,104,75,12,9,8,96
28403,108,38,26,24,20,88
28404,301,148,88,1,64,237
28405,126,28,40,23,35,91
28406,192,132,18,0,42,150
28407,122,50,34,15,23,99
28408,19,4,4,8,3,16
28409,348,149,122,6,71,277
28410,52,41,1,0,10,42
28411,63,27,25,0,11,52
28412,59,24,19,3,13,46
28413,14,3,3,2,6,8
28414,15,6,6,0,3,12
28415,15,2,10,1,2,13
28416,21,10,4,0,7,14
28417,86,40,20,7,19,67
28418,36,2,30,0,4,32
28419,46,18,20,0,8,38
28420,63,41,4,0,18,45
28421,35,23,5,2,5,30
28422,39,5,28,0,6,33
28423,15,3,8,2,2,13
28424,98,53,13,8,24,74
28425,37,19,14,1,3,34
28426,55,33,10,0,12,43
28427,77,10,43,5,19,58
28428,23,7,13,0,3,20
28429,59,31,15,4,9,50
28430,25,17,1,0,7,18
28431,36,24,7,0,5,31
28432,60,32,14,1,13,47
28433,127,77,26,0,24,103
28434,15,9,6,0,0,15
28435,435,320,20,0,95,340
28436,75,30,20,6,19,56
28437,87,64,6,1,16,71
28438,48,0,38,2,8,40
28439,24,6,13,1,4,20
28440,44,19,16,0,9,35
28441,40,30,1,2,7,33
28442,29,15,11,0,3,26
28443,65,31,21,1,12,53
28444,392,224,88,0,80,312
28445,176,125,13,1,37,139
28446,59,6,43,0,10,49
28447,71,33,29,1,8,63
28448,46,24,3,11,8,38
28449,48,23,17,2,6,42
28450,37,7,24,1,5,32
28451,56,35,13,0,8,48
28452,6,4,1,0,1,5
28453,20,8,8,0,4,16
28454,116,58,33,4,21,95
28455,202,101,37,29,35,167
28456,31,13,11,0,7,24
28457,4,2,1,0,1,3
28458,44,20,7,7,10,34
28459,194,141,14,1,38,156
28460,98,29,48,7,14,84
28461,64,46,6,1,11,53
28462,154,73,48,1,32,122
28463,46,18,20,0,8,38
28464,577,405,49,1,122,455
28465,136,72,33,0,31,105
28466,25,12,5,1,7,18
28467,63,31,11,7,14,49
28468,101,40,35,8,18,83
28469,29,9,12,2,6,23
28470,3,1,1,0,1,2
28471,12,2,8,0,2,10
28472,27,16,7,0,4,23
28473,127,102,5,0,20,107
28474,70,16,40,0,14,56
28475,110,53,37,0,20,90
28476,314,134,114,10,56,258
28477,50,9,30,1,10,40
28478,93,32,34,5,22,71
28479,127,74,22,3,28,99
28480,35,1,29,0,5,30
28481,12,5,7,0,0,12
28482,19,8,8,2,1,18
28483,134,60,48,5,21,113
28484,257,74,134,1,48,209
28485,672,391,152,19,110,562
28486,8,0,8,0,0,8
28487,20,10,6,0,4,16
28488,84,53,15,4,12,72
28489,76,25,25,14,12,64
28490,240,164,56,3,17,223
28491,25,8,9,0,8,17
28492,197,119,13,23,42,155
28493,97,40,18,14,25,72
28494,25,5,15,2,3,22
28495,31,22,3,0,6,25
28496,42,15,20,0,7,35
28497,46,18,20,0,8,38
28498,49,33,6,1,9,40
28499,67,36,24,2,5,62
28500,100,70,5,0,25,75
28501,29,13,8,1,7,22
28502,123,40,44,5,34,89
28503,56,29,18,0,9,47
28504,52,32,11,4,5,47
28505,10,5,4,0,1,9
28506,61,11,30,4,16,45
28507,36,12,20,1,3,33
28508,31,16,11,1,3,28
28509,127,69,22,12,24,103
28510,213,127,14,26,46,167
28511,86,65,5,4,12,74
28512,137,85,19,4,29,108
28513,22,13,5,0,4,18
28514,60,44,2,0,14,46
28515,13,5,7,0,1,12
28516,79,23,44,1,11,68
28517,77,33,8,16,20,57
28518,46,18,20,0,8,38
28519,25,4,12,1,8,17
28520,132,54,40,8,30,102
28521,132,50,38,16,28,104
28522,112,89,5,0,18,94
28523,17,0,15,0,2,15
28524,80,38,28,4,10,70
28525,119,45,49,12,13,106
28526,81,40,24,3,14,67
28527,166,121,10,5,30,136
28528,59,22,12,16,9,50
28529,109,35,28,19,27,82
28530,111,67,12,11,21,90
28531,111,63,14,10,24,87
28532,35,22,8,1,4,31
28533,88,43,19,4,22,66
28534,505,257,92,51,105,400
28535,71,17,35,4,15,56
28536,15,7,1,1,6,9
28537,90,36,35,1,18,72
28538,119,42,41,7,29,90
28539,96,62,23,0,11,85
28540,153,64,33,19,37,116
28541,15,4,7,0,4,11
28542,64,18,26,6,14,50
28543,77,27,27,8,15,62
28544,32,17,13,0,2,30
28545,148,69,51,5,23,125
28546,32,22,3,0,7,25
28547,38,17,16,0,5,33
28548,50,14,16,9,11,39
28549,28,13,6,0,9,19
28550,91,24,40,11,16,75
28551,65,45,4,1,15,50
28552,185,97,52,0,36,149
28553,241,100,14,83,44,197
28554,2,0,1,0,1,1
28555,4,1,2,0,1,3
28556,103,32,45,5,21,82
28557,4,2,1,0,1,3
28558,75,46,17,0,12,63
28559,194,75,35,34,50,144
28560,3,0,3,0,0,3
28561,428,202,138,12,76,352
28562,255,191,11,0,53,202
28563,72,29,21,8,14,58
28564,204,73,94,2,35,169
28565,141,41,47,20,33,108
28566,452,234,114,14,90,362
28567,21,5,7,2,7,14
28568,22,9,8,1,4,18
28569,38,19,9,0,10,28
28570,74,8,42,5,19,55
28571,157,77,48,1,31,126
28572,121,25,60,2,34,87
28573,20,6,9,0,5,15
28574,55,13,23,9,10,45
28575,224,96,14,76,38,186
28576,5,3,2,0,0,5
28577,38,16,8,6,8,30
28578,242,122,70,0,50,192
28579,55,32,14,0,9,46
28580,60,41,5,1,13,47
28581,419,217,113,17,72,347
28582,226,75,86,15,50,176
28583,23,19,2,0,2,21
28584,72,41,16,0,15,57
28585,107,68,24,3,12,95
28586,23,11,8,0,4,19
28587,46,18,20,0,8,38
28588,503,366,35,0,102,401
28589,14,6,4,0,4,10
28590,35,5,21,0,9,26
28591,40,25,9,2,4,36
28592,23,7,9,4,3,20
28593,37,21,6,0,10,27
28594,225,75,85,15,50,175
28595,119,72,31,0,16,103
28596,36,21,9,1,5,31
28597,56,34,9,4,9,47
28598,100,81,2,3,14,86
28599,403,229,92,0,82,321
28600,37,8,12,8,9,28
28601,27,8,9,1,9,18
28602,0,0,0,0,0,0
28603,72,7,49,5,11,61
28604,90,50,23,3,14,76
28605,86,18,42,9,17,69
28606,233,156,31,0,46,187
28607,207,117,43,4,43,164
28608,54,36,2,2,14,40
28609,21,14,5,0,2,19
28610,500,270,83,43,104,396
28611,65,44,1,4,16,49
28612,25,4,16,0,5,20
28613,0,0,0,0,0,0
28614,55,37,1,4,13,42
28615,55,2,33,14,6,49
28616,131,35,67,1,28,103
28617,68,49,2,0,17,51
28618,78,45,18,6,9,69
28619,22,4,18,0,0,22
28620,13,1,9,0,3,10
28621,94,41,36,0,17,77
28622,44,11,21,0,12,32
28623,33,3,6,16,8,25
28624,43,2,27,0,14,29
28625,113,45,35,8,25,88
28626,90,26,39,4,21,69
28627,24,7,11,0,6,18
28628,13,5,4,0,4,9
28629,46,18,20,0,8,38
28630,235,69,113,15,38,197
28631,61,21,32,0,8,53
28632,55,35,3,8,9,46
28633,51,34,3,0,14,37
28634,13,5,6,0,2,11
28635,67,38,19,0,10,57
28636,112,85,7,13,7,105
28637,242,100,15,82,45,197
28638,27,13,8,0,6,21
28639,46,18,20,0,8,38
28640,121,44,47,0,30,91
28641,135,75,24,7,29,106
28642,34,16,8,2,8,26
28643,32,21,9,0,2,30
28644,52,19,22,0,11,41
28645,47,10,30,0,7,40
28646,10,0,6,0,4,6
28647,219,148,30,0,41,178
28648,40,13,10,1,16,24
28649,36,16,9,2,9,27
28650,144,92,14,10,28,116
28651,156,80,44,1,31,125
28652,141,103,9,0,29,112
28653,31,21,4,0,6,25
28654,17,5,8,0,4,13
28655,22,4,16,0,2,20
28656,15,4,6,2,3,12
28657,10,3,2,0,5,5
28658,38,9,19,0,10,28
28659,51,36,6,1,8,43
28660,141,75,35,5,26,115
28661,19,4,12,0,3,16
28662,35,19,14,0,2,33
28663,80,39,26,1,14,66
28664,29,0,25,0,4,25
28665,73,36,21,0,16,57
28666,7,4,1,1,1,6
28667,159,95,31,8,25,134
28668,41,13,20,0,8,33
28669,34,14,5,3,12,22
28670,88,36,36,1,15,73
28671,105,53,30,4,18,87
28672,51,16,20,1,14,37
28673,93,49,27,4,13,80
28674,115,50,39,4,22,93
28675,48,12,23,1,12,36
28676,24,0,16,0,8,16
28677,121,44,17,39,21,100
28678,4,1,3,0,0,4
28679,384,124,162,10,88,296
28680,146,36,76,1,33,113
28681,30,20,0,0,10,20
28682,143,37,73,1,32,111
28683,78,43,16,0,19,59
28684,34,23,2,0,9,25
28685,62,14,16,17,15,47
28686,497,344,49,2,102,395
28687,95,53,24,4,14,81
28688,24,15,2,0,7,17
28689,23,12,8,1,2,21
28690,226,152,56,2,16,210
28691,52,15,27,0,10,42
28692,73,9,46,5,13,60
28693,43,21,17,0,5,38
28694,15,7,7,0,1,14
28695,16,11,1,0,4,12
28696,76,53,12,1,10,66
28697,104,45,13,25,21,83
28698,73,17,9,28,19,54
28699,52,34,7,0,11,41
28700,23,6,13,3,1,22
28701,33,13,12,1,7,26
28702,60,37,9,2,12,48
28703,51,22,8,8,13,38
28704,24,5,16,0,3,21
28705,6,2,1,0,3,3
28706,90,37,34,2,17,73
28707,96,23,53,3,17,79
28708,63,42,9,2,10,53
28709,38,15,10,6,7,31
28710,37,23,7,0,7,30
28711,99,33,26,21,19,80
28712,112,52,25,14,21,91
28713,52,9,19,19,5,47
28714,46,20,17,0,9,37
28715,110,32,57,0,21,89
28716,100,46,12,21,21,79
28717,9,1,8,0,0,9
28718,46,22,8,5,11,35
28719,304,70,160,5,69,235
28720,40,16,11,3,10,30
28721,105,30,57,0,18,87
28722,19,7,7,0,5,14
28723,75,33,30,0,12,63
28724,16,2,10,0,4,12
28725,2,1,1,0,0,2
28726,42,23,12,0,7,35
28727,22,14,6,1,1,21
28728,347,149,122,5,71,276
28729,127,92,6,0,29,98
28730,14,8,3,0,3,11
28731,34,2,25,1,6,28
28732,82,37,17,11,17,65
28733,662,381,152,20,109,553
28734,37,2,31,0,4,33
28735,55,18,22,3,12,43
28736,236,100,15,80,41,195
28737,473,237,115,20,101,372
28738,4,0,4,0,0,4
28739,43,23,16,0,4,39
28740,321,167,85,15,54,267
28741,198,139,43,2,14,184
28742,46,18,20,0,8,38
28743,44,33,0,0,11,33
28744,222,124,55,0,43,179
28745,32,21,9,0,2,30
28746,357,217,59,7,74,283
28747,47,14,23,0,10,37
28748,22,9,10,2,1,21
28749,37,14,15,0,8,29
28750,60,13,25,7,15,45
28751,57,44,1,0,12,45
28752,65,21,25,3,16,49
28753,86,35,27,3,21,65
28754,156,80,44,1,31,125
28755,97,33,41,10,13,84
28756,218,46,54,75,43,175
28757,17,15,0,0,2,15
28758,65,29,23,3,10,55
28759,39,18,11,0,10,29
28760,32,21,9,0,2,30
28761,59,37,12,0,10,49
28762,49,32,1,4,12,37
28763,80,15,37,0,28,52
28764,32,21,9,0,2,30
28765,85,21,46,2,16,69
28766,32,21,9,0,2,30
28767,145,13,99,2,31,114
28768,58,46,2,0,10,48
28769,56,37,12,0,7,49
28770,68,29,26,1,12,56
28771,92,26,41,6,19,73
28772,13,0,7,0,6,7
28773,38,25,5,1,7,31
28774,177,78,28,28,43,134
28775,33,1,25,0,7,26
28776,44,35,2,0,7,37
28777,30,18,6,2,4,26
28778,60,21,31,0,8,52
28779,80,16,39,10,15,65
28780,110,64,16,9,21,89
28781,59,31,6,5,17,42
28782,8,3,3,1,1,7
28783,128,52,33,19,24,104
28784,36,26,7,3,0,36
28785,112,73,27,0,12,100
28786,167,49,93,4,21,146
28787,148,49,70,0,29,119
28788,72,40,21,0,11,61
28789,67,4,51,0,12,55
28790,64,29,21,1,13,51
28791,9,4,4,0,1,8
28792,121,58,24,16,23,98
28793,19,11,4,0,4,15
28794,29,0,25,0,4,25
28795,28,17,9,0,2,26
28796,49,8,21,9,11,38
28797,78,24,28,14,12,66
28798,19,4,9,0,6,13
28799,26,5,13,1,7,19
28800,53,11,27,10,5,48
28801,41,12,18,0,11,30
28802,121,65,10,22,24,97
28803,61,19,19,6,17,44
28804,10,3,4,0,3,7
28805,44,12,24,0,8,36
28806,44,20,13,3,8,36
28807,116,29,61,1,25,91
28808,91,38,30,10,13,78
28809,28,14,6,3,5,23
28810,118,55,38,4,21,97
28811,87,65,5,4,13,74
28812,646,376,140,17,113,533
28813,35,11,12,1,11,24
28814,230,91,14,81,44,186
28815,97,30,40,10,17,80
28816,53,34,8,1,10,43
28817,15,13,0,0,2,13
28818,2,1,1,0,0,2
28819,62,27,18,6,11,51
28820,517,370,38,0,109,408
28821,374,186,103,13,72,302
28822,67,37,15,0,15,52
28823,42,9,11,9,13,29
28824,32,21,9,0,2,30
28825,532,293,106,13,120,412
28826,103,54,19,9,21,82
28827,36,9,19,0,8,28
28828,73,5,51,1,16,57
28829,14,6,3,0,5,9
28830,76,17,36,8,15,61
28831,132,71,47,0,14,118
28832,8,3,4,1,0,8
28833,325,164,91,5,65,260
28834,25,17,0,0,8,17
28835,66,31,17,2,16,50
28836,17,8,3,2,4,13
28837,94,29,4,47,14,80
28838,131,59,26,23,23,108
28839,22,1,16,0,5,17
28840,221,74,83,15,49,172
28841,27,14,10,0,3,24
28842,55,23,18,5,9,46
28843,6,4,0,2,0,6
28844,104,70,11,0,23,81
28845,38,22,11,1,4,34
28846,19,13,2,0,4,15
28847,12,7,4,0,1,11
28848,36,8,16,1,11,25
28849,57,33,9,0,15,42
28850,134,104,11,0,19,115
28851,38,6,4,19,9,29
28852,105,47,22,10,26,79
28853,143,89,29,1,24,119
28854,10,0,9,0,1,9
28855,23,6,12,0,5,18
28856,44,11,25,1,7,37
28857,24,16,5,0,3,21
28858,34,21,7,1,5,29
28859,168,121,5,2,40,128
28860,80,51,14,1,14,66
28861,11,0,7,2,2,9
28862,157,97,34,1,25,132
28863,55,10,39,0,6,49
28864,201,103,71,7,20,181
28865,3,2,1,0,0,3
28866,71,37,20,0,14,57
28867,69,36,3,17,13,56
28868,29,10,12,1,6,23
28869,201,111,39,14,37,164
28870,42,26,9,0,7,35
28871,84,39,25,4,16,68
28872,14,0,12,0,2,12
28873,57,12,28,11,6,51
28874,42,21,13,0,8,34
28875,33,12,13,0,8,25
28876,57,20,23,0,14,43
28877,46,18,20,0,8,38
28878,104,32,50,0,22,82
28879,95,49,29,3,14,81
28880,46,18,20,0,8,38
28881,54,13,29,1,11,43
28882,68,25,6,23,14,54
28883,381,220,84,14,63,318
28884,88,34,29,8,17,71
28885,434,107,181,47,99,335
28886,19,3,13,0,3,16
28887,38,0,32,0,6,32
28888,40,18,15,0,7,33
28889,64,18,33,1,12,52
28890,379,197,96,20,66,313
28891,173,97,23,18,35,138
28892,42,13,23,0,6,36
28893,50,19,19,0,12,38
28894,53,25,21,0,7,46
28895,18,9,3,1,5,13
28896,30,21,3,0,6,24
28897,61,28,22,0,11,50
28898,1,0,0,0,1,0
28899,22,9,7,2,4,18
28900,70,17,36,0,17,53
28901,158,116,9,5,28,130
28902,34,16,13,2,3,31
28903,68,23,17,17,11,57
28904,36,20,8,0,8,28
28905,39,23,8,0,8,31
28906,179,101,32,0,46,133
28907,82,55,7,1,19,63
28908,140,40,68,1,31,109
28909,286,77,34,126,49,237
28910,18,5,8,0,5,13
28911,100,25,55,4,16,84
28912,98,34,40,6,18,80
28913,61,17,20,5,19,42
28914,25,14,6,0,5,20
28915,64,23,30,0,11,53
28916,64,37,16,0,11,53
28917,76,47,8,1,20,56
28918,27,16,7,0,4,23
28919,52,12,26,1,13,39
28920,48,19,23,0,6,42
28921,26,19,3,1,3,23
28922,505,259,89,51,106,399
28923,218,147,30,0,41,177
28924,153,9,86,27,31,122
28925,51,20,17,2,12,39
28926,65,37,11,7,10,55
28927,36,21,7,0,8,28
28928,94,35,35,0,24,70
28929,20,9,6,3,2,18
28930,108,40,32,14,22,86
28931,61,31,14,4,12,49
28932,55,5,35,1,14,41
28933,30,19,6,0,5,25
28934,7,2,3,0,2,5
28935,69,23,29,2,15,54
28936,56,22,14,4,16,40
28937,60,30,8,7,15,45
28938,25,17,0,0,8,17
28939,88,50,17,0,21,67
28940,220,150,29,0,41,179
28941,27,12,9,0,6,21
28942,17,3,8,0,6,11
28943,63,12,41,0,10,53
28944,79,18,36,3,22,57
28945,44,35,2,0,7,37
28946,102,64,10,5,23,79
28947,13,0,5,5,3,10
28948,73,71,0,2,0,73
28949,24,7,13,0,4,20
28950,350,188,92,15,55,295
28951,100,58,32,2,8,92
28952,109,84,8,0,17,92
28953,211,139,23,0,49,162
28954,57,30,5,5,17,40
28955,32,21,9,0,2,30
28956,26,5,11,3,7,19
28957,41,9,15,10,7,34
28958,24,5,14,0,5,19
28959,5,0,1,1,3,2
28960,465,181,136,47,101,364
28961,68,38,18,1,11,57
28962,222,167,9,0,46,176
28963,60,28,20,0,12,48
28964,45,11,25,0,9,36
28965,134,99,6,0,29,105
28966,131,43,35,28,25,106
28967,36,16,5,4,11,25
28968,105,47,25,5,28,77
28969,58,26,17,3,12,46
28970,11,8,0,1,2,9
28971,161,67,33,21,40,121
28972,453,159,152,45,97,356
28973,15,2,6,1,6,9
28974,101,45,13,21,22,79
28975,72,25,29,7,11,61
28976,48,24,17,0,7,41
28977,27,15,8,0,4,23
28978,108,36,43,1,28,80
28979,109,59,20,3,27,82
28980,63,30,7,5,21,42
28981,171,68,37,26,40,131
28982,288,69,70,89,60,228
28983,19,11,5,0,3,16
28984,182,123,12,9,38,144
28985,30,4,22,2,2,28
28986,16,9,5,0,2,14
28987,35,23,8,1,3,32
28988,246,144,51,7,44,202
28989,237,134,45,8,50,187
28990,46,33,4,1,8,38
28991,13,4,6,3,0,13
28992,27,7,15,0,5,22
28993,30,15,7,0,8,22
28994,6,1,5,0,0,6
28995,100,50,24,0,26,74
28996,109,42,33,14,20,89
28997,447,225,113,13,96,351
28998,17,3,12,0,2,15
28999,134,58,39,12,25,109
29000,48,4,31,1,12,36
29001,17,6,9,1,1,16
29002,41,11,24,4,2,39
29003,21,4,11,0,6,15
29004,199,78,37,33,51,148
29005,17,2,12,0,3,14
29006,660,366,164,23,107,553
29007,86,57,14,0,15,71
29008,29,6,20,0,3,26
29009,472,265,118,0,89,383
29010,37,7,22,0,8,29
29011,46,27,11,0,8,38
29012,39,1,29,1,8,31
29013,257,22,186,2,47,210
29014,46,18,20,0,8,38
29015,31,13,10,0,8,23
29016,22,0,19,0,3,19
29017,34,27,1,0,6,28
29018,59,29,14,3,13,46
29019,48,13,28,1,6,42
29020,66,33,20,0,13,53
29021,115,58,33,4,20,95
29022,76,4,53,1,18,58
29023,211,49,31,93,38,173
29024,316,180,63,6,67,249
29025,79,47,18,0,14,65
29026,103,32,46,5,20,83
29027,4,4,0,0,0,4
29028,2,1,1,0,0,2
29029,199,52,25,92,30,169
29030,20,11,3,1,5,15
29031,19,9,3,0,7,12
29032,118,84,6,3,25,93
29033,64,29,15,5,15,49
29034,23,9,1,7,6,17
29035,100,41,34,8,17,83
29036,36,21,7,0,8,28
29037,127,52,41,13,21,106
29038,66,38,18,0,10,56
29039,123,35,48,19,21,102
29040,78,13,41,7,17,61
29041,54,38,2,0,14,40
29042,418,191,134,8,85,333
29043,103,37,35,6,25,78
29044,46,18,20,0,8,38
29045,58,30,15,1,12,46
29046,53,15,19,3,16,37
29047,113,43,41,10,19,94
29048,149,86,27,1,35,114
29049,21,9,7,2,3,18
29050,46,18,20,0,8,38
29051,31,9,19,0,3,28
29052,88,46,12,2,28,60
29053,52,35,4,0,13,39
29054,26,10,10,0,6,20
29055,168,108,11,10,39,129
29056,38,18,15,0,5,33
29057,210,50,31,92,37,173
29058,498,248,94,52,104,394
29059,111,84,2,0,25,86
29060,33,8,17,4,4,29
29061,30,19,3,0,8,22
29062,313,189,48,11,65,248
29063,94,30,21,24,19,75
29064,34,11,14,0,9,25
29065,35,12,17,2,4,31
29066,52,31,2,3,16,36
29067,56,32,9,3,12,44
29068,91,60,2,10,19,72
29069,84,58,5,0,21,63
29070,94,46,32,3,13,81
29071,49,18,25,0,6,43
29072,62,29,22,0,11,51
29073,50,26,12,1,11,39
29074,18,12,2,1,3,15
29075,25,10,10,1,4,21
29076,39,12,15,6,6,33
29077,40,34,1,0,5,35
29078,28,12,2,11,3,25
29079,60,27,22,0,11,49
29080,85,39,26,0,20,65
29081,143,99,32,3,9,134
29082,23,8,7,1,7,16
29083,80,50,16,0,14,66
29084,6,6,0,0,0,6
29085,32,7,15,1,9,23
29086,23,3,13,2,5,18
29087,91,51,24,2,14,77
29088,17,9,2,1,5,12
29089,233,155,32,0,46,187
29090,66,49,12,0,5,61
29091,312,156,88,4,64,248
29092,176,103,27,9,37,139
29093,25,16,3,0,6,19
29094,33,11,11,0,11,22
29095,35,4,26,0,5,30
29096,51,33,9,0,9,42
29097,35,22,8,1,4,31
29098,412,191,136,11,74,338
29099,179,75,26,30,48,131
29100,190,99,58,4,29,161
29101,47,34,4,0,9,38
29102,126,80,28,3,15,111
29103,357,150,114,25,68,289
29104,34,3,20,0,11,23
29105,36,9,19,0,8,28
29106,97,54,19,0,24,73
29107,662,386,138,21,117,545
29108,75,43,13,2,17,58
29109,42,14,15,4,9,33
29110,84,38,32,0,14,70
29111,24,3,19,0,2,22
29112,68,23,27,4,14,54
29113,32,9,18,0,5,27
29114,183,138,4,2,39,144
29115,16,6,5,0,5,11
29116,5,0,1,2,2,3
29117,50,34,2,1,13,37
29118,16,9,3,0,4,12
29119,160,65,32,31,32,128
29120,33,14,15,2,2,31
29121,65,48,12,0,5,60
29122,134,62,45,5,22,112
29123,15,7,4,0,4,11
29124,60,18,32,1,9,51
29125,100,66,1,12,21,79
29126,88,45,24,2,17,71
29127,109,21,64,1,23,86
29128,354,186,93,15,60,294
29129,71,20,36,4,11,60
29130,161,92,48,11,10,151
29131,20,1,13,0,6,14
29132,33,2,26,0,5,28
29133,201,104,33,28,36,165
29134,20,11,2,0,7,13
29135,25,14,8,0,3,22
29136,23,10,10,0,3,20
29137,77,53,9,0,15,62
29138,58,27,15,3,13,45
29139,87,67,0,4,16,71
29140,125,89,6,4,26,99
29141,79,51,7,4,17,62
29142,124,54,19,18,33,91
29143,53,44,1,0,8,45
29144,197,10,150,0,37,160
29145,38,18,15,0,5,33
29146,9,3,1,0,5,4
29147,92,23,39,15,15,77
29148,88,44,25,2,17,71
29149,63,27,20,5,11,52
29150,263,194,16,0,53,210
29151,13,2,7,0,4,9
29152,8,6,0,1,1,7
29153,75,20,26,12,17,58
29154,22,11,8,1,2,20
29155,138,62,52,6,18,120
29156,76,20,22,14,20,56
29157,32,21,9,0,2,30
29158,187,124,21,0,42,145
29159,26,19,2,0,5,21
29160,10,6,2,0,2,8
29161,401,121,168,27,85,316
29162,44,30,1,1,12,32
29163,76,39,13,9,15,61
29164,29,3,15,3,8,21
29165,138,53,36,20,29,109
29166,160,111,23,0,26,134
29167,105,47,25,5,28,77
29168,110,43,39,10,18,92
29169,472,130,199,39,104,368
29170,209,154,12,1,42,167
29171,26,5,14,2,5,21
29172,184,56,58,27,43,141
29173,46,18,20,0,8,38
29174,28,17,2,0,9,19
29175,37,28,6,3,0,37
29176,97,42,35,1,19,78
29177,33,17,14,0,2,31
29178,39,13,20,1,5,34
29179,42,22,8,2,10,32
29180,99,45,35,4,15,84
29181,110,104,0,6,0,110
29182,25,11,11,0,3,22
29183,83,44,23,0,16,67
29184,564,396,47,0,121,443
29185,48,30,6,0,12,36
29186,444,258,83,9,94,350
29187,8,6,1,0,1,7
29188,19,4,9,1,5,14
29189,116,28,35,21,32,84
29190,58,34,15,1,8,50
29191,108,81,9,2,16,92
29192,85,24,37,2,22,63
29193,106,42,48,2,14,92
29194,105,38,40,11,16,89
29195,33,12,12,2,7,26
29196,115,27,65,1,22,93
29197,72,50,11,0,11,61
29198,561,358,86,4,113,448
29199,86,42,18,7,19,67
29200,88,44,25,2,17,71
29201,40,17,15,0,8,32
29202,89,23,46,4,16,73
29203,37,14,13,3,7,30
29204,46,18,20,0,8,38
29205,102,35,38,5,24,78
29206,117,63,12,20,22,95
29207,202,89,55,20,38,164
29208,420,103,180,44,93,327
29209,32,21,9,0,2,30
29210,20,10,4,1,5,15
29211,6,3,1,0,2,4
29212,68,40,3,12,13,55
29213,43,20,15,0,8,35
29214,33,1,25,1,6,27
29215,32,24,3,1,4,28
29216,7,0,4,1,2,5
29217,156,119,15,1,21,135
29218,25,7,8,0,10,15
29219,120,57,30,9,24,96
29220,13,2,10,0,1,12
29221,140,114,7,2,17,123
29222,18,7,8,0,3,15
29223,420,194,127,14,85,335
29224,59,43,4,0,12,47
29225,44,18,9,8,9,35
29226,158,66,55,16,21,137
29227,27,8,2,5,12,15
29228,115,79,15,0,21,94
29229,102,67,1,12,22,80
29230,18,1,13,1,3,15
29231,114,50,15,29,20,94
29232,145,36,77,1,31,114
29233,56,3,40,1,12,44
29234,445,135,194,15,101,344
29235,83,24,22,19,18,65
29236,59,35,9,3,12,47
29237,19,10,5,0,4,15
29238,225,74,85,15,51,174
29239,27,5,9,8,5,22
29240,253,141,34,30,48,205
29241,6,3,1,1,1,5
29242,40,20,12,1,7,33
29243,38,23,4,6,5,33
29244,102,45,9,23,25,77
29245,24,16,5,1,2,22
29246,27,0,23,0,4,23
29247,32,21,9,0,2,30
29248,153,88,36,1,28,125
29249,422,202,115,21,84,338
29250,342,147,119,6,70,272
29251,38,0,31,0,7,31
29252,32,21,9,0,2,30
29253,224,20,163,2,39,185
29254,112,79,15,9,9,103
29255,78,60,6,1,11,67
29256,42,30,1,0,11,31
29257,193,88,47,20,38,155
29258,43,2,35,0,6,37
29259,80,38,30,1,11,69
29260,191,146,14,1,30,161
29261,134,82,29,2,21,113
29262,180,72,55,7,46,134
29263,1,1,0,0,0,1
29264,20,0,16,1,3,17
29265,28,5,6,9,8,20
29266,44,17,17,1,9,35
29267,625,411,72,5,137,488
29268,96,27,54,2,13,83
29269,76,30,31,1,14,62
29270,70,36,20,0,14,56
29271,121,37,46,5,33,88
29272,44,22,16,1,5,39
29273,20,6,11,1,2,18
29274,57,33,2,3,19,38
29275,64,44,13,1,6,58
29276,12,6,2,0,4,8
29277,26,3,17,0,6,20
29278,219,155,48,3,13,206
29279,418,189,113,31,85,333
29280,30,11,9,3,7,23
29281,57,17,24,2,14,43
29282,60,22,13,16,9,51
29283,77,29,23,8,17,60
29284,156,103,39,4,10,146
29285,211,50,108,3,50,161
29286,98,42,18,11,27,71
29287,7,3,2,0,2,5
29288,17,4,9,3,1,16
29289,37,13,6,8,10,27
29290,32,12,8,4,8,24
29291,101,67,1,12,21,80
29292,295,141,74,20,60,235
29293,6,2,2,1,1,5
29294,54,21,5,15,13,41
29295,29,4,23,0,2,27
29296,104,31,38,9,26,78
29297,154,59,38,22,35,119
29298,35,12,13,3,7,28
29299,28,10,14,0,4,24
29300,35,3,24,4,4,31
29301,55,24,13,6,12,43
29302,8,4,3,0,1,7
29303,63,16,22,19,6,57
29304,613,420,59,2,132,481
29305,11,4,3,0,4,7
29306,248,187,9,1,51,197
29307,65,27,24,0,14,51
29308,25,11,11,0,3,22
29309,289,68,69,92,60,229
29310,37,13,18,0,6,31
29311,33,5,22,0,6,27
29312,20,12,5,0,3,17
29313,63,24,23,6,10,53
29314,45,35,3,1,6,39
29315,25,5,8,6,6,19
29316,50,20,21,0,9,41
29317,57,29,17,2,9,48
29318,36,8,22,0,6,30
29319,32,21,9,0,2,30
29320,179,101,33,0,45,134
29321,33,20,6,0,7,26
29322,1,0,0,0,1,0
29323,43,19,13,0,11,32
29324,25,10,11,0,4,21
29325,62,37,12,0,13,49
29326,94,27,42,6,19,75
29327,78,45,10,6,17,61
29328,22,13,7,0,2,20
29329,41,9,3,21,8,33
29330,24,11,10,0,3,21
29331,26,9,9,3,5,21
29332,465,230,90,50,95,370
29333,50,9,29,2,10,40
29334,636,367,149,16,104,532
29335,56,38,3,6,9,47
29336,81,26,27,9,19,62
29337,35,1,26,0,8,27
29338,54,10,35,0,9,45
29339,125,73,20,3,29,96
29340,55,33,14,2,6,49
29341,67,4,51,2,10,57
29342,9,6,1,0,2,7
29343,50,29,11,0,10,40
29344,141,58,54,1,28,113
29345,72,45,16,7,4,68
29346,32,21,9,0,2,30
29347,49,14,24,0,11,38
29348,24,7,7,0,10,14
29349,42,14,22,0,6,36
29350,62,18,31,3,10,52
29351,136,100,5,2,29,107
29352,595,427,43,1,124,471
29353,61,5,40,0,16,45
29354,3,2,0,0,1,2
29355,80,20,33,6,21,59
29356,272,139,93,0,40,232
29357,170,112,27,1,30,140
29358,41,23,10,0,8,33
29359,65,21,32,2,10,55
29360,171,83,54,3,31,140
29361,44,30,9,0,5,39
29362,52,16,25,0,11,41
29363,14,1,9,0,4,10
29364,9,6,1,0,2,7
29365,19,11,4,1,3,16
29366,136,45,65,0,26,110
29367,25,12,6,1,6,19
29368,39,9,16,4,10,29
29369,59,25,25,1,8,51
29370,29,1,23,2,3,26
29371,55,33,14,2,6,49
29372,29,7,15,3,4,25
29373,160,114,11,0,35,125
29374,374,165,124,12,73,301
29375,22,8,11,0,3,19
29376,78,39,19,2,18,60
29377,10,1,6,0,3,7
29378,625,362,144,17,102,523
29379,75,40,13,5,17,58
29380,110,37,43,11,19,91
29381,38,15,21,1,1,37
29382,38,12,15,6,5,33
29383,110,34,54,0,22,88
29384,351,254,17,2,78,273
29385,46,9,22,5,10,36
29386,21,0,13,1,7,14
29387,23,4,18,1,0,23
29388,14,6,6,1,1,13
29389,69,49,2,1,17,52
29390,238,115,64,13,46,192
29391,64,13,30,7,14,50
29392,23,15,4,2,2,21
29393,3,1,1,0,1,2
29394,19,6,9,0,4,15
29395,32,21,9,0,2,30
29396,93,41,27,1,24,69
29397,40,28,2,0,10,30
29398,246,130,44,23,49,197
29399,38,10,15,6,7,31
29400,412,196,138,7,71,341
29401,168,126,3,1,38,130
29402,77,44,15,0,18,59
29403,21,13,4,1,3,18
29404,45,21,19,0,5,40
29405,50,22,21,0,7,43
29406,50,21,8,11,10,40
29407,15,2,2,9,2,13
29408,27,9,12,2,4,23
29409,288,157,78,0,53,235
29410,18,6,0,7,5,13
29411,34,19,5,2,8,26
29412,133,28,47,30,28,105
29413,32,21,9,0,2,30
29414,77,44,20,0,13,64
29415,58,28,17,1,12,46
29416,106,48,35,4,19,87
29417,81,42,5,17,17,64
29418,57,25,17,5,10,47
29419,72,32,24,0,16,56
29420,18,5,9,0,4,14
29421,52,23,20,3,6,46
29422,24,6,15,0,3,21
29423,44,21,17,1,5,39
29424,96,92,0,4,0,96
29425,554,399,41,1,113,441
29426,78,50,14,0,14,64
29427,20,2,11,1,6,14
29428,72,21,35,4,12,60
29429,8,3,2,0,3,5
29430,95,58,16,6,15,80
29431,98,72,6,0,20,78
29432,177,47,53,41,36,141
29433,237,179,13,0,45,192
29434,70,55,1,0,14,56
29435,96,41,34,3,18,78
29436,44,12,20,2,10,34
29437,25,11,13,0,1,24
29438,13,9,3,0,1,12
29439,27,25,0,0,2,25
29440,5,5,0,0,0,5
29441,81,38,4,16,23,58
29442,19,5,9,1,4,15
29443,162,83,40,0,39,123
29444,95,71,6,0,18,77
29445,326,170,86,15,55,271
29446,22,10,10,1,1,21
29447,42,18,11,0,13,29
29448,439,201,141,9,88,351
29449,76,53,8,0,15,61
29450,29,17,5,0,7,22
29451,23,7,13,0,3,20
29452,49,6,37,1,5,44
29453,98,74,5,0,19,79
29454,66,15,35,6,10,56
29455,60,7,41,0,12,48
29456,644,370,151,17,106,538
29457,286,160,35,33,58,228
29458,45,10,24,0,11,34
29459,57,27,14,3,13,44
29460,68,37,16,2,13,55
29461,40,26,9,0,5,35
29462,299,134,92,14,59,240
29463,82,39,29,0,14,68
29464,45,28,5,6,6,39
29465,28,13,6,0,9,19
29466,15,3,10,0,2,13
29467,57,36,7,0,14,43
29468,75,27,24,6,18,57
29469,184,58,76,13,37,147
29470,43,13,20,2,8,35
29471,487,340,41,1,105,382
29472,84,32,16,15,21,63
29473,40,5,29,2,4,36
29474,20,14,3,0,3,17
29475,54,26,19,0,9,45
29476,44,5,16,11,12,32
29477,28,11,10,2,5,23
29478,101,33,40,10,18,83
29479,64,42,13,0,9,55
29480,114,45,44,2,23,91
29481,98,26,56,1,15,83
29482,343,143,127,6,67,276
29483,193,125,52,2,14,179
29484,108,52,17,22,17,91
29485,117,38,64,0,15,102
29486,20,4,7,4,5,15
29487,87,77,2,0,8,79
29488,34,14,14,0,6,28
29489,44,19,17,1,7,37
29490,59,10,35,0,14,45
29491,48,19,17,1,11,37
29492,27,15,1,4,7,20
29493,32,21,9,0,2,30
29494,15,3,9,0,3,12
29495,89,47,6,16,20,69
29496,110,33,39,11,27,83
29497,39,16,17,2,4,35
29498,170,82,53,3,32,138
29499,32,21,9,0,2,30
29500,131,42,48,17,24,107
29501,21,18,2,0,1,20
29502,49,36,3,0,10,39
29503,12,9,2,0,1,11
29504,71,35,11,7,18,53
29505,59,23,24,0,12,47
29506,285,77,33,127,48,237
29507,26,9,16,0,1,25
29508,34,25,4,0,5,29
29509,73,50,10,0,13,60
29510,15,11,2,0,2,13
29511,70,51,4,0,15,55
29512,57,29,12,2,14,43
29513,57,33,12,3,9,48
29514,69,48,7,4,10,59
29515,24,13,5,1,5,19
29516,30,11,13,0,6,24
29517,12,9,2,0,1,11
29518,65,17,38,0,10,55
29519,41,13,13,6,9,32
29520,192,87,47,20,38,154
29521,74,33,12,13,16,58
29522,50,36,3,5,6,44
29523,13,5,3,0,5,8
29524,32,21,9,0,2,30
29525,84,52,5,12,15,69
29526,41,31,1,0,9,32
29527,40,36,0,0,4,36
29528,28,10,13,0,5,23
29529,199,110,27,23,39,160
29530,245,185,18,2,40,205
29531,216,61,113,5,37,179
29532,660,379,155,20,106,554
29533,10,0,9,0,1,9
29534,40,6,15,8,11,29
29535,99,73,4,2,20,79
29536,55,19,24,0,12,43
29537,13,6,7,0,0,13
29538,58,5,49,0,4,54
29539,76,44,19,0,13,63
29540,4,2,1,0,1,3
29541,106,23,47,14,22,84
29542,32,21,9,0,2,30
29543,68,51,6,0,11,57
29544,24,14,5,0,5,19
29545,85,55,15,0,15,70
29546,19,6,8,3,2,17
29547,433,108,183,46,96,337
29548,6,2,1,0,3,3
29549,62,41,9,0,12,50
29550,103,38,29,12,24,79
29551,13,13,0,0,0,13
29552,412,191,120,12,89,323
29553,85,7,62,1,15,70
29554,69,32,28,0,9,60
29555,453,139,191,28,95,358
29556,186,43,101,11,31,155
29557,124,45,41,16,22,102
29558,12,0,11,0,1,11
29559,1,0,1,0,0,1
29560,208,162,16,1,29,179
29561,132,28,70,1,33,99
29562,88,44,25,2,17,71
29563,516,247,107,56,106,410
29564,104,38,25,19,22,82
29565,55,24,14,2,15,40
29566,21,10,4,0,7,14
29567,5,3,2,0,0,5
29568,78,28,26,9,15,63
29569,30,14,13,0,3,27
29570,27,17,5,2,3,24
29571,125,68,40,9,8,117
29572,55,17,22,7,9,46
29573,12,6,3,3,0,12
29574,31,18,4,0,9,22
29575,78,20,32,8,18,60
29576,189,84,62,10,33,156
29577,240,167,26,5,42,198
29578,50,30,10,0,10,40
29579,1284,520,169,337,258,1026
29580,25,12,10,0,3,22
29581,25,5,1,15,4,21
29582,26,7,12,0,7,19
29583,100,70,5,0,25,75
29584,80,28,33,1,18,62
29585,137,55,42,9,31,106
29586,121,35,52,8,26,95
29587,94,47,14,2,31,63
29588,27,5,12,5,5,22
29589,2,1,0,1,0,2
29590,77,29,25,8,15,62
29591,366,265,29,0,72,294
29592,25,10,10,1,4,21
29593,23,10,6,0,7,16
29594,15,8,1,6,0,15
29595,52,0,41,2,9,43
29596,140,47,60,6,27,113
29597,31,10,11,3,7,24
29598,134,69,40,0,25,109
29599,366,264,18,2,82,284
29600,54,13,22,11,8,46
29601,26,14,7,0,5,21
29602,75,38,16,2,19,56
29603,114,46,39,3,26,88
29604,144,103,6,4,31,113
29605,180,67,55,26,32,148
29606,154,79,49,2,24,130
29607,32,21,9,0,2,30
29608,116,48,46,2,20,96
29609,35,13,9,4,9,26
29610,106,38,38,6,24,82
29611,12,5,4,2,1,11
29612,114,64,17,11,22,92
29613,90,45,27,2,16,74
29614,9,2,4,0,3,6
29615,6,2,1,0,3,3
29616,249,171,55,4,19,230
29617,5,5,0,0,0,5
29618,36,15,9,3,9,27
29619,81,38,27,4,12,69
29620,72,5,50,1,16,56
29621,127,75,21,3,28,99
29622,78,47,10,3,18,60
29623,20,2,13,0,5,15
29624,51,11,24,1,15,36
29625,133,11,74,18,30,103
29626,33,17,7,0,9,24
29627,31,11,13,0,7,24
29628,290,76,151,2,61,229
29629,152,105,21,0,26,126
29630,123,68,34,1,20,103
29631,26,8,13,1,4,22
29632,11,4,4,0,3,8
29633,24,9,9,0,6,18
29634,10,2,8,0,0,10
29635,31,15,10,2,4,27
29636,188,53,18,86,31,157
29637,35,23,5,1,6,29
29638,86,41,25,2,18,68
29639,20,2,16,0,2,18
29640,30,13,8,1,8,22
29641,37,21,3,0,13,24
29642,200,48,103,14,35,165
29643,56,37,12,0,7,49
29644,220,129,18,26,47,173
29645,32,17,8,0,7,25
29646,85,35,5,32,13,72
29647,13,8,4,0,1,12
29648,65,28,15,5,17,48
29649,54,35,11,2,6,48
29650,35,8,19,0,8,27
29651,71,37,13,8,13,58
29652,87,39,31,1,16,71
29653,157,68,37,15,37,120
29654,175,47,57,36,35,140
29655,286,147,92,0,47,239
29656,480,226,98,49,107,373
29657,40,30,1,2,7,33
29658,35,15,14,0,6,29
29659,66,38,19,3,6,60
29660,46,21,12,6,7,39
29661,137,100,8,0,29,108
29662,83,25,31,11,16,67
29663,456,210,142,13,91,365
29664,72,49,13,0,10,62
29665,136,52,46,14,24,112
29666,17,7,8,0,2,15
29667,29,16,4,2,7,22
29668,365,192,91,20,62,303
29669,19,2,12,0,5,14
29670,24,12,8,2,2,22
29671,32,14,15,0,3,29
29672,45,17,13,4,11,34
29673,56,21,17,3,15,41
29674,14,10,0,2,2,12
29675,8,7,1,0,0,8
29676,208,88,45,24,51,157
29677,561,407,42,1,111,450
29678,5,3,1,0,1,4
29679,235,72,106,8,49,186
29680,357,118,149,11,79,278
29681,45,8,29,0,8,37
29682,12,0,11,0,1,11
29683,22,9,11,0,2,20
29684,16,3,6,3,4,12
29685,30,18,2,0,10,20
29686,11,7,2,0,2,9
29687,2,1,1,0,0,2
29688,176,104,18,20,34,142
29689,77,48,12,2,15,62
29690,44,12,24,1,7,37
29691,178,90,50,0,38,140
29692,35,9,15,4,7,28
29693,44,7,27,3,7,37
29694,80,51,15,0,14,66
29695,95,35,19,11,30,65
29696,225,70,106,12,37,188
29697,192,94,70,8,20,172
29698,4,0,4,0,0,4
29699,371,168,120,9,74,297
29700,164,67,55,9,33,131
29701,27,7,5,5,10,17
29702,583,425,40,1,117,466
29703,34,15,10,0,9,25
29704,33,6,19,0,8,25
29705,72,28,18,16,10,62
29706,84,28,27,9,20,64
29707,61,21,32,0,8,53
29708,7,1,4,0,2,5
29709,64,38,15,0,11,53
29710,20,10,5,2,3,17
29711,35,31,0,0,4,31
29712,102,93,0,9,0,102
29713,47,18,19,0,10,37
29714,42,19,7,2,14,28
29715,20,14,0,0,6,14
29716,66,41,7,2,16,50
29717,5,2,0,0,3,2
29718,33,15,7,1,10,23
29719,22,4,11,3,4,18
29720,62,11,35,1,15,47
29721,59,19,15,13,12,47
29722,54,33,14,0,7,47
29723,58,37,11,0,10,48
29724,16,5,8,0,3,13
29725,128,65,12,23,28,100
29726,85,32,33,6,14,71
29727,127,64,30,9,24,103
29728,17,6,8,0,3,14
29729,18,10,6,0,2,16
29730,32,15,7,0,10,22
29731,107,48,29,18,12,95
29732,42,9,26,0,7,35
29733,38,16,16,1,5,33
29734,22,15,2,0,5,17
29735,77,41,21,0,15,62
29736,26,1,16,0,9,17
29737,66,23,24,3,16,50
29738,55,32,7,0,16,39
29739,31,5,16,2,8,23
29740,144,61,54,7,22,122
29741,5,0,4,0,1,4
29742,51,19,21,1,10,41
29743,5,2,0,2,1,4
29744,60,39,10,0,11,49
29745,21,8,11,0,2,19
29746,148,46,73,3,26,122
29747,60,31,7,8,14,46
29748,416,234,88,14,80,336
29749,49,18,25,0,6,43
29750,27,3,22,0,2,25
29751,223,149,33,0,41,182
29752,103,46,13,21,23,80
29753,21,8,10,0,3,18
29754,12,0,11,0,1,11
29755,68,36,21,0,11,57
29756,71,27,27,1,16,55
29757,153,102,3,15,33,120
29758,32,5,23,1,3,29
29759,71,36,15,2,18,53
29760,29,14,10,0,5,24
29761,96,73,3,0,20,76
29762,43,12,16,8,7,36
29763,121,79,23,0,19,102
29764,177,99,32,0,46,131
29765,145,59,44,9,33,112
29766,68,18,27,0,23,45
29767,10,4,3,0,3,7
29768,19,8,7,1,3,16
29769,37,21,12,0,4,33
29770,90,46,32,2,10,80
29771,166,98,38,1,29,137
29772,55,37,10,0,8,47
29773,123,82,19,0,22,101
29774,62,36,12,2,12,50
29775,23,1,17,0,5,18
29776,30,10,14,2,4,26
29777,27,9,15,0,3,24
29778,129,44,48,12,25,104
29779,49,6,32,5,6,43
29780,127,42,47,13,25,102
29781,277,107,99,20,51,226
29782,125,60,29,14,22,103
29783,28,16,7,0,5,23
29784,431,124,195,14,98,333
29785,150,60,31,29,30,120
29786,46,20,9,8,9,37
29787,71,56,1,0,14,57
29788,72,52,5,0,15,57
29789,52,28,13,0,11,41
29790,36,16,15,0,5,31
29791,226,65,112,4,45,181
29792,41,20,9,1,11,30
29793,48,24,17,0,7,41
29794,19,0,13,0,6,13
29795,147,100,22,0,25,122
29796,22,6,10,1,5,17
29797,76,31,30,1,14,62
29798,56,11,35,2,8,48
29799,12,6,2,1,3,9
29800,18,8,4,0,6,12
29801,270,206,15,0,49,221
29802,12,2,5,0,5,7
29803,73,25,28,1,19,54
29804,97,40,34,1,22,75
29805,25,14,5,1,5,20
29806,44,19,4,10,11,33
29807,56,22,23,0,11,45
29808,53,4,35,9,5,48
29809,104,100,0,4,0,104
29810,90,42,21,12,15,75
29811,122,68,12,14,28,94
29812,22,10,10,0,2,20
29813,45,23,12,4,6,39
29814,186,52,97,2,35,151
29815,19,5,7,0,7,12
29816,81,47,17,0,17,64
29817,34,16,11,0,7,27
29818,63,25,14,11,13,50
29819,19,5,8,2,4,15
29820,31,6,20,3,2,29
29821,44,11,23,6,4,40
29822,11,5,2,2,2,9
29823,116,47,36,8,25,91
29824,96,46,22,3,25,71
29825,90,43,24,10,13,77
29826,24,8,13,0,3,21
29827,219,47,33,100,39,180
29828,29,12,13,1,3,26
29829,33,7,19,1,6,27
29830,66,33,13,3,17,49
29831,161,68,55,16,22,139
29832,101,23,62,0,16,85
29833,150,64,54,7,25,125
29834,46,24,11,0,11,35
29835,444,238,110,21,75,369
29836,74,16,38,6,14,60
29837,545,386,46,1,112,433
29838,80,26,32,4,18,62
29839,56,37,4,0,15,41
29840,14,7,0,3,4,10
29841,243,102,15,81,45,198
29842,26,13,5,3,5,21
29843,179,76,26,30,47,132
29844,277,15,211,0,51,226
29845,286,76,151,3,56,230
29846,3,2,1,0,0,3
29847,252,18,187,2,45,207
29848,232,131,47,14,40,192
29849,52,18,5,19,10,42
29850,13,2,8,0,3,10
29851,83,49,19,2,13,70
29852,122,91,7,0,24,98
29853,10,3,5,1,1,9
29854,124,55,41,9,19,105
29855,90,66,5,0,19,71
29856,73,36,24,1,12,61
29857,54,41,2,2,9,45
29858,42,16,19,2,5,37
29859,11,3,7,1,0,11
29860,119,58,34,0,27,92
29861,134,71,36,0,27,107
29862,99,69,11,0,19,80
29863,155,88,38,1,28,127
29864,327,196,61,0,70,257
29865,11,4,4,0,3,8
29866,159,57,49,23,30,129
29867,47,18,19,0,10,37
29868,46,18,20,0,8,38
29869,11,0,9,0,2,9
29870,17,6,7,0,4,13
29871,23,3,8,9,3,20
29872,30,11,10,1,8,22
29873,36,14,6,6,10,26
29874,206,81,13,74,38,168
29875,29,18,4,0,7,22
29876,213,88,53,26,46,167
29877,41,13,16,1,11,30
29878,456,271,66,31,88,368
29879,32,13,15,0,4,28
29880,28,20,3,1,4,24
29881,6,2,3,0,1,5
29882,125,79,26,0,20,105
29883,542,308,130,17,87,455
29884,640,368,150,17,105,535
29885,17,4,7,1,5,12
29886,317,131,115,6,65,252
29887,193,45,21,96,31,162
29888,128,49,45,8,26,102
29889,39,7,23,2,7,32
29890,46,19,12,1,14,32
29891,121,51,38,3,29,92
29892,128,58,43,1,26,102
29893,284,193,68,3,20,264
29894,58,2,40,0,16,42
29895,78,75,0,3,0,78
29896,270,60,140,5,65,205
29897,62,26,18,6,12,50
29898,49,21,14,3,11,38
29899,19,11,6,1,1,18
29900,571,333,125,15,98,473
29901,5,3,1,0,1,4
29902,101,29,46,4,22,79
29903,462,217,103,43,99,363
29904,51,14,27,1,9,42
29905,55,28,15,0,12,43
29906,309,188,54,0,67,242
29907,5,4,0,0,1,4
29908,43,9,16,4,14,29
29909,70,37,21,0,12,58
29910,321,243,19,0,59,262
29911,42,33,4,0,5,37
29912,31,6,13,5,7,24
29913,46,18,20,0,8,38
29914,1,0,0,0,1,0
29915,150,37,77,1,35,115
29916,51,14,27,1,9,42
29917,70,35,23,1,11,59
29918,37,18,3,5,11,26
29919,16,0,14,0,2,14
29920,39,23,5,3,8,31
29921,342,145,120,6,71,271
29922,171,48,53,35,35,136
29923,28,7,15,2,4,24
29924,276,109,105,15,47,229
29925,32,21,9,0,2,30
29926,97,52,29,2,14,83
29927,184,130,19,2,33,151
29928,6,3,0,0,3,3
29929,77,64,0,1,12,65
29930,19,6,8,0,5,14
29931,79,36,5,16,22,57
29932,201,53,27,91,30,171
29933,37,16,15,0,6,31
29934,139,58,40,15,26,113
29935,105,49,32,6,18,87
29936,29,12,6,4,7,22
29937,67,30,19,6,12,55
29938,26,14,10,0,2,24
29939,269,60,69,87,53,216
29940,145,68,49,5,23,122
29941,354,211,70,0,73,281
29942,130,29,49,21,31,99
29943,56,2,29,18,7,49
29944,108,37,41,3,27,81
29945,95,48,14,2,31,64
29946,6,4,2,0,0,6
29947,74,32,21,3,18,56
29948,49,32,6,2,9,40
29949,69,40,7,10,12,57
29950,22,15,3,1,3,19
29951,106,56,23,0,27,79
29952,268,114,97,9,48,220
29953,83,23,39,1,20,63
29954,257,154,50,4,49,208
29955,96,50,13,17,16,80
29956,53,26,16,1,10,43
29957,35,14,14,0,7,28
29958,11,6,3,0,2,9
29959,25,8,8,3,6,19
29960,59,20,22,4,13,46
29961,80,41,7,13,19,61
29962,55,32,15,2,6,49
29963,191,113,61,4,13,178
29964,48,14,18,7,9,39
29965,28,11,7,0,10,18
29966,13,5,4,0,4,9
29967,27,17,4,3,3,24
29968,41,16,21,0,4,37
29969,63,38,14,0,11,52
29970,411,283,41,1,86,325
29971,35,16,10,3,6,29
29972,69,19,32,1,17,52
29973,30,17,7,0,6,24
29974,2,0,2,0,0,2
29975,28,21,6,1,0,28
29976,15,7,3,0,5,10
29977,37,17,9,3,8,29
29978,177,91,40,9,37,140
29979,12,5,2,2,3,9
29980,96,83,3,0,10,86
29981,127,74,22,3,28,99
29982,104,39,33,13,19,85
29983,132,62,37,5,28,104
29984,89,57,15,0,17,72
29985,152,80,33,7,32,120
29986,36,7,17,3,9,27
29987,24,16,0,3,5,19
29988,11,9,1,1,0,11
29989,25,0,19,3,3,22
29990,61,33,13,2,13,48
29991,370,281,20,0,69,301
29992,21,14,4,1,2,19
29993,27,6,12,2,7,20
29994,46,18,20,0,8,38
29995,153,65,33,18,37,116
29996,112,49,28,14,21,91
29997,180,87,36,25,32,148
29998,145,105,6,4,30,115
29999,68,34,24,0,10,58
30000,27,17,3,0,7,20
30001,22,1,16,0,5,17
30002,72,40,20,0,12,60
30003,222,74,82,15,51,171
30004,335,176,81,18,60,275
30005,27,12,9,1,5,22
30006,294,80,41,124,49,245
30007,444,302,45,1,96,348
30008,96,43,25,11,17,79
30009,21,3,12,0,6,15
30010,21,14,2,0,5,16
30011,87,57,9,3,18,69
30012,29,16,11,1,1,28
30013,45,12,20,8,5,40
30014,55,14,26,3,12,43
30015,381,219,84,0,78,303
30016,311,162,83,15,51,260
30017,23,7,11,0,5,18
30018,48,31,8,0,9,39
30019,35,15,10,0,10,25
30020,36,20,9,0,7,29
30021,76,47,18,0,11,65
30022,469,219,145,12,93,376
30023,125,54,20,18,33,92
30024,27,17,3,0,7,20
30025,140,66,46,4,24,116
30026,11,8,0,2,1,10
30027,90,34,18,9,29,61
30028,69,36,16,1,16,53
30029,117,50,29,16,22,95
30030,265,109,96,16,44,221
30031,29,4,17,2,6,23
30032,57,44,5,2,6,51
30033,13,6,3,1,3,10
30034,83,38,26,2,17,66
30035,63,21,15,7,20,43
30036,54,17,22,5,10,44
30037,32,21,9,0,2,30
30038,132,88,12,4,28,104
30039,76,5,42,8,21,55
30040,38,12,17,0,9,29
30041,14,9,3,0,2,12
30042,93,45,29,4,15,78
30043,53,25,16,0,12,41
30044,37,14,12,0,11,26
30045,8,8,0,0,0,8
30046,274,153,35,31,55,219
30047,37,12,17,0,8,29
30048,73,36,18,0,19,54
30049,60,2,41,12,5,55
30050,44,8,21,0,15,29
30051,32,21,9,0,2,30
30052,28,16,7,0,5,23
30053,167,85,21,28,33,134
30054,66,13,42,1,10,56
30055,100,58,22,0,20,80
30056,99,56,18,1,24,75
30057,110,45,37,6,22,88
30058,19,2,11,3,3,16
30059,47,17,18,2,10,37
30060,32,12,16,0,4,28
30061,13,8,2,0,3,10
30062,31,17,3,3,8,23
30063,55,21,27,0,7,48
30064,62,15,33,4,10,52
30065,121,60,40,10,11,110
30066,68,19,21,11,17,51
30067,7,4,0,1,2,5
30068,21,2,17,0,2,19
30069,57,20,22,3,12,45
30070,16,8,4,0,4,12
30071,1307,528,182,337,260,1047
30072,67,44,13,0,10,57
30073,8,3,1,1,3,5
30074,125,47,42,8,28,97
30075,92,34,30,8,20,72
30076,98,65,17,0,16,82
30077,125,41,45,7,32,93
30078,389,213,107,0,69,320
30079,27,1,19,1,6,21
30080,353,159,119,6,69,284
30081,56,38,7,1,10,46
30082,84,17,40,7,20,64
30083,86,50,23,0,13,73
30084,74,42,20,0,12,62
30085,127,74,22,3,28,99
30086,19,12,4,0,3,16
30087,64,30,21,0,13,51
30088,32,21,9,0,2,30
30089,235,94,14,83,44,191
30090,51,34,5,2,10,41
30091,213,143,14,13,43,170
30092,351,188,92,15,56,295
30093,180,84,56,4,36,144
30094,76,27,36,4,9,67
30095,456,212,147,11,86,370
30096,63,7,51,0,5,58
30097,172,31,71,27,43,129
30098,37,5,4,20,8,29
30099,99,67,11,2,19,80
30100,115,52,20,15,28,87
30101,53,32,14,0,7,46
30102,53,28,16,0,9,44
30103,76,47,15,0,14,62
30104,84,49,16,2,17,67
30105,8,5,0,1,2,6
30106,50,16,15,3,16,34
30107,64,29,21,0,14,50
30108,133,41,51,17,24,109
30109,73,30,20,1,22,51
30110,15,13,0,0,2,13
30111,71,32,22,0,17,54
30112,13,8,3,0,2,11
30113,28,17,5,0,6,22
30114,514,207,141,54,112,402
30115,44,6,29,0,9,35
30116,15,8,1,5,1,14
30117,45,22,7,5,11,34
30118,32,22,3,0,7,25
30119,92,24,48,0,20,72
30120,156,72,49,5,30,126
30121,126,74,21,3,28,98
30122,90,29,31,10,20,70
30123,38,21,14,0,3,35
30124,164,66,56,17,25,139
30125,129,42,47,6,34,95
30126,125,44,46,8,27,98
30127,30,12,5,5,8,22
30128,103,57,13,12,21,82
30129,26,8,10,0,8,18
30130,203,135,22,0,46,157
30131,55,20,20,5,10,45
30132,79,11,36,15,17,62
30133,36,13,16,3,4,32
30134,46,18,20,0,8,38
30135,65,17,31,1,16,49
30136,42,9,5,20,8,34
30137,26,13,8,0,5,21
30138,28,21,6,1,0,28
30139,101,46,27,16,12,89
30140,59,30,3,15,11,48
30141,86,35,36,0,15,71
30142,44,22,16,0,6,38
30143,33,8,15,1,9,24
30144,32,21,9,0,2,30
30145,11,4,4,0,3,8
30146,53,20,23,0,10,43
30147,207,128,34,6,39,168
30148,19,4,5,7,3,16
30149,72,27,24,6,15,57
30150,10,7,1,0,2,8
30151,397,263,41,0,93,304
30152,53,28,9,7,9,44
30153,138,72,29,1,36,102
30154,45,8,22,5,10,35
30155,45,21,12,4,8,37
30156,216,80,90,4,42,174
30157,355,153,127,6,69,286
30158,94,56,19,5,14,80
30159,70,15,39,2,14,56
30160,138,88,29,0,21,117
30161,119,34,62,0,23,96
30162,12,7,2,0,3,9
30163,11,7,0,2,2,9
30164,88,32,27,10,19,69
30165,142,58,44,14,26,116
30166,55,33,10,0,12,43
30167,172,80,53,3,36,136
30168,63,24,27,0,12,51
30169,40,30,1,2,7,33
30170,37,13,17,1,6,31
30171,7,7,0,0,0,7
30172,64,27,14,4,19,45
30173,18,14,3,0,1,17
30174,34,13,12,0,9,25
30175,77,53,8,0,16,61
30176,31,6,15,1,9,22
30177,279,97,125,14,43,236
30178,77,37,23,4,13,64
30179,56,6,46,0,4,52
30180,42,19,11,1,11,31
30181,265,126,79,5,55,210
30182,346,178,96,5,67,279
30183,269,60,155,1,53,216
30184,36,5,22,0,9,27
30185,117,47,35,8,27,90
30186,37,23,8,1,5,32
30187,39,18,13,0,8,31
30188,12,7,4,0,1,11
30189,151,79,46,5,21,130
30190,8,3,2,0,3,5
30191,37,15,15,0,7,30
30192,29,7,11,4,7,22
30193,32,8,19,0,5,27
30194,109,58,25,4,22,87
30195,164,126,7,0,31,133
30196,277,149,66,0,62,215
30197,9,5,3,0,1,8
30198,25,18,3,0,4,21
30199,44,15,19,4,6,38
30200,4,1,3,0,0,4
30201,227,97,86,1,43,184
30202,53,3,39,3,8,45
30203,71,45,11,4,11,60
30204,89,20,52,8,9,80
30205,19,6,5,1,7,12
30206,40,24,9,4,3,37
30207,20,11,8,0,1,19
30208,192,110,25,22,35,157
30209,24,1,14,0,9,15
30210,184,102,34,1,47,137
30211,23,6,11,1,5,18
30212,182,111,5,22,44,138
30213,52,21,23,0,8,44
30214,35,6,20,0,9,26
30215,22,1,16,0,5,17
30216,88,37,30,4,17,71
30217,100,32,40,11,17,83
30218,7,3,3,0,1,6
30219,577,413,46,1,117,460
30220,201,57,89,7,48,153
30221,88,44,30,4,10,78
30222,339,140,123,5,71,268
30223,204,103,61,4,36,168
30224,112,65,23,7,17,95
30225,60,46,6,0,8,52
30226,375,212,84,0,79,296
30227,266,122,92,3,49,217
30228,30,17,6,2,5,25
30229,262,124,87,4,47,215
30230,21,0,14,1,6,15
30231,154,69,51,2,32,122
30232,83,29,41,6,7,76
30233,437,210,113,19,95,342
30234,18,9,8,0,1,17
30235,127,52,40,12,23,104
30236,96,23,48,0,25,71
30237,8,4,1,2,1,7
30238,8,1,5,0,2,6
30239,51,33,4,5,9,42
30240,97,21,53,3,20,77
30241,66,44,5,2,15,51
30242,16,3,7,0,6,10
30243,44,25,10,3,6,38
30244,133,90,17,0,26,107
30245,376,135,119,41,81,295
30246,127,76,26,0,25,102
30247,98,63,24,0,11,87
30248,135,54,40,15,26,109
30249,44,23,10,1,10,34
30250,46,18,20,0,8,38
30251,90,31,5,41,13,77
30252,77,5,55,1,16,61
30253,70,34,23,0,13,57
30254,29,7,18,0,4,25
30255,43,15,18,0,10,33
30256,35,19,8,6,2,33
30257,47,11,22,3,11,36
30258,128,42,46,8,32,96
30259,131,39,48,18,26,105
30260,8,0,3,0,5,3
30261,22,7,5,9,1,21
30262,250,188,13,0,49,201
30263,419,156,131,41,91,328
30264,24,10,3,7,4,20
30265,8,2,4,0,2,6
30266,76,31,7,17,21,55
30267,61,33,21,0,7,54
30268,48,26,9,4,9,39
30269,83,42,26,0,15,68
30270,180,105,19,22,34,146
30271,27,14,5,0,8,19
30272,47,0,37,0,10,37
30273,33,1,7,18,7,26
30274,11,5,3,0,3,8
30275,58,13,39,0,6,52
30276,102,43,24,12,23,79
30277,28,10,9,3,6,22
30278,116,32,33,27,24,92
30279,89,40,15,9,25,64
30280,3,0,1,0,2,1
30281,30,13,12,0,5,25
30282,61,17,28,2,14,47
30283,181,138,7,0,36,145
30284,465,234,116,18,97,368
30285,61,25,26,1,9,52
30286,43,10,20,0,13,30
30287,92,23,38,12,19,73
30288,49,21,20,1,7,42
30289,18,8,7,0,3,15
30290,16,8,5,0,3,13
30291,443,134,184,32,93,350
30292,132,93,20,0,19,113
30293,64,22,30,2,10,54
30294,21,1,3,13,4,17
30295,50,25,4,11,10,40
30296,61,17,25,4,15,46
30297,31,15,14,0,2,29
30298,48,21,17,0,10,38
30299,96,42,34,2,18,78
30300,395,205,113,4,73,322
30301,31,19,3,0,9,22
30302,103,32,39,11,21,82
30303,281,145,77,12,47,234
30304,39,12,18,0,9,30
30305,160,118,3,1,38,122
30306,79,46,10,8,15,64
30307,71,5,50,1,15,56
30308,27,6,10,3,8,19
30309,32,21,9,0,2,30
30310,36,19,5,3,9,27
30311,38,8,23,0,7,31
30312,427,198,103,37,89,338
30313,134,62,39,5,28,106
30314,29,11,11,1,6,23
30315,30,13,10,0,7,23
30316,485,343,38,1,103,382
30317,155,98,22,4,31,124
30318,180,128,15,2,35,145
30319,37,21,8,0,8,29
30320,23,13,3,0,7,16
30321,97,40,36,1,20,77
30322,475,220,159,12,84,391
30323,57,38,9,1,9,48
30324,50,16,21,4,9,41
30325,136,49,54,0,33,103
30326,57,27,18,1,11,46
30327,302,107,139,5,51,251
30328,83,41,18,9,15,68
30329,29,7,13,0,9,20
30330,109,58,25,4,22,87
30331,142,41,75,0,26,116
30332,4,2,2,0,0,4
30333,45,32,4,0,9,36
30334,17,6,9,1,1,16
30335,99,44,33,4,18,81
30336,67,18,37,0,12,55
30337,109,61,15,11,22,87
30338,85,55,15,0,15,70
30339,66,46,9,0,11,55
30340,94,50,12,17,15,79
30341,25,10,9,0,6,19
30342,56,15,26,7,8,48
30343,127,59,35,0,33,94
30344,58,40,11,5,2,56
30345,155,97,30,1,27,128
30346,8,0,7,0,1,7
30347,16,10,2,0,4,12
30348,12,3,5,0,4,8
30349,47,11,27,1,8,39
30350,139,105,6,0,28,111
30351,90,35,15,13,27,63
30352,49,28,12,3,6,43
30353,197,64,93,0,40,157
30354,23,9,7,2,5,18
30355,43,16,14,3,10,33
30356,48,22,10,7,9,39
30357,46,18,20,0,8,38
30358,228,126,64,0,38,190
30359,58,18,15,9,16,42
30360,39,22,8,0,9,30
30361,130,26,44,24,36,94
30362,80,22,37,8,13,67
30363,5,1,3,0,1,4
30364,64,22,27,1,14,50
30365,83,38,28,1,16,67
30366,80,9,52,3,16,64
30367,98,22,43,14,19,79
30368,67,24,33,1,9,58
30369,124,90,5,2,27,97
30370,270,113,97,16,44,226
30371,75,34,18,14,9,66
30372,68,45,5,3,15,53
30373,95,56,20,0,19,76
30374,155,116,6,0,33,122
30375,124,68,34,12,10,114
30376,169,83,52,3,31,138
30377,46,18,20,0,8,38
30378,9,2,5,0,2,7
30379,669,390,143,18,118,551
30380,117,72,10,10,25,92
30381,32,15,4,5,8,24
30382,113,64,27,0,22,91
30383,23,7,12,1,3,20
30384,153,99,10,9,35,118
30385,4,2,0,1,1,3
30386,45,20,13,2,10,35
30387,57,20,24,0,13,44
30388,19,1,13,0,5,14
30389,68,34,20,0,14,54
30390,17,10,1,1,5,12
30391,82,47,17,4,14,68
30392,33,24,5,0,4,29
30393,32,21,9,0,2,30
30394,67,36,14,0,17,50
30395,185,104,43,9,29,156
30396,249,116,84,4,45,204
30397,267,191,26,1,49,218
30398,73,37,26,0,10,63
30399,10,1,6,0,3,7
30400,412,145,137,42,88,324
30401,51,15,22,1,13,38
30402,186,95,46,0,45,141
30403,21,16,3,0,2,19
30404,33,10,7,9,7,26
30405,37,5,19,5,8,29
30406,381,179,92,31,79,302
30407,168,35,52,45,36,132
30408,48,19,17,0,12,36
30409,15,4,7,1,3,12
30410,71,43,12,2,14,57
30411,32,21,9,0,2,30
30412,193,88,47,20,38,155
30413,27,3,20,1,3,24
30414,58,36,7,0,15,43
30415,61,35,13,3,10,51
30416,243,182,9,0,52,191
30417,46,18,20,0,8,38
30418,185,102,35,1,47,138
30419,164,115,13,0,36,128
30420,156,82,33,7,34,122
30421,47,16,16,3,12,35
30422,10,4,4,1,1,9
30423,654,383,142,17,112,542
30424,46,18,20,0,8,38
30425,46,18,20,0,8,38
30426,50,35,0,0,15,35
30427,21,13,5,0,3,18
30428,60,25,24,0,11,49
30429,60,30,21,0,9,51
30430,106,100,0,6,0,106
30431,46,14,24,1,7,39
30432,29,16,4,7,2,27
30433,178,76,66,10,26,152
30434,65,48,12,0,5,60
30435,47,24,14,1,8,39
30436,87,47,24,4,12,75
30437,309,163,78,16,52,257
30438,94,51,29,7,7,87
30439,59,10,36,4,9,50
30440,100,66,1,12,21,79
30441,27,7,14,0,6,21
30442,128,67,37,1,23,105
30443,151,101,21,1,28,123
30444,81,58,2,2,19,62
30445,321,161,92,5,63,258
30446,0,0,0,0,0,0
30447,15,10,2,0,3,12
30448,177,98,39,0,40,137
30449,13,2,11,0,0,13
30450,404,185,134,11,74,330
30451,116,71,22,0,23,93
30452,3,0,3,0,0,3
30453,54,32,11,0,11,43
30454,15,13,0,0,2,13
30455,26,16,6,4,0,26
30456,18,11,4,2,1,17
30457,117,50,34,18,15,102
30458,24,10,9,0,5,19
30459,48,27,14,0,7,41
30460,164,73,53,7,31,133
30461,53,19,17,11,6,47
30462,664,397,126,23,118,546
30463,63,23,26,1,13,50
30464,26,3,15,0,8,18
30465,38,21,9,0,8,30
30466,36,2,27,0,7,29
30467,8,1,3,2,2,6
30468,35,6,22,0,7,28
30469,92,72,8,0,12,80
30470,164,118,21,0,25,139
30471,196,74,52,29,41,155
30472,132,51,46,15,20,112
30473,20,6,8,0,6,14
30474,146,70,28,21,27,119
30475,68,10,50,0,8,60
30476,85,49,15,0,21,64
30477,432,217,108,12,95,337
30478,32,21,9,0,2,30
30479,10,6,1,0,3,7
30480,506,274,112,13,107,399
30481,64,31,21,0,12,52
30482,45,0,40,0,5,40
30483,388,223,84,0,81,307
30484,21,7,8,2,4,17
30485,108,35,31,14,28,80
30486,142,65,44,11,22,120
30487,29,3,14,6,6,23
30488,102,38,38,6,20,82
30489,91,19,31,22,19,72
30490,292,36,200,2,54,238
30491,17,4,4,0,9,8
30492,140,47,60,6,27,113
30493,225,49,74,53,49,176
30494,34,13,15,1,5,29
30495,14,3,9,0,2,12
30496,13,6,3,1,3,10
30497,15,0,11,0,4,11
30498,8,1,7,0,0,8
30499,115,47,48,2,18,97
30500,32,21,9,0,2,30
30501,400,132,154,25,89,311
30502,11,6,2,1,2,9
30503,65,11,41,0,13,52
30504,20,15,3,0,2,18
30505,81,15,31,17,18,63
30506,29,1,19,0,9,20
30507,6,5,0,1,0,6
30508,42,19,6,9,8,34
30509,45,23,15,0,7,38
30510,31,11,13,0,7,24
30511,417,239,76,15,87,330
30512,12,0,9,0,3,9
30513,34,15,8,0,11,23
30514,46,13,24,0,9,37
30515,197,104,58,6,29,168
30516,27,9,8,1,9,18
30517,22,9,3,2,8,14
30518,93,48,19,0,26,67
30519,60,28,22,1,9,51
30520,56,36,9,0,11,45
30521,48,18,18,1,11,37
30522,49,8,30,3,8,41
30523,23,9,8,0,6,17
30524,243,178,12,1,52,191
30525,23,11,8,1,3,20
30526,53,16,23,3,11,42
30527,46,18,20,0,8,38
30528,20,3,13,2,2,18
30529,56,13,31,1,11,45
30530,53,36,3,1,13,40
30531,385,111,156,31,87,298
30532,29,11,9,2,7,22
30533,79,23,16,22,18,61
30534,128,44,33,22,29,99
30535,42,18,13,2,9,33
30536,405,188,133,11,73,332
30537,134,62,37,0,35,99
30538,16,3,12,0,1,15
30539,27,9,10,0,8,19
30540,434,200,143,11,80,354
30541,31,6,15,2,8,23
30542,71,34,26,0,11,60
30543,61,26,19,7,9,52
30544,37,12,19,0,6,31
30545,39,18,11,1,9,30
30546,6,5,0,1,0,6
30547,43,18,16,2,7,36
30548,12,1,9,0,2,10
30549,23,4,8,3,8,15
30550,40,18,9,3,10,30
30551,52,30,17,0,5,47
30552,26,12,8,4,2,24
30553,35,19,9,0,7,28
30554,86,39,25,4,18,68
30555,44,34,2,0,8,36
30556,33,24,5,2,2,31
30557,15,9,6,0,0,15
30558,226,124,35,28,39,187
30559,122,57,40,4,21,101
30560,95,42,27,1,25,70
30561,9,4,4,0,1,8
30562,54,28,9,7,10,44
30563,23,3,17,0,3,20
30564,17,3,11,0,3,14
30565,109,58,25,4,22,87
30566,16,11,1,0,4,12
30567,130,41,50,14,25,105
30568,74,44,19,0,11,63
30569,52,30,11,0,11,41
30570,113,54,27,6,26,87
30571,35,24,3,1,7,28
30572,16,10,3,0,3,13
30573,34,17,12,2,3,31
30574,178,72,44,19,43,135
30575,131,70,24,4,33,98
30576,39,19,12,0,8,31
30577,351,183,99,3,66,285
30578,80,40,9,19,12,68
30579,113,87,6,0,20,93
30580,34,15,5,5,9,25
30581,6,0,4,0,2,4
30582,80,16,56,2,6,74
30583,35,19,8,0,8,27
30584,46,18,20,0,8,38
30585,10,6,3,0,1,9
30586,115,71,21,0,23,92
30587,46,18,20,0,8,38
30588,184,60,98,4,22,162
30589,31,7,15,3,6,25
30590,31,10,7,9,5,26
30591,17,3,10,0,4,13
30592,19,3,12,0,4,15
30593,26,19,3,1,3,23
30594,75,42,11,4,18,57
30595,37,8,14,3,12,25
30596,53,28,10,1,14,39
30597,321,161,91,5,64,257
30598,262,182,17,4,59,203
30599,194,76,35,33,50,144
30600,173,63,50,32,28,145
30601,216,145,55,1,15,201
30602,51,23,16,2,10,41
30603,21,1,4,12,4,17
30604,38,22,7,0,9,29
30605,8,0,6,0,2,6
30606,318,165,85,15,53,265
30607,32,21,9,0,2,30
30608,38,18,15,0,5,33
30609,46,18,20,0,8,38
30610,242,124,71,0,47,195
30611,257,175,32,4,46,211
30612,114,78,7,5,24,90
30613,330,180,95,0,55,275
30614,35,5,23,0,7,28
30615,35,3,24,0,8,27
30616,25,2,16,0,7,18
30617,637,362,150,19,106,531
30618,27,14,6,3,4,23
30619,71,9,9,33,20,51
30620,23,8,13,0,2,21
30621,26,3,17,0,6,20
30622,129,37,62,4,26,103
30623,63,42,9,1,11,52
30624,18,8,3,5,2,16
30625,118,87,5,0,26,92
30626,39,8,24,0,7,32
30627,34,25,2,0,7,27
30628,132,76,28,0,28,104
30629,360,184,102,1,73,287
30630,39,12,20,0,7,32
30631,310,223,17,0,70,240
30632,375,104,172,12,87,288
30633,46,18,20,0,8,38
30634,113,46,43,0,24,89
30635,74,31,24,3,16,58
30636,22,20,0,0,2,20
30637,115,80,10,0,25,90
30638,168,107,45,2,14,154
30639,70,42,15,0,13,57
30640,21,14,5,0,2,19
30641,170,59,54,26,31,139
30642,52,41,1,0,10,42
30643,33,8,21,0,4,29
30644,192,75,34,34,49,143
30645,159,36,15,83,25,134
30646,47,27,13,0,7,40
30647,240,166,24,4,46,194
30648,18,12,5,1,0,18
30649,25,8,9,2,6,19
30650,170,84,50,3,33,137
30651,150,99,29,0,22,128
30652,80,54,13,0,13,67
30653,54,33,14,0,7,47
30654,18,8,1,5,4,14
30655,26,13,6,0,7,19
30656,134,55,52,7,20,114
30657,325,143,120,5,57,268
30658,157,116,14,0,27,130
30659,58,38,12,1,7,51
30660,58,27,22,2,7,51
30661,124,36,39,23,26,98
30662,19,12,3,1,3,16
30663,543,303,117,13,110,433
30664,12,3,9,0,0,12
30665,61,37,11,1,12,49
30666,14,5,3,3,3,11
30667,8,3,4,0,1,7
30668,112,81,6,0,25,87
30669,8,1,5,0,2,6
30670,396,207,112,3,74,322
30671,203,50,104,14,35,168
30672,8,5,1,0,2,6
30673,148,3,123,0,22,126
30674,71,34,12,7,18,53
30675,33,14,9,1,9,24
30676,139,107,6,0,26,113
30677,32,21,9,0,2,30
30678,21,13,1,2,5,16
30679,3,3,0,0,0,3
30680,288,157,79,0,52,236
30681,286,160,35,33,58,228
30682,161,75,30,28,28,133
30683,367,162,129,6,70,297
30684,8,0,5,0,3,5
30685,702,401,159,23,119,583
30686,28,16,7,0,5,23
30687,46,18,20,0,8,38
30688,29,18,6,1,4,25
30689,159,77,48,1,33,126
30690,98,50,30,1,17,81
30691,117,71,17,3,26,91
30692,55,25,12,6,12,43
30693,67,15,25,3,24,43
30694,39,12,23,0,4,35
30695,18,4,9,1,4,14
30696,95,43,6,21,25,70
30697,26,11,5,7,3,23
30698,32,21,9,0,2,30
30699,106,23,45,16,22,84
30700,12,0,9,0,3,9
30701,75,9,42,5,19,56
30702,11,9,0,0,2,9
30703,20,5,6,4,5,15
30704,233,155,32,0,46,187
30705,73,63,2,0,8,65
30706,114,56,19,12,27,87
30707,16,8,4,0,4,12
30708,73,21,36,4,12,61
30709,15,6,4,0,5,10
30710,46,18,20,0,8,38
30711,170,125,19,0,26,144
30712,21,6,9,1,5,16
30713,4,0,3,0,1,3
30714,14,3,5,1,5,9
30715,192,152,12,1,27,165
30716,7,2,4,0,1,6
30717,37,18,9,1,9,28
30718,154,29,94,1,30,124
30719,71,26,30,1,14,57
30720,42,14,20,0,8,34
30721,12,7,3,0,2,10
30722,26,11,11,0,4,22
30723,64,34,9,9,12,52
30724,38,23,4,3,8,30
30725,44,35,2,0,7,37
30726,76,18,40,2,16,60
30727,52,36,4,1,11,41
30728,94,50,20,5,19,75
30729,52,10,32,2,8,44
30730,2,0,1,0,1,1
30731,179,86,35,24,34,145
30732,78,13,41,7,17,61
30733,340,143,120,6,71,269
30734,40,20,10,0,10,30
30735,32,27,0,0,5,27
30736,23,5,14,0,4,19
30737,32,12,5,8,7,25
30738,55,16,28,0,11,44
30739,75,32,25,3,15,60
30740,1,1,0,0,0,1
30741,79,44,12,4,19,60
30742,164,85,38,0,41,123
30743,44,26,15,0,3,41
30744,69,30,27,1,11,58
30745,20,6,9,0,5,15
30746,96,46,22,3,25,71
30747,151,71,42,0,38,113
30748,507,280,82,41,104,403
30749,39,21,16,0,2,37
30750,53,36,10,1,6,47
30751,91,38,29,3,21,70
30752,55,40,5,0,10,45
30753,571,331,110,11,119,452
30754,11,3,7,0,1,10
30755,64,41,12,1,10,54
30756,36,15,15,0,6,30
30757,18,7,5,0,6,12
30758,16,4,9,1,2,14
30759,214,87,14,75,38,176
30760,30,12,10,1,7,23
30761,18,10,5,1,2,16
30762,555,401,42,1,111,444
30763,101,35,46,1,19,82
30764,96,47,20,12,17,79
30765,38,18,9,1,10,28
30766,42,20,10,1,11,31
30767,13,2,7,1,3,10
30768,42,7,25,2,8,34
30769,32,21,9,0,2,30
30770,58,26,22,1,9,49
30771,42,18,14,1,9,33
30772,54,24,15,2,13,41
30773,48,40,2,0,6,42
30774,54,27,16,1,10,44
30775,261,121,81,4,55,206
30776,9,6,2,1,0,9
30777,38,9,17,4,8,30
30778,69,28,20,3,18,51
30779,72,36,25,0,11,61
30780,31,19,3,0,9,22
30781,207,31,93,33,50,157
30782,37,4,23,2,8,29
30783,547,371,60,4,112,435
30784,72,50,7,1,14,58
30785,418,245,76,7,90,328
30786,107,37,41,10,19,88
30787,130,64,45,1,20,110
30788,123,48,40,7,28,95
30789,15,4,8,0,3,12
30790,12,1,7,0,4,8
30791,37,27,0,2,8,29
30792,9,2,5,1,1,8
30793,46,21,10,1,14,32
30794,29,11,12,2,4,25
30795,78,53,12,2,11,67
30796,181,128,13,1,39,142
30797,18,14,1,0,3,15
30798,64,20,26,2,16,48
30799,41,3,30,0,8,33
30800,195,93,62,0,40,155
30801,103,52,28,5,18,85
30802,36,14,8,3,11,25
30803,9,3,4,0,2,7
30804,237,166,51,2,18,219
30805,83,32,31,0,20,63
30806,173,113,23,5,32,141
30807,8,4,3,0,1,7
30808,32,2,24,0,6,26
30809,54,39,5,0,10,44
30810,90,51,23,3,13,77
30811,46,18,20,0,8,38
30812,81,20,37,16,8,73
30813,12,11,0,0,1,11
30814,83,66,4,2,11,72
30815,194,76,34,34,50,144
30816,53,20,24,1,8,45
30817,10,6,4,0,0,10
30818,42,6,25,0,11,31
30819,31,12,10,1,8,23
30820,32,18,5,0,9,23
30821,57,35,14,0,8,49
30822,30,20,4,2,4,26
30823,89,44,19,4,22,67
30824,268,22,194,2,50,218
30825,68,51,6,0,11,57
30826,85,53,6,11,15,70
30827,114,76,16,2,20,94
30828,77,46,15,6,10,67
30829,71,50,4,0,17,54
30830,14,7,5,0,2,12
30831,32,18,4,8,2,30
30832,31,13,6,0,12,19
30833,14,4,6,0,4,10
30834,116,54,37,0,25,91
30835,52,23,19,2,8,44
30836,20,4,9,0,7,13
30837,77,10,44,4,19,58
30838,204,84,65,20,35,169
30839,38,23,9,4,2,36
30840,103,71,21,0,11,92
30841,24,5,12,0,7,17
30842,97,28,39,2,28,69
30843,148,94,28,0,26,122
30844,72,36,12,7,17,55
30845,468,329,40,0,99,369
30846,81,51,15,0,15,66
30847,32,21,9,0,2,30
30848,58,24,24,0,10,48
30849,43,20,6,6,11,32
30850,29,0,25,0,4,25
30851,39,7,23,2,7,32
30852,35,12,11,1,11,24
30853,458,219,140,13,86,372
30854,38,29,8,1,0,38
30855,12,1,6,0,5,7
30856,32,10,18,0,4,28
30857,42,21,14,0,7,35
30858,49,34,2,1,12,37
30859,36,19,9,0,8,28
30860,171,82,53,3,33,138
30861,249,175,15,4,55,194
30862,44,7,18,9,10,34
30863,68,37,15,1,15,53
30864,12,6,3,0,3,9
30865,120,57,38,4,21,99
30866,138,64,42,5,27,111
30867,227,88,14,81,44,183
30868,35,21,3,4,7,28
30869,41,5,26,0,10,31
30870,89,48,17,3,21,68
30871,123,41,61,0,21,102
30872,46,18,20,0,8,38
30873,99,47,15,22,15,84
30874,103,70,11,1,21,82
30875,22,7,5,3,7,15
30876,30,13,13,0,4,26
30877,74,55,6,0,13,61
30878,19,12,3,1,3,16
30879,262,194,15,0,53,209
30880,3,0,1,0,2,1
30881,46,18,20,0,8,38
30882,46,18,20,0,8,38
30883,24,7,8,2,7,17
30884,110,37,43,11,19,91
30885,27,6,16,0,5,22
30886,159,68,35,25,31,128
30887,111,50,25,14,22,89
30888,238,161,31,1,45,193
30889,97,42,33,4,18,79
30890,650,361,158,24,107,543
30891,39,16,16,2,5,34
30892,31,14,9,3,5,26
30893,65,26,30,0,9,56
30894,85,56,14,0,15,70
30895,12,1,4,0,7,5
30896,37,4,27,1,5,32
30897,259,163,37,0,59,200
30898,85,15,44,7,19,66
30899,46,12,15,11,8,38
30900,267,120,97,2,48,219
30901,41,9,15,10,7,34
30902,45,18,13,0,14,31
30903,58,9,39,0,10,48
30904,20,6,11,1,2,18
30905,85,42,17,7,19,66
30906,22,8,10,0,4,18
30907,50,22,11,1,16,34
30908,50,38,2,2,8,42
30909,119,60,29,6,24,95
30910,24,17,2,0,5,19
30911,18,8,6,1,3,15
30912,313,162,83,15,53,260
30913,22,8,12,0,2,20
30914,52,14,26,3,9,43
30915,21,0,14,0,7,14
30916,17,16,0,0,1,16
30917,147,84,36,0,27,120
30918,30,8,17,0,5,25
30919,47,15,22,0,10,37
30920,136,28,84,0,24,112
30921,28,4,17,0,7,21
30922,21,8,9,0,4,17
30923,75,22,37,2,14,61
30924,77,38,25,0,14,63
30925,226,76,85,15,50,176
30926,46,17,17,0,12,34
30927,648,381,137,16,114,534
30928,51,17,26,0,8,43
30929,9,4,3,0,2,7
30930,39,17,9,2,11,28
30931,403,191,136,7,69,334
30932,21,5,8,3,5,16
30933,72,47,11,5,9,63
30934,96,40,34,0,22,74
30935,20,8,5,1,6,14
30936,22,4,9,1,8,14
30937,39,7,23,2,7,32
30938,4,1,1,0,2,2
30939,14,2,6,0,6,8
30940,55,17,24,0,14,41
30941,109,31,56,0,22,87
30942,64,49,11,0,4,60
30943,36,0,32,1,3,33
30944,75,5,61,0,9,66
30945,28,19,2,0,7,21
30946,180,128,7,4,41,139
30947,100,42,21,17,20,80
30948,65,17,3,32,13,52
30949,29,18,5,0,6,23
30950,107,35,44,9,19,88
30951,46,18,20,0,8,38
30952,399,224,95,0,80,319
30953,48,32,8,1,7,41
30954,325,234,16,0,75,250
30955,165,123,3,1,38,127
30956,14,5,6,0,3,11
30957,92,23,26,28,15,77
30958,73,24,21,10,18,55
30959,140,53,47,15,25,115
30960,26,11,8,1,6,20
30961,61,41,12,0,8,53
30962,106,49,33,5,19,87
30963,16,9,4,0,3,13
30964,17,10,2,0,5,12
30965,145,59,56,8,22,123
30966,45,11,25,1,8,37
30967,171,65,44,23,39,132
30968,116,37,54,3,22,94
30969,28,11,14,1,2,26
30970,40,8,27,1,4,36
30971,69,45,9,0,15,54
30972,229,111,63,0,55,174
30973,42,18,13,0,11,31
30974,168,78,33,27,30,138
30975,32,21,9,0,2,30
30976,527,293,115,17,102,425
30977,15,1,9,0,5,10
30978,182,146,8,0,28,154
30979,20,1,12,1,6,14
30980,102,52,30,4,16,86
30981,71,40,15,2,14,57
30982,158,11,91,25,31,127
30983,594,409,54,1,130,464
30984,28,13,12,0,3,25
30985,69,34,18,0,17,52
30986,56,37,12,0,7,49
30987,146,42,48,21,35,111
30988,13,4,2,1,6,7
30989,53,37,6,1,9,44
30990,3,3,0,0,0,3
30991,14,0,9,0,5,9
30992,64,19,35,1,9,55
30993,129,45,62,0,22,107
30994,32,8,18,1,5,27
30995,110,40,29,14,27,83
30996,26,12,5,6,3,23
30997,95,44,12,20,19,76
30998,171,113,27,1,30,141
30999,31,10,7,9,5,26
31000,46,18,20,0,8,38
31001,70,20,26,12,12,58
31002,215,99,85,0,31,184
31003,115,41,40,12,22,93
31004,7,3,4,0,0,7
31005,151,105,20,0,26,125
31006,79,35,28,1,15,64
31007,91,51,21,1,18,73
31008,54,16,30,0,8,46
31009,34,22,5,2,5,29
31010,9,7,0,0,2,7
31011,94,44,36,2,12,82
31012,88,59,16,0,13,75
31013,68,44,12,0,12,56
31014,143,46,73,3,21,122
31015,83,42,18,8,15,68
31016,41,2,33,1,5,36
31017,17,0,10,1,6,11
31018,52,23,14,1,14,38
31019,130,37,64,1,28,102
31020,10,3,5,0,2,8
31021,82,62,6,2,12,70
31022,27,11,10,0,6,21
31023,26,2,7,13,4,22
31024,46,12,11,13,10,36
31025,36,9,20,0,7,29
31026,39,0,33,0,6,33
31027,321,166,78,18,59,262
31028,89,57,10,7,15,74
31029,140,27,48,24,41,99
31030,123,53,40,5,25,98
31031,77,38,21,1,17,60
31032,143,70,28,18,27,116
31033,107,39,28,13,27,80
31034,52,33,7,0,12,40
31035,22,10,7,0,5,17
31036,410,138,162,17,93,317
31037,21,8,7,2,4,17
31038,32,21,9,0,2,30
31039,379,103,157,32,87,292
31040,40,6,5,19,10,30
31041,43,14,16,4,9,34
31042,12,0,5,0,7,5
31043,204,124,63,4,13,191
31044,16,5,8,2,1,15
31045,54,15,31,0,8,46
31046,89,69,0,4,16,73
31047,114,74,22,0,18,96
31048,57,29,6,7,15,42
31049,25,13,3,0,9,16
31050,15,6,7,0,2,13
31051,19,6,9,1,3,16
31052,20,10,6,0,4,16
31053,23,12,1,5,5,18
31054,28,16,7,1,4,24
31055,632,351,156,23,102,530
31056,283,160,31,33,59,224
31057,181,110,39,18,14,167
31058,52,29,12,4,7,45
31059,48,22,15,2,9,39
31060,519,272,103,39,105,414
31061,170,112,27,1,30,140
31062,130,80,31,0,19,111
31063,132,100,4,2,26,106
31064,81,31,33,0,17,64
31065,130,95,6,1,28,102
31066,198,50,22,93,33,165
31067,123,100,3,3,17,106
31068,15,5,7,0,3,12
31069,167,85,40,0,42,125
31070,88,36,34,3,15,73
31071,66,33,17,0,16,50
31072,30,15,8,2,5,25
31073,18,8,7,0,3,15
31074,3,1,2,0,0,3
31075,6,0,4,0,2,4
31076,77,37,25,0,15,62
31077,15,0,11,0,4,11
31078,13,2,8,0,3,10
31079,126,46,34,18,28,98
31080,26,20,2,1,3,23
31081,98,76,3,0,19,79
31082,14,7,4,0,3,11
31083,31,17,6,0,8,23
31084,18,7,5,0,6,12
31085,154,73,31,19,31,123
31086,20,3,8,4,5,15
31087,142,59,31,21,31,111
31088,117,52,46,4,15,102
31089,124,28,41,30,25,99
31090,32,18,11,0,3,29
31091,33,19,7,0,7,26
31092,20,7,6,1,6,14
31093,17,6,7,0,4,13
31094,28,4,16,0,8,20
31095,163,96,37,1,29,134
31096,204,140,18,0,46,158
31097,37,26,0,1,10,27
31098,493,228,114,49,102,391
31099,29,5,22,0,2,27
31100,165,83,48,3,31,134
31101,55,23,19,0,13,42
31102,209,51,31,92,35,174
31103,145,58,45,9,33,112
31104,61,39,4,9,9,52
31105,129,88,9,5,27,102
31106,145,107,9,0,29,116
31107,24,4,17,0,3,21
31108,163,69,35,20,39,124
31109,42,18,12,1,11,31
31110,40,9,20,0,11,29
31111,5,0,2,0,3,2
31112,269,150,69,3,47,222
31113,93,62,6,0,25,68
31114,67,42,8,2,15,52
31115,46,1,13,25,7,39
31116,89,64,10,0,15,74
31117,155,71,50,5,29,126
31118,50,6,36,0,8,42
31119,204,56,35,79,34,170
31120,26,0,15,0,11,15
31121,59,28,21,2,8,51
31122,100,93,0,7,0,100
31123,236,17,177,0,42,194
31124,24,9,11,0,4,20
31125,132,40,36,29,27,105
31126,130,44,49,8,29,101
31127,419,238,93,0,88,331
31128,90,38,27,7,18,72
31129,299,151,84,15,49,250
31130,165,63,56,21,25,140
31131,90,21,36,12,21,69
31132,524,287,113,13,111,413
31133,167,27,70,27,43,124
31134,94,31,41,6,16,78
31135,69,31,24,0,14,55
31136,32,21,9,0,2,30
31137,87,6,65,4,12,75
31138,40,6,23,2,9,31
31139,25,18,2,2,3,22
31140,140,65,42,11,22,118
31141,59,8,38,2,11,48
31142,72,34,14,4,20,52
31143,198,78,43,31,46,152
31144,126,85,18,1,22,104
31145,249,94,55,39,61,188
31146,67,39,12,2,14,53
31147,38,10,24,0,4,34
31148,44,22,17,0,5,39
31149,16,11,3,0,2,14
31150,140,58,41,15,26,114
31151,135,105,7,1,22,113
31152,51,26,5,9,11,40
31153,32,21,9,0,2,30
31154,109,41,39,6,23,86
31155,57,30,18,0,9,48
31156,15,0,11,0,4,11
31157,182,129,6,4,43,139
31158,32,8,11,4,9,23
31159,166,124,7,0,35,131
31160,17,10,1,0,6,11
31161,42,6,29,0,7,35
31162,61,41,6,0,14,47
31163,126,85,18,1,22,104
31164,12,8,3,0,1,11
31165,136,52,46,14,24,112
31166,99,64,17,0,18,81
31167,58,18,24,7,9,49
31168,95,54,18,5,18,77
31169,137,93,19,1,24,113
31170,448,205,150,11,82,366
31171,22,5,15,0,2,20
31172,18,12,3,0,3,15
31173,212,168,6,0,38,174
31174,22,11,6,0,5,17
31175,87,35,16,15,21,66
31176,182,50,56,36,40,142
31177,90,29,32,11,18,72
31178,26,14,7,0,5,21
31179,171,114,26,1,30,141
31180,150,24,97,1,28,122
31181,51,37,2,0,12,39
31182,11,0,7,2,2,9
31183,32,13,14,0,5,27
31184,157,64,54,15,24,133
31185,38,13,16,0,9,29
31186,95,24,53,3,15,80
31187,43,6,30,0,7,36
31188,245,73,120,4,48,197
31189,246,168,27,4,47,199
31190,101,31,37,12,21,80
31191,14,5,9,0,0,14
31192,20,4,7,3,6,14
31193,166,71,32,19,44,122
31194,48,24,12,1,11,37
31195,642,373,145,17,107,535
31196,266,119,90,10,47,219
31197,8,1,5,0,2,6
31198,180,114,34,3,29,151
31199,35,18,12,0,5,30
31200,50,2,36,0,12,38
31201,26,7,13,0,6,20
31202,143,81,40,3,19,124
31203,32,21,9,0,2,30
31204,87,28,25,12,22,65
31205,365,270,18,2,75,290
31206,78,55,6,0,17,61
31207,32,6,20,1,5,27
31208,56,37,12,0,7,49
31209,64,24,3,28,9,55
31210,179,77,54,10,38,141
31211,37,24,11,0,2,35
31212,25,14,8,0,3,22
31213,32,21,9,0,2,30
31214,8,1,5,0,2,6
31215,87,45,19,6,17,70
31216,30,13,10,2,5,25
31217,105,50,36,0,19,86
31218,6,5,1,0,0,6
31219,107,37,46,11,13,94
31220,38,1,33,0,4,34
31221,8,3,3,1,1,7
31222,41,15,13,5,8,33
31223,17,6,4,4,3,14
31224,1290,523,178,337,252,1038
31225,83,46,23,0,14,69
31226,84,58,5,0,21,63
31227,32,21,9,0,2,30
31228,67,42,9,3,13,54
31229,205,30,93,33,49,156
31230,67,12,42,0,13,54
31231,21,9,7,2,3,18
31232,38,9,4,18,7,31
31233,398,194,117,13,74,324
31234,17,3,6,2,6,11
31235,18,15,0,0,3,15
31236,25,9,12,0,4,21
31237,82,39,22,0,21,61
31238,443,209,142,12,80,363
31239,11,4,2,2,3,8
31240,122,82,12,2,26,96
31241,109,85,3,0,21,88
31242,125,58,40,4,23,102
31243,27,2,20,1,4,23
31244,85,33,30,4,18,67
31245,170,112,27,1,30,140
31246,30,5,14,1,10,20
31247,64,41,5,0,18,46
31248,61,40,13,0,8,53
31249,91,39,22,19,11,80
31250,102,49,36,1,16,86
31251,27,7,15,0,5,22
31252,89,51,22,3,13,76
31253,29,6,17,0,6,23
31254,159,48,84,4,23,136
31255,23,9,8,0,6,17
31256,274,16,204,2,52,222
31257,82,55,10,0,17,65
31258,117,50,38,0,29,88
31259,78,36,13,15,14,64
31260,34,24,1,0,9,25
31261,46,26,6,2,12,34
31262,9,5,3,0,1,8
31263,128,64,22,15,27,101
31264,32,21,9,0,2,30
31265,129,48,47,8,26,103
31266,44,3,34,4,3,41
31267,19,2,14,0,3,16
31268,45,34,2,0,9,36
31269,111,45,47,0,19,92
31270,42,7,23,0,12,30
31271,32,3,19,2,8,24
31272,215,17,159,0,39,176
31273,69,44,12,1,12,57
31274,100,43,28,12,17,83
31275,33,10,6,10,7,26
31276,99,32,38,6,23,76
31277,471,237,113,20,101,370
31278,26,19,3,0,4,22
31279,267,178,69,2,18,249
31280,7,2,2,0,3,4
31281,192,146,6,2,38,154
31282,33,12,16,0,5,28
31283,46,10,23,0,13,33
31284,45,15,15,3,12,33
31285,339,140,122,6,71,268
31286,337,198,67,0,72,265
31287,25,11,7,0,7,18
31288,17,0,13,0,4,13
31289,76,39,25,4,8,68
31290,111,31,58,0,22,89
31291,62,32,17,3,10,52
31292,67,37,4,12,14,53
31293,166,111,26,0,29,137
31294,245,175,23,4,43,202
31295,277,127,99,2,49,228
31296,4,2,2,0,0,4
31297,212,114,33,20,45,167
31298,21,8,9,0,4,17
31299,57,16,25,0,16,41
31300,19,14,0,0,5,14
31301,119,44,33,18,24,95
31302,64,17,3,31,13,51
31303,90,25,37,10,18,72
31304,37,22,6,1,8,29
31305,140,103,3,0,34,106
31306,31,23,5,3,0,31
31307,121,59,28,10,24,97
31308,117,48,42,1,26,91
31309,140,66,42,10,22,118
31310,359,158,125,6,70,289
31311,459,136,195,32,96,363
31312,43,7,23,0,13,30
31313,77,53,10,0,14,63
31314,82,27,28,7,20,62
31315,112,51,31,0,30,82
31316,681,378,166,23,114,567
31317,13,5,4,0,4,9
31318,12,0,9,0,3,9
31319,49,32,6,2,9,40
31320,70,7,8,35,20,50
31321,14,7,2,2,3,11
31322,245,16,182,0,47,198
31323,223,121,53,0,49,174
31324,425,205,104,31,85,340
31325,427,132,176,21,98,329
31326,429,203,112,27,87,342
31327,42,29,8,5,0,42
31328,58,34,13,0,11,47
31329,198,141,16,2,39,159
31330,42,24,11,1,6,36
31331,109,51,31,3,24,85
31332,82,31,17,14,20,62
31333,96,31,35,6,24,72
31334,59,39,4,2,14,45
31335,71,23,28,4,16,55
31336,136,72,26,10,28,108
31337,125,56,29,14,26,99
31338,29,17,6,0,6,23
31339,46,18,20,0,8,38
31340,61,35,17,2,7,54
31341,28,15,8,0,5,23
31342,48,26,12,0,10,38
31343,35,33,0,0,2,33
31344,14,4,6,2,2,12
31345,46,28,6,1,11,35
31346,34,24,2,0,8,26
31347,136,81,30,0,25,111
31348,40,23,7,1,9,31
31349,116,23,58,0,35,81
31350,46,18,20,0,8,38
31351,120,59,22,16,23,97
31352,51,15,24,2,10,41
31353,51,27,7,7,10,41
31354,74,31,30,3,10,64
31355,74,48,5,10,11,63
31356,91,31,31,9,20,71
31357,17,4,8,0,5,12
31358,124,54,19,18,33,91
31359,275,26,196,2,51,224
31360,10,4,6,0,0,10
31361,143,91,14,10,28,115
31362,31,16,12,1,2,29
31363,67,26,16,10,15,52
31364,21,6,1,7,7,14
31365,17,7,4,0,6,11
31366,31,19,3,0,9,22
31367,65,36,12,2,15,50
31368,58,40,11,5,2,56
31369,40,12,19,1,8,32
31370,20,0,18,0,2,18
31371,60,19,27,5,9,51
31372,156,118,7,0,31,125
31373,45,20,9,5,11,34
31374,2,0,1,0,1,1
31375,5,5,0,0,0,5
31376,10,1,7,0,2,8
31377,31,7,16,1,7,24
31378,55,17,31,0,7,48
31379,126,41,35,27,23,103
31380,21,5,11,0,5,16
31381,121,75,16,4,26,95
31382,42,23,9,0,10,32
31383,157,81,45,1,30,127
31384,63,44,8,2,9,54
31385,90,29,36,3,22,68
31386,32,21,9,0,2,30
31387,167,64,40,24,39,128
31388,46,18,20,0,8,38
31389,123,84,8,5,26,97
31390,103,67,15,3,18,85
31391,46,21,11,1,13,33
31392,41,16,17,0,8,33
31393,33,17,10,0,6,27
31394,22,5,11,1,5,17
31395,8,5,2,1,0,8
31396,78,37,23,0,18,60
31397,73,36,18,0,19,54
31398,33,11,20,1,1,32
31399,90,64,15,1,10,80
31400,96,35,39,10,12,84
31401,22,11,5,0,6,16
31402,57,24,18,5,10,47
31403,46,18,20,0,8,38
31404,360,192,100,3,65,295
31405,27,7,8,5,7,20
31406,88,53,9,0,26,62
31407,103,62,7,12,22,81
31408,137,58,27,25,27,110
31409,49,3,8,23,15,34
31410,73,30,20,1,22,51
31411,48,0,36,0,12,36
31412,141,37,79,0,25,116
31413,32,21,9,0,2,30
31414,55,32,15,2,6,49
31415,194,93,61,0,40,154
31416,63,24,28,2,9,54
31417,10,6,0,0,4,6
31418,66,32,18,4,12,54
31419,339,203,66,0,70,269
31420,4,2,1,0,1,3
31421,76,59,1,0,16,60
31422,232,102,85,2,43,189
31423,32,21,9,0,2,30
31424,46,20,4,16,6,40
31425,59,17,23,4,15,44
31426,37,8,25,0,4,33
31427,49,30,5,0,14,35
31428,62,4,48,2,8,54
31429,31,7,3,15,6,25
31430,37,22,2,0,13,24
31431,39,2,18,13,6,33
31432,48,10,13,10,15,33
31433,33,25,1,0,7,26
31434,199,82,32,39,46,153
31435,165,54,73,0,38,127
31436,153,57,45,17,34,119
31437,56,34,10,0,12,44
31438,200,65,81,14,40,160
31439,129,83,17,3,26,103
31440,185,106,21,23,35,150
31441,32,21,9,0,2,30
31442,433,259,73,6,95,338
31443,99,65,9,2,23,76
31444,19,14,3,0,2,17
31445,7,3,1,2,1,6
31446,49,31,4,1,13,36
31447,551,390,46,1,114,437
31448,60,39,6,1,14,46
31449,156,53,39,31,33,123
31450,38,10,15,6,7,31
31451,6,4,0,0,2,4
31452,4,1,2,0,1,3
31453,158,88,27,14,29,129
31454,43,11,23,3,6,37
31455,78,44,23,1,10,68
31456,109,41,39,6,23,86
31457,124,26,67,1,30,94
31458,42,10,27,0,5,37
31459,90,30,33,5,22,68
31460,24,9,8,1,6,18
31461,435,205,142,12,76,359
31462,82,44,22,4,12,70
31463,86,45,19,6,16,70
31464,137,44,36,22,35,102
31465,9,3,4,1,1,8
31466,37,20,9,0,8,29
31467,128,45,51,13,19,109
31468,170,69,50,7,44,126
31469,51,12,28,1,10,41
31470,26,11,6,1,8,18
31471,96,23,55,4,14,82
31472,298,140,103,2,53,245
31473,8,0,7,0,1,7
31474,104,56,18,9,21,83
31475,43,6,29,1,7,36
31476,66,13,31,6,16,50
31477,61,22,31,0,8,53
31478,67,29,15,10,13,54
31479,109,47,28,7,27,82
31480,52,31,11,2,8,44
31481,28,13,7,3,5,23
31482,152,118,9,3,22,130
31483,150,97,31,0,22,128
31484,19,2,15,0,2,17
31485,92,64,6,7,15,77
31486,262,200,15,0,47,215
31487,62,33,13,0,16,46
31488,39,13,17,0,9,30
31489,65,29,12,9,15,50
31490,30,9,7,10,4,26
31491,27,12,13,0,2,25
31492,27,4,20,0,3,24
31493,62,41,11,1,9,53
31494,22,2,14,0,6,16
31495,28,13,9,0,6,22
31496,14,5,5,0,4,10
31497,129,66,41,11,11,118
31498,16,4,9,2,1,15
31499,32,21,9,0,2,30
31500,614,363,130,17,104,510
31501,53,11,12,21,9,44
31502,19,5,13,0,1,18
31503,187,43,110,2,32,155
31504,33,2,6,17,8,25
31505,12,4,6,0,2,10
31506,55,36,8,1,10,45
31507,368,110,171,6,81,287
31508,31,15,9,0,7,24
31509,24,5,12,0,7,17
31510,42,5,26,0,11,31
31511,46,27,15,0,4,42
31512,19,3,10,3,3,16
31513,199,148,13,1,37,162
31514,278,155,35,33,55,223
31515,54,31,15,1,7,47
31516,164,18,81,27,38,126
31517,114,66,36,0,12,102
31518,57,19,26,0,12,45
31519,62,43,8,4,7,55
31520,35,14,15,0,6,29
31521,127,36,65,0,26,101
31522,87,25,42,0,20,67
31523,98,49,31,0,18,80
31524,5,1,1,0,3,2
31525,32,21,9,0,2,30
31526,17,11,3,1,2,15
31527,96,59,12,2,23,73
31528,20,11,6,0,3,17
31529,350,157,118,6,69,281
31530,57,39,7,2,9,48
31531,431,319,20,0,92,339
31532,86,43,25,0,18,68
31533,53,26,15,1,11,42
31534,19,10,3,0,6,13
31535,659,378,145,18,118,541
31536,98,44,34,0,20,78
31537,85,41,21,1,22,63
31538,671,396,136,20,119,552
31539,49,32,6,2,9,40
31540,102,28,24,21,29,73
31541,55,14,23,0,18,37
31542,50,15,27,0,8,42
31543,430,135,158,48,89,341
31544,65,27,4,21,13,52
31545,33,8,17,4,4,29
31546,32,9,14,0,9,23
31547,13,0,11,1,1,12
31548,25,13,9,0,3,22
31549,76,33,19,15,9,67
31550,182,79,30,28,45,137
31551,63,33,16,3,11,52
31552,222,76,100,2,44,178
31553,27,6,10,4,7,20
31554,14,5,5,0,4,10
31555,23,14,2,1,6,17
31556,55,25,12,6,12,43
31557,92,46,27,4,15,77
31558,46,18,20,0,8,38
31559,11,3,2,1,5,6
31560,1,0,0,0,1,0
31561,62,39,11,1,11,51
31562,50,15,18,8,9,41
31563,42,38,0,4,0,42
31564,122,31,66,0,25,97
31565,52,30,7,0,15,37
31566,661,390,140,17,114,547
31567,452,269,60,34,89,363
31568,140,58,50,3,29,111
31569,24,2,20,0,2,22
31570,17,10,2,0,5,12
31571,104,86,3,3,12,92
31572,21,9,7,2,3,18
31573,27,10,13,0,4,23
31574,36,14,15,1,6,30
31575,71,32,25,4,10,61
31576,49,29,16,0,4,45
31577,38,12,22,0,4,34
31578,67,32,13,8,14,53
31579,37,5,22,2,8,29
31580,50,17,23,0,10,40
31581,51,26,12,1,12,39
31582,342,262,20,0,60,282
31583,29,16,5,0,8,21
31584,49,31,4,3,11,38
31585,88,47,25,1,15,73
31586,143,90,27,0,26,117
31587,55,28,6,4,17,38
31588,94,21,57,0,16,78
31589,348,188,90,15,55,293
31590,17,11,4,1,1,16
31591,4,3,0,0,1,3
31592,49,28,6,3,12,37
31593,5,5,0,0,0,5
31594,30,12,9,3,6,24
31595,290,69,68,95,58,232
31596,19,15,2,0,2,17
31597,102,61,18,6,17,85
31598,32,21,9,0,2,30
31599,275,126,96,3,50,225
31600,204,77,39,38,50,154
31601,59,36,10,0,13,46
31602,61,30,13,8,10,51
31603,187,89,55,1,42,145
31604,370,169,120,13,68,302
31605,32,21,9,0,2,30
31606,63,30,17,4,12,51
31607,64,22,9,21,12,52
31608,283,72,158,1,52,231
31609,645,385,123,18,119,526
31610,99,37,41,9,12,87
31611,64,35,12,2,15,49
31612,9,4,2,0,3,6
31613,22,12,7,2,1,21
31614,345,187,87,15,56,289
31615,55,24,13,6,12,43
31616,47,22,12,2,11,36
31617,24,13,6,1,4,20
31618,43,11,24,1,7,36
31619,45,20,17,0,8,37
31620,61,42,14,5,0,61
31621,100,25,51,3,21,79
31622,119,55,24,15,25,94
31623,90,37,30,10,13,77
31624,68,2,43,17,6,62
31625,535,299,115,17,104,431
31626,555,323,110,18,104,451
31627,149,64,51,14,20,129
31628,84,59,6,0,19,65
31629,430,134,177,21,98,332
31630,58,34,4,6,14,44
31631,51,11,31,0,9,42
31632,29,6,4,11,8,21
31633,143,55,30,23,35,108
31634,414,200,112,20,82,332
31635,284,98,126,16,44,240
31636,42,16,14,0,12,30
31637,210,108,59,0,43,167
31638,116,44,37,14,21,95
31639,12,2,9,0,1,11
31640,236,94,15,83,44,192
31641,253,192,15,0,46,207
31642,13,2,8,0,3,10
31643,48,19,4,17,8,40
31644,29,6,12,4,7,22
31645,18,8,7,0,3,15
31646,37,6,10,16,5,32
31647,51,32,7,0,12,39
31648,54,16,30,1,7,47
31649,129,43,50,11,25,104
31650,33,25,4,0,4,29
31651,22,5,12,0,5,17
31652,32,21,9,0,2,30
31653,87,61,4,2,20,67
31654,182,110,6,22,44,138
31655,6,3,0,3,0,6
31656,96,38,21,17,20,76
31657,50,29,11,0,10,40
31658,39,2,29,1,7,32
31659,124,46,44,8,26,98
31660,29,23,1,0,5,24
31661,51,15,23,2,11,40
31662,145,57,58,8,22,123
31663,278,175,42,0,61,217
31664,46,18,20,0,8,38
31665,266,65,71,75,55,211
31666,126,99,6,0,21,105
31667,77,39,26,4,8,69
31668,291,47,193,1,50,241
31669,104,39,37,9,19,85
31670,0,0,0,0,0,0
31671,71,14,36,0,21,50
31672,39,1,29,1,8,31
31673,90,67,16,2,5,85
31674,55,24,22,0,9,46
31675,65,30,24,0,11,54
31676,152,74,28,22,28,124
31677,17,10,0,2,5,12
31678,7,1,6,0,0,7
31679,62,37,14,1,10,52
31680,41,8,24,3,6,35
31681,58,14,28,2,14,44
31682,32,14,11,0,7,25
31683,102,67,1,12,22,80
31684,63,27,29,0,7,56
31685,12,4,6,0,2,10
31686,56,8,30,4,14,42
31687,60,40,7,0,13,47
31688,54,15,30,1,8,46
31689,68,35,15,6,12,56
31690,81,33,8,22,18,63
31691,43,27,8,0,8,35
31692,9,7,0,0,2,7
31693,143,58,37,18,30,113
31694,19,13,1,4,1,18
31695,8,4,2,0,2,6
31696,32,21,9,0,2,30
31697,14,1,10,2,1,13
31698,37,5,23,0,9,28
31699,332,75,167,6,84,248
31700,217,73,81,15,48,169
31701,26,10,11,2,3,23
31702,62,31,13,1,17,45
31703,40,6,22,3,9,31
31704,265,195,15,0,55,210
31705,98,44,15,14,25,73
31706,27,20,0,0,7,20
31707,368,187,97,19,65,303
31708,47,3,9,27,8,39
31709,50,7,31,0,12,38
31710,59,24,23,0,12,47
31711,16,3,7,3,3,13
31712,87,27,22,17,21,66
31713,47,30,8,0,9,38
31714,69,4,56,0,9,60
31715,32,21,9,0,2,30
31716,72,70,0,2,0,72
31717,58,7,36,1,14,44
31718,73,35,14,8,16,57
31719,47,12,25,0,10,37
31720,37,7,10,15,5,32
31721,127,42,47,7,31,96
31722,24,3,12,0,9,15
31723,82,42,26,0,14,68
31724,21,7,5,2,7,14
31725,17,9,0,3,5,12
31726,562,410,33,1,118,444
31727,22,9,10,2,1,21
31728,444,246,85,8,105,339
31729,34,1,28,1,4,30
31730,26,11,7,4,4,22
31731,29,2,21,1,5,24
31732,60,35,14,1,10,50
31733,43,34,3,1,5,38
31734,61,18,33,3,7,54
31735,11,8,0,0,3,8
31736,57,30,12,5,10,47
31737,418,193,126,12,87,331
31738,28,3,20,1,4,24
31739,116,80,15,0,21,95
31740,175,47,57,36,35,140
31741,42,23,9,0,10,32
31742,42,4,8,23,7,35
31743,84,40,17,11,16,68
31744,93,47,13,2,31,62
31745,31,12,11,0,8,23
31746,131,66,13,23,29,102
31747,61,19,22,11,9,52
31748,55,30,16,0,9,46
31749,6,3,3,0,0,6
31750,62,25,24,2,11,51
31751,15,1,13,0,1,14
31752,251,106,86,16,43,208
31753,169,31,105,1,32,137
31754,32,18,10,2,2,30
31755,19,2,12,0,5,14
31756,85,55,15,0,15,70
31757,48,21,18,0,9,39
31758,90,39,37,0,14,76
31759,19,13,2,0,4,15
31760,70,35,13,5,17,53
31761,25,21,1,3,0,25
31762,67,29,23,0,15,52
31763,227,88,14,81,44,183
31764,35,9,22,0,4,31
31765,27,10,11,2,4,23
31766,38,25,5,0,8,30
31767,25,13,3,0,9,16
31768,21,0,19,0,2,19
31769,56,28,13,1,14,42
31770,21,14,1,1,5,16
31771,111,45,9,37,20,91
31772,19,9,5,0,5,14
31773,105,31,41,9,24,81
31774,72,34,13,7,18,54
31775,182,70,46,27,39,143
31776,27,23,0,0,4,23
31777,198,47,31,86,34,164
31778,145,87,24,7,27,118
31779,28,4,20,2,2,26
31780,40,13,17,1,9,31
31781,278,96,126,14,42,236
31782,39,22,10,1,6,33
31783,60,33,17,0,10,50
31784,64,18,29,2,15,49
31785,16,3,5,1,7,9
31786,395,109,187,6,93,302
31787,33,7,19,1,6,27
31788,126,74,21,3,28,98
31789,62,12,29,4,17,45
31790,60,24,26,1,9,51
31791,48,28,13,0,7,41
31792,75,17,43,0,15,60
31793,36,16,13,0,7,29
31794,141,107,13,0,21,120
31795,77,51,5,7,14,63
31796,60,30,11,2,17,43
31797,26,19,3,0,4,22
31798,139,49,55,0,35,104
31799,51,26,12,1,12,39
31800,35,2,24,0,9,26
31801,28,15,5,0,8,20
31802,135,76,22,3,34,101
31803,119,59,21,16,23,96
31804,44,19,16,0,9,35
31805,54,32,14,0,8,46
31806,62,40,9,0,13,49
31807,54,43,1,0,10,44
31808,65,14,33,0,18,47
31809,24,10,4,2,8,16
31810,106,33,52,4,17,89
31811,252,18,188,2,44,208
31812,74,11,48,0,15,59
31813,101,36,41,3,21,80
31814,77,54,8,0,15,62
31815,80,16,57,2,5,75
31816,114,61,20,10,23,91
31817,29,11,14,0,4,25
31818,409,237,86,16,70,339
31819,431,203,103,36,89,342
31820,117,8,60,25,24,93
31821,7,3,1,2,1,6
31822,136,45,48,12,31,105
31823,287,48,186,1,52,235
31824,25,14,5,0,6,19
31825,105,74,12,11,8,97
31826,32,21,9,0,2,30
31827,41,26,8,0,7,34
31828,664,386,142,18,118,546
31829,611,421,57,1,132,479
31830,36,7,20,2,7,29
31831,20,12,4,0,4,16
31832,388,223,86,0,79,309
31833,88,41,32,1,14,74
31834,28,13,11,0,4,24
31835,70,43,12,1,14,56
31836,27,4,0,17,6,21
31837,25,11,8,1,5,20
31838,18,4,6,0,8,10
31839,122,73,26,0,23,99
31840,44,12,12,7,13,31
31841,138,99,9,0,30,108
31842,27,6,15,1,5,22
31843,34,6,20,0,8,26
31844,30,8,6,13,3,27
31845,37,15,19,0,3,34
31846,100,67,1,12,20,80
31847,22,3,13,2,4,18
31848,12,4,6,0,2,10
31849,103,70,5,0,28,75
31850,35,16,10,0,9,26
31851,140,42,65,4,29,111
31852,30,19,3,0,8,22
31853,19,4,8,1,6,13
31854,3,1,1,0,1,2
31855,36,15,14,1,6,30
31856,196,97,38,28,33,163
31857,1324,534,194,337,259,1065
31858,8,3,4,0,1,7
31859,54,18,17,7,12,42
31860,38,15,7,3,13,25
31861,8,2,4,2,0,8
31862,27,10,11,2,4,23
31863,32,21,9,0,2,30
31864,78,29,31,7,11,67
31865,22,12,4,3,3,19
31866,18,3,11,0,4,14
31867,316,133,110,6,67,249
31868,17,14,3,0,0,17
31869,83,34,12,17,20,63
31870,553,398,40,1,114,439
31871,115,76,22,0,17,98
31872,34,15,9,3,7,27
31873,41,13,17,0,11,30
31874,105,57,22,7,19,86
31875,32,21,9,0,2,30
31876,38,9,4,18,7,31
31877,12,7,2,0,3,9
31878,32,21,9,0,2,30
31879,133,99,6,0,28,105
31880,6,5,0,1,0,6
31881,64,31,13,5,15,49
31882,32,15,2,5,10,22
31883,180,117,27,5,31,149
31884,42,17,21,0,4,38
31885,97,63,15,0,19,78
31886,116,37,64,0,15,101
31887,337,188,67,13,69,268
31888,96,45,15,21,15,81
31889,444,138,191,15,100,344
31890,57,35,10,0,12,45
31891,529,270,93,53,113,416
31892,18,6,4,0,8,10
31893,14,3,10,0,1,13
31894,39,7,12,9,11,28
31895,73,15,40,7,11,62
31896,69,31,28,0,10,59
31897,479,256,122,20,81,398
31898,219,122,44,0,53,166
31899,7,4,1,1,1,6
31900,51,35,6,1,9,42
31901,39,29,5,0,5,34
31902,105,38,25,19,23,82
31903,14,1,12,0,1,13
31904,15,4,7,0,4,11
31905,37,8,18,2,9,28
31906,207,109,48,0,50,157
31907,436,241,83,8,104,332
31908,45,23,11,1,10,35
31909,119,93,3,0,23,96
31910,19,8,6,0,5,14
31911,30,11,16,0,3,27
31912,257,110,98,3,46,211
31913,42,12,16,7,7,35
31914,22,2,16,0,4,18
31915,208,46,56,69,37,171
31916,86,55,16,0,15,71
31917,53,0,33,3,17,36
31918,118,58,39,3,18,100
31919,72,30,21,3,18,54
31920,241,129,64,0,48,193
31921,192,95,31,31,35,157
31922,27,16,6,0,5,22
31923,90,23,47,0,20,70
31924,90,35,36,1,18,72
31925,32,21,9,0,2,30
31926,51,15,24,4,8,43
31927,4,0,1,1,2,2
31928,59,11,25,7,16,43
31929,75,40,19,4,12,63
31930,1068,392,430,46,200,868
31931,199,110,40,13,36,163
31932,104,40,27,14,23,81
31933,15,7,4,0,4,11
31934,95,40,33,1,21,74
31935,37,15,13,0,9,28
31936,294,143,86,4,61,233
31937,1,1,0,0,0,1
31938,55,40,4,1,10,45
31939,90,65,5,0,20,70
31940,28,17,5,1,5,23
31941,33,14,8,2,9,24
31942,194,61,80,14,39,155
31943,104,56,28,0,20,84
31944,58,41,8,0,9,49
31945,65,24,21,5,15,50
31946,18,6,7,3,2,16
31947,20,9,9,0,2,18
31948,30,20,6,4,0,30
31949,71,43,7,8,13,58
31950,56,37,12,0,7,49
31951,14,1,10,0,3,11
31952,125,73,26,0,26,99
31953,37,21,5,1,10,27
31954,117,53,48,3,13,104
31955,29,11,12,0,6,23
31956,62,35,13,3,11,51
31957,38,19,8,1,10,28
31958,68,27,26,4,11,57
31959,49,20,12,7,10,39
31960,60,41,8,4,7,53
31961,50,34,9,0,7,43
31962,58,7,36,0,15,43
31963,61,22,28,2,9,52
31964,32,21,9,0,2,30
31965,72,56,2,0,14,58
31966,88,50,4,16,18,70
31967,9,2,4,1,2,7
31968,93,44,15,16,18,75
31969,28,22,3,3,0,28
31970,19,11,4,0,4,15
31971,74,42,20,0,12,62
31972,10,4,4,0,2,8
31973,108,73,23,0,12,96
31974,21,13,4,1,3,18
31975,6,1,3,0,2,4
31976,48,28,14,0,6,42
31977,120,42,43,5,30,90
31978,6,1,4,0,1,5
31979,116,86,5,0,25,91
31980,672,391,141,21,119,553
31981,373,168,125,6,74,299
31982,343,186,87,15,55,288
31983,144,45,52,14,33,111
31984,39,24,9,0,6,33
31985,48,23,16,0,9,39
31986,94,35,28,2,29,65
31987,111,72,13,3,23,88
31988,6,5,0,0,1,5
31989,13,6,7,0,0,13
31990,342,147,119,6,70,272
31991,145,14,98,2,31,114
31992,27,5,13,2,7,20
31993,73,16,39,6,12,61
31994,91,29,32,12,18,73
31995,92,72,3,0,17,75
31996,3,1,0,0,2,1
31997,30,15,7,4,4,26
31998,122,96,8,2,16,106
31999,57,30,6,6,15,42
32000,26,0,20,1,5,21
32001,114,45,38,7,24,90
32002,44,12,20,0,12,32
32003,37,18,13,0,6,31
32004,52,41,1,0,10,42
32005,169,55,88,4,22,147
32006,91,47,24,1,19,72
32007,63,25,26,6,6,57
32008,18,6,7,2,3,15
32009,156,77,53,0,26,130
32010,54,18,12,13,11,43
32011,207,112,61,0,34,173
32012,21,8,9,0,4,17
32013,60,30,14,3,13,47
32014,180,101,32,1,46,134
32015,46,18,20,0,8,38
32016,87,42,21,1,23,64
32017,60,41,12,5,2,58
32018,38,13,17,2,6,32
32019,82,35,29,1,17,65
32020,9,1,5,1,2,7
32021,437,136,177,26,98,339
32022,60,42,7,2,9,51
32023,29,11,5,4,9,20
32024,139,79,14,19,27,112
32025,188,99,25,28,36,152
32026,93,26,42,6,19,74
32027,55,17,18,3,17,38
32028,99,54,25,3,17,82
32029,59,29,5,14,11,48
32030,32,18,8,0,6,26
32031,87,40,14,15,18,69
32032,103,48,35,4,16,87
32033,30,13,8,0,9,21
32034,22,6,10,1,5,17
32035,9,1,6,0,2,7
32036,40,9,24,1,6,34
32037,109,58,25,4,22,87
32038,27,9,12,2,4,23
32039,39,11,18,2,8,31
32040,97,72,4,2,19,78
32041,438,146,152,48,92,346
32042,31,12,10,0,9,22
32043,30,4,17,3,6,24
32044,73,41,23,4,5,68
32045,32,21,9,0,2,30
32046,44,18,16,0,10,34
32047,73,5,51,1,16,57
32048,45,19,18,0,8,37
32049,37,7,21,2,7,30
32050,412,305,24,0,83,329
32051,134,73,32,5,24,110
32052,93,41,26,3,23,70
32053,26,19,3,1,3,23
32054,31,20,6,0,5,26
32055,79,25,28,14,12,67
32056,69,45,9,0,15,54
32057,62,15,8,26,13,49
32058,38,25,3,3,7,31
32059,39,19,12,0,8,31
32060,21,7,7,0,7,14
32061,30,22,0,0,8,22
32062,58,13,36,0,9,49
32063,32,21,9,0,2,30
32064,508,343,58,3,104,404
32065,21,9,9,1,2,19
32066,195,140,16,2,37,158
32067,27,14,5,0,8,19
32068,77,39,25,1,12,65
32069,67,34,15,0,18,49
32070,670,386,152,18,114,556
32071,117,95,2,3,17,100
32072,37,4,21,6,6,31
32073,57,9,33,4,11,46
32074,96,40,23,10,23,73
32075,41,17,5,9,10,31
32076,125,98,6,0,21,104
32077,58,33,10,0,15,43
32078,20,5,5,7,3,17
32079,48,35,1,3,9,39
32080,68,45,11,0,12,56
32081,137,72,42,12,11,126
32082,42,8,13,9,12,30
32083,530,380,35,1,114,416
32084,68,41,7,7,13,55
32085,42,14,19,3,6,36
32086,50,18,22,0,10,40
32087,61,49,4,0,8,53
32088,137,81,30,0,26,111
32089,127,74,22,3,28,99
32090,1,1,0,0,0,1
32091,102,54,20,8,20,82
32092,26,10,14,0,2,24
32093,15,1,8,0,6,9
32094,32,18,6,1,7,25
32095,20,13,6,1,0,20
32096,46,18,20,0,8,38
32097,230,112,68,10,40,190
32098,55,39,6,1,9,46
32099,53,17,18,7,11,42
32100,66,29,21,2,14,52
32101,4,0,3,1,0,4
32102,70,22,35,1,12,58
32103,134,52,60,1,21,113
32104,66,14,35,7,10,56
32105,55,40,4,1,10,45
32106,65,7,49,0,9,56
32107,30,11,11,0,8,22
32108,20,3,10,0,7,13
32109,199,133,21,0,45,154
32110,46,18,20,0,8,38
32111,46,18,20,0,8,38
32112,137,74,38,2,23,114
32113,44,2,36,0,6,38
32114,58,37,7,0,14,44
32115,62,18,33,1,10,52
32116,70,37,14,0,19,51
32117,337,165,70,37,65,272
32118,23,13,3,1,6,17
32119,150,72,36,9,33,117
32120,48,33,6,1,8,40
32121,50,24,16,0,10,40
32122,7,4,0,1,2,5
32123,198,89,52,19,38,160
32124,8,3,2,0,3,5
32125,34,5,7,11,11,23
32126,12,4,5,0,3,9
32127,80,30,28,1,21,59
32128,106,54,19,9,24,82
32129,105,57,26,4,18,87
32130,27,9,9,0,9,18
32131,632,367,130,18,117,515
32132,29,20,3,0,6,23
32133,357,185,102,12,58,299
32134,374,228,59,19,68,306
32135,26,20,2,1,3,23
32136,5,0,3,0,2,3
32137,134,71,31,8,24,110
32138,86,58,10,0,18,68
32139,30,10,15,0,5,25
32140,76,46,15,0,15,61
32141,15,8,1,5,1,14
32142,46,18,20,0,8,38
32143,63,46,11,0,6,57
32144,24,12,8,2,2,22
32145,47,18,19,0,10,37
32146,90,33,39,2,16,74
32147,29,19,3,0,7,22
32148,82,27,31,11,13,69
32149,32,22,4,0,6,26
32150,81,36,23,0,22,59
32151,18,10,2,2,4,14
32152,170,61,50,20,39,131
32153,20,0,16,1,3,17
32154,171,83,56,4,28,143
32155,45,26,16,0,3,42
32156,9,3,5,0,1,8
32157,61,37,15,2,7,54
32158,33,17,10,0,6,27
32159,228,152,58,2,16,212
32160,459,169,146,42,102,357
32161,31,12,11,2,6,25
32162,504,215,125,50,114,390
32163,120,32,57,4,27,93
32164,21,8,8,0,5,16
32165,247,103,15,82,47,200
32166,14,8,4,0,2,12
32167,128,52,33,19,24,104
32168,45,20,8,8,9,36
32169,21,1,17,0,3,18
32170,38,5,25,0,8,30
32171,16,11,2,0,3,13
32172,19,3,10,0,6,13
32173,31,5,19,0,7,24
32174,95,29,49,0,17,78
32175,115,44,46,12,13,102
32176,35,15,12,0,8,27
32177,24,9,7,2,6,18
32178,46,18,20,0,8,38
32179,101,50,25,5,21,80
32180,129,96,3,0,30,99
32181,63,17,14,12,20,43
32182,59,15,24,1,19,40
32183,28,15,10,0,3,25
32184,26,10,10,0,6,20
32185,26,13,8,0,5,21
32186,29,11,12,0,6,23
32187,7,3,3,0,1,6
32188,9,7,0,0,2,7
32189,125,44,44,8,29,96
32190,65,15,38,1,11,54
32191,30,9,7,4,10,20
32192,54,2,27,18,7,47
32193,213,114,47,0,52,161
32194,14,10,2,0,2,12
32195,50,10,29,1,10,40
32196,37,5,19,4,9,28
32197,17,11,4,1,1,16
32198,43,5,29,0,9,34
32199,38,12,22,0,4,34
32200,18,4,9,0,5,13
32201,30,4,23,0,3,27
32202,48,12,23,0,13,35
32203,56,34,6,0,16,40
32204,21,4,5,9,3,18
32205,235,68,113,15,39,196
32206,62,21,15,16,10,52
32207,37,15,14,0,8,29
32208,46,30,7,3,6,40
32209,701,406,161,20,114,587
32210,62,29,23,2,8,54
32211,59,21,20,7,11,48
32212,50,15,15,10,10,40
32213,117,52,34,2,29,88
32214,29,16,6,2,5,24
32215,19,6,8,3,2,17
32216,99,35,39,10,15,84
32217,192,74,73,2,43,149
32218,44,35,2,0,7,37
32219,357,183,115,0,59,298
32220,39,21,9,4,5,34
32221,14,3,7,2,2,12
32222,124,32,66,0,26,98
32223,102,29,51,4,18,84
32224,40,10,25,0,5,35
32225,184,65,52,24,43,141
32226,17,11,2,0,4,13
32227,46,18,20,0,8,38
32228,64,20,30,4,10,54
32229,55,23,19,2,11,44
32230,30,23,4,0,3,27
32231,64,48,12,0,4,60
32232,8,2,6,0,0,8
32233,266,185,17,4,60,206
32234,47,32,11,0,4,43
32235,49,16,19,3,11,38
32236,126,54,20,18,34,92
32237,96,27,54,2,13,83
32238,373,162,130,12,69,304
32239,46,27,8,2,9,37
32240,59,26,22,3,8,51
32241,79,44,19,4,12,67
32242,283,101,123,15,44,239
32243,684,381,166,23,114,570
32244,123,47,36,10,30,93
32245,119,43,31,21,24,95
32246,10,1,8,0,1,9
32247,97,18,48,13,18,79
32248,137,54,55,2,26,111
32249,80,40,20,3,17,63
32250,44,21,14,2,7,37
32251,45,28,7,0,10,35
32252,37,10,10,13,4,33
32253,82,24,36,5,17,65
32254,47,14,21,0,12,35
32255,93,25,48,0,20,73
32256,27,8,11,2,6,21
32257,27,13,12,0,2,25
32258,226,142,67,1,16,210
32259,117,87,7,0,23,94
32260,8,0,5,0,3,5
32261,281,157,35,33,56,225
32262,642,385,109,9,139,503
32263,159,92,37,1,29,130
32264,123,94,1,1,27,96
32265,85,25,43,3,14,71
32266,70,39,13,4,14,56
32267,83,35,29,4,15,68
32268,74,54,7,4,9,65
32269,51,27,11,1,12,39
32270,102,65,10,6,21,81
32271,35,19,8,1,7,28
32272,22,10,8,0,4,18
32273,14,2,8,0,4,10
32274,316,173,72,0,71,245
32275,62,36,13,1,12,50
32276,36,15,15,0,6,30
32277,37,21,10,2,4,33
32278,23,14,3,0,6,17
32279,169,58,82,0,29,140
32280,153,9,90,24,30,123
32281,16,11,3,0,2,14
32282,126,74,21,3,28,98
32283,156,74,30,26,26,130
32284,138,44,44,17,33,105
32285,8,4,2,0,2,6
32286,32,21,9,0,2,30
32287,181,24,93,27,37,144
32288,27,7,13,0,7,20
32289,222,53,123,1,45,177
32290,229,125,68,0,36,193
32291,80,9,50,4,17,63
32292,30,14,13,0,3,27
32293,58,29,19,0,10,48
32294,27,15,8,0,4,23
32295,113,44,41,10,18,95
32296,29,15,5,0,9,20
32297,70,17,37,1,15,55
32298,23,5,12,1,5,18
32299,77,30,34,3,10,67
32300,321,79,136,29,77,244
32301,10,1,7,0,2,8
32302,17,3,11,0,3,14
32303,31,7,16,2,6,25
32304,44,14,19,1,10,34
32305,290,196,70,3,21,269
32306,52,35,3,1,13,39
32307,46,18,20,0,8,38
32308,125,55,48,1,21,104
32309,22,12,4,0,6,16
32310,22,16,1,0,5,17
32311,39,14,18,0,7,32
32312,39,2,18,13,6,33
32313,55,29,9,4,13,42
32314,134,49,34,21,30,104
32315,46,18,20,0,8,38
32316,102,66,25,0,11,91
32317,49,15,10,11,13,36
32318,90,38,27,0,25,65
32319,81,52,11,3,15,66
32320,305,218,25,0,62,243
32321,20,3,11,0,6,14
32322,35,11,12,5,7,28
32323,178,138,6,0,34,144
32324,58,31,14,3,10,48
32325,0,0,0,0,0,0
32326,29,12,12,1,4,25
32327,39,21,9,1,8,31
32328,62,47,5,3,7,55
32329,54,23,20,1,10,44
32330,701,405,163,19,114,587
32331,63,27,20,2,14,49
32332,68,45,5,3,15,53
32333,94,47,32,2,13,81
32334,356,192,90,15,59,297
32335,453,232,117,11,93,360
32336,232,130,52,0,50,182
32337,64,43,9,1,11,53
32338,105,50,27,5,23,82
32339,28,5,13,1,9,19
32340,470,216,148,14,92,378
32341,86,40,22,1,23,63
32342,220,93,55,25,47,173
32343,13,12,0,0,1,12
32344,490,259,114,12,105,385
32345,46,29,2,10,5,41
32346,75,27,36,1,11,64
32347,83,33,5,32,13,70
32348,165,110,26,0,29,136
32349,31,1,22,0,8,23
32350,14,1,9,0,4,10
32351,64,12,38,0,14,50
32352,113,63,17,6,27,86
32353,64,49,11,0,4,60
32354,89,32,37,1,19,70
32355,417,133,181,12,91,326
32356,78,63,3,2,10,68
32357,650,384,138,18,110,540
32358,525,258,98,57,112,413
32359,128,66,11,23,28,100
32360,124,42,61,0,21,103
32361,78,49,20,6,3,75
32362,84,25,47,0,12,72
32363,14,5,5,0,4,10
32364,197,98,30,33,36,161
32365,55,17,5,23,10,45
32366,276,70,149,3,54,222
32367,29,2,19,2,6,23
32368,130,60,37,0,33,97
32369,180,74,37,27,42,138
32370,15,10,2,1,2,13
32371,64,35,17,0,12,52
32372,87,19,49,10,9,78
32373,115,92,6,2,15,100
32374,141,83,29,5,24,117
32375,39,23,9,0,7,32
32376,56,21,26,0,9,47
32377,86,38,28,2,18,68
32378,18,9,3,0,6,12
32379,65,42,11,1,11,54
32380,266,148,34,32,52,214
32381,22,15,2,0,5,17
32382,32,21,9,0,2,30
32383,64,49,11,0,4,60
32384,206,54,23,95,34,172
32385,220,149,30,0,41,179
32386,99,11,51,18,19,80
32387,16,9,3,0,4,12
32388,61,35,16,0,10,51
32389,4,0,3,0,1,3
32390,195,78,35,33,49,146
32391,44,30,1,1,12,32
32392,46,7,28,0,11,35
32393,79,50,13,8,8,71
32394,27,15,8,0,4,23
32395,15,8,1,5,1,14
32396,121,79,29,0,13,108
32397,55,30,14,3,8,47
32398,19,3,12,0,4,15
32399,40,11,17,1,11,29
32400,92,43,22,2,25,67
32401,48,19,16,0,13,35
32402,638,369,147,16,106,532
32403,2,0,1,0,1,1
32404,126,58,32,12,24,102
32405,467,344,24,0,99,368
32406,35,20,9,3,3,32
32407,24,14,5,0,5,19
32408,158,69,53,6,30,128
32409,69,34,25,0,10,59
32410,145,36,77,1,31,114
32411,45,33,5,1,6,39
32412,142,67,42,11,22,120
32413,55,33,8,3,11,44
32414,83,41,22,0,20,63
32415,74,39,19,0,16,58
32416,70,32,16,13,9,61
32417,15,10,2,1,2,13
32418,30,14,11,3,2,28
32419,146,13,100,2,31,115
32420,621,368,110,9,134,487
32421,90,46,13,2,29,61
32422,62,39,12,1,10,52
32423,46,18,20,0,8,38
32424,33,19,9,2,3,30
32425,56,3,40,1,12,44
32426,79,15,45,3,16,63
32427,25,13,5,1,6,19
32428,62,37,7,6,12,50
32429,52,13,28,1,10,42
32430,48,17,12,3,16,32
32431,30,14,6,0,10,20
32432,31,11,2,14,4,27
32433,166,126,7,0,33,133
32434,51,17,19,1,14,37
32435,105,66,15,4,20,85
32436,32,15,7,2,8,24
32437,99,33,26,21,19,80
32438,10,3,4,0,3,7
32439,84,43,21,8,12,72
32440,72,29,32,1,10,62
32441,65,24,19,6,16,49
32442,23,0,15,0,8,15
32443,49,40,2,0,7,42
32444,94,50,13,16,15,79
32445,91,61,6,0,24,67
32446,19,4,12,0,3,16
32447,141,50,31,28,32,109
32448,95,58,17,0,20,75
32449,69,14,33,2,20,49
32450,46,18,20,0,8,38
32451,43,8,20,0,15,28
32452,339,155,111,11,62,277
32453,107,34,51,0,22,85
32454,82,45,20,1,16,66
32455,73,61,2,1,9,64
32456,32,15,10,0,7,25
32457,163,83,35,7,38,125
32458,322,148,77,35,62,260
32459,18,6,8,0,4,14
32460,53,29,14,2,8,45
32461,38,19,11,1,7,31
32462,24,4,14,0,6,18
32463,137,72,35,0,30,107
32464,27,12,10,0,5,22
32465,22,6,11,0,5,17
32466,149,52,37,30,30,119
32467,26,1,15,0,10,16
32468,247,128,71,0,48,199
32469,32,21,9,0,2,30
32470,6,3,1,0,2,4
32471,41,17,9,6,9,32
32472,102,51,15,21,15,87
32473,121,53,36,3,29,92
32474,84,32,35,2,15,69
32475,72,38,18,0,16,56
32476,53,27,10,7,9,44
32477,166,62,41,24,39,127
32478,4,1,3,0,0,4
32479,17,0,15,0,2,15
32480,250,154,37,0,59,191
32481,55,6,46,0,3,52
32482,9,1,7,0,1,8
32483,137,88,29,0,20,117
32484,36,11,16,0,9,27
32485,38,10,17,0,11,27
32486,21,15,4,0,2,19
32487,57,16,31,0,10,47
32488,156,80,36,9,31,125
32489,109,58,31,2,18,91
32490,64,33,10,1,20,44
32491,157,71,50,6,30,127
32492,41,14,13,3,11,30
32493,100,64,9,5,22,78
32494,14,3,10,0,1,13
32495,111,50,36,6,19,92
32496,77,19,26,16,16,61
32497,68,31,24,3,10,58
32498,4,0,0,4,0,4
32499,185,58,76,14,37,148
32500,103,52,25,5,21,82
32501,126,39,47,6,34,92
32502,146,64,52,1,29,117
32503,52,38,4,0,10,42
32504,24,12,6,1,5,19
32505,51,22,18,3,8,43
32506,80,45,5,17,13,67
32507,187,74,43,29,41,146
32508,101,63,10,13,15,86
32509,46,18,20,0,8,38
32510,66,36,11,0,19,47
32511,27,1,21,0,5,22
32512,13,5,6,0,2,11
32513,86,57,14,0,15,71
32514,29,10,12,1,6,23
32515,32,21,9,0,2,30
32516,69,28,27,0,14,55
32517,7,4,2,0,1,6
32518,75,27,21,10,17,58
32519,58,13,22,2,21,37
32520,546,304,115,12,115,431
32521,62,43,8,4,7,55
32522,11,2,7,1,1,10
32523,61,18,25,3,15,46
32524,245,148,9,31,57,188
32525,138,79,22,3,34,104
32526,104,38,41,11,14,90
32527,86,24,23,21,18,68
32528,113,77,19,0,17,96
32529,17,4,7,0,6,11
32530,48,35,0,0,13,35
32531,508,368,36,0,104,404
32532,659,384,148,15,112,547
32533,55,22,22,1,10,45
32534,52,34,12,0,6,46
32535,39,21,8,2,8,31
32536,15,4,8,0,3,12
32537,9,1,4,0,4,5
32538,406,106,162,46,92,314
32539,70,20,26,12,12,58
32540,172,49,89,2,32,140
32541,36,6,22,0,8,28
32542,153,82,46,0,25,128
32543,26,15,6,2,3,23
32544,662,384,143,18,117,545
32545,103,66,26,0,11,92
32546,174,73,37,20,44,130
32547,33,12,12,1,8,25
32548,67,4,52,1,10,57
32549,30,11,11,0,8,22
32550,109,53,36,0,20,89
32551,42,17,12,2,11,31
32552,366,200,92,15,59,307
32553,53,26,6,7,14,39
32554,124,56,45,4,19,105
32555,45,26,9,4,6,39
32556,29,14,8,1,6,23
32557,2,1,1,0,0,2
32558,141,72,24,19,26,115
32559,8,4,2,0,2,6
32560,130,94,17,0,19,111
32561,13,6,5,0,2,11
32562,300,185,49,0,66,234
32563,461,134,191,36,100,361
32564,165,31,102,1,31,134
32565,56,23,23,0,10,46
32566,49,13,24,3,9,40
32567,58,23,22,3,10,48
32568,164,51,54,22,37,127
32569,421,102,177,45,97,324
32570,250,103,18,82,47,203
32571,18,11,2,0,5,13
32572,84,68,2,0,14,70
32573,230,159,29,2,40,190
32574,41,21,10,1,9,32
32575,18,5,7,3,3,15
32576,57,21,22,1,13,44
32577,46,18,20,0,8,38
32578,21,13,5,0,3,18
32579,23,9,11,0,3,20
32580,585,404,54,1,126,459
32581,86,27,25,14,20,66
32582,141,85,29,0,27,114
32583,34,7,20,0,7,27
32584,81,43,8,6,24,57
32585,10,3,5,0,2,8
32586,78,29,17,20,12,66
32587,72,29,13,14,16,56
32588,63,38,11,0,14,49
32589,60,1,49,0,10,50
32590,85,55,15,0,15,70
32591,139,64,46,5,24,115
32592,18,12,1,0,5,13
32593,97,48,16,2,31,66
32594,49,3,30,1,15,34
32595,127,64,12,23,28,99
32596,29,2,21,1,5,24
32597,67,46,6,0,15,52
32598,91,49,11,10,21,70
32599,78,32,23,6,17,61
32600,140,66,45,5,24,116
32601,27,20,2,0,5,22
32602,26,13,8,0,5,21
32603,68,35,12,3,18,50
32604,32,21,9,0,2,30
32605,16,1,12,0,3,13
32606,76,38,24,0,14,62
32607,88,34,23,11,20,68
32608,175,62,76,3,34,141
32609,31,4,21,0,6,25
32610,66,35,15,2,14,52
32611,98,77,3,0,18,80
32612,49,22,15,0,12,37
32613,44,15,19,2,8,36
32614,32,21,9,0,2,30
32615,134,75,21,7,31,103
32616,72,21,27,1,23,49
32617,37,12,19,0,6,31
32618,32,21,9,0,2,30
32619,22,6,14,0,2,20
32620,87,69,3,1,14,73
32621,394,204,111,4,75,319
32622,62,13,43,0,6,56
32623,85,15,44,7,19,66
32624,133,99,6,0,28,105
32625,398,298,20,0,80,318
32626,117,34,42,16,25,92
32627,92,81,2,9,0,92
32628,255,100,95,15,45,210
32629,178,86,37,24,31,147
32630,291,60,173,1,57,234
32631,31,13,9,0,9,22
32632,86,45,21,0,20,66
32633,25,10,8,0,7,18
32634,11,9,2,0,0,11
32635,67,15,36,6,10,57
32636,29,14,8,0,7,22
32637,16,10,3,0,3,13
32638,75,40,11,9,15,60
32639,41,12,24,0,5,36
32640,81,28,27,10,16,65
32641,40,4,28,1,7,33
32642,130,38,66,0,26,104
32643,71,13,44,0,14,57
32644,25,15,5,0,5,20
32645,151,70,49,6,26,125
32646,36,16,10,0,10,26
32647,163,118,30,2,13,150
32648,16,4,9,1,2,14
32649,25,5,15,0,5,20
32650,55,9,33,4,9,46
32651,506,262,93,47,104,402
32652,152,80,42,0,30,122
32653,105,38,25,20,22,83
32654,148,37,76,1,34,114
32655,56,24,22,0,10,46
32656,168,127,3,1,37,131
32657,32,12,10,3,7,25
32658,40,11,22,1,6,34
32659,32,21,9,0,2,30
32660,28,13,7,3,5,23
32661,129,42,47,16,24,105
32662,185,92,33,28,32,153
32663,8,7,1,0,0,8
32664,54,16,30,0,8,46
32665,206,45,55,70,36,170
32666,139,80,21,3,35,104
32667,101,82,3,0,16,85
32668,43,31,3,2,7,36
32669,600,377,95,7,121,479
32670,38,18,4,9,7,31
32671,5,2,3,0,0,5
32672,44,26,11,0,7,37
32673,34,15,8,2,9,25
32674,34,18,5,2,9,25
32675,79,40,10,8,21,58
32676,182,100,34,1,47,135
32677,53,30,7,0,16,37
32678,6,4,2,0,0,6
32679,17,6,7,1,3,14
32680,357,273,20,0,64,293
32681,105,36,37,6,26,79
32682,7,5,0,1,1,6
32683,65,38,16,0,11,54
32684,269,15,201,0,53,216
32685,106,31,52,0,23,83
32686,37,22,8,0,7,30
32687,372,159,134,9,70,302
32688,38,6,4,19,9,29
32689,214,131,43,0,40,174
32690,277,202,18,2,55,222
32691,60,41,6,0,13,47
32692,28,10,12,0,6,22
32693,72,52,10,1,9,63
32694,2,1,0,1,0,2
32695,167,57,8,72,30,137
32696,23,2,12,2,7,16
32697,37,32,1,0,4,33
32698,82,43,17,3,19,63
32699,60,20,27,1,12,48
32700,50,31,12,7,0,50
32701,352,186,91,15,60,292
32702,382,174,127,4,77,305
32703,192,49,98,4,41,151
32704,67,29,19,7,12,55
32705,16,3,10,0,3,13
32706,22,9,11,0,2,20
32707,20,9,6,3,2,18
32708,72,22,33,4,13,59
32709,31,13,7,4,7,24
32710,41,20,11,0,10,31
32711,15,8,3,0,4,11
32712,12,2,5,0,5,7
32713,36,19,10,0,7,29
32714,652,379,145,19,109,543
32715,36,18,15,0,3,33
32716,29,10,12,0,7,22
32717,55,35,11,0,9,46
32718,59,25,18,3,13,46
32719,35,9,14,3,9,26
32720,27,11,8,1,7,20
32721,63,11,37,0,15,48
32722,136,72,26,10,28,108
32723,60,25,17,4,14,46
32724,32,9,14,2,7,25
32725,35,8,20,1,6,29
32726,74,26,37,0,11,63
32727,75,57,6,1,11,64
32728,195,49,101,5,40,155
32729,32,21,9,0,2,30
32730,145,36,77,1,31,114
32731,19,9,8,0,2,17
32732,60,12,24,7,17,43
32733,157,47,81,0,29,128
32734,46,18,20,0,8,38
32735,54,31,6,2,15,39
32736,53,30,12,0,11,42
32737,59,35,18,2,4,55
32738,10,5,0,0,5,5
32739,99,74,4,1,20,79
32740,137,70,32,4,31,106
32741,643,378,137,19,109,534
32742,288,195,68,3,22,266
32743,85,68,3,0,14,71
32744,49,34,12,3,0,49
32745,17,12,3,0,2,15
32746,151,73,27,23,28,123
32747,27,0,18,0,9,18
32748,670,396,146,18,110,560
32749,20,4,12,0,4,16
32750,151,37,73,4,37,114
32751,74,42,17,3,12,62
32752,37,18,8,2,9,28
32753,23,5,10,0,8,15
32754,89,54,17,2,16,73
32755,91,19,46,10,16,75
32756,42,5,31,0,6,36
32757,47,29,6,3,9,38
32758,57,23,19,5,10,47
32759,187,46,23,85,33,154
32760,46,18,20,0,8,38
32761,408,302,19,0,87,321
32762,63,11,38,0,14,49
32763,35,14,15,2,4,31
32764,212,54,109,6,43,169
32765,56,35,9,2,10,46
32766,42,18,15,0,9,33
32767,140,72,43,0,25,115
32768,14,5,9,0,0,14
32769,57,21,19,7,10,47
32770,160,30,98,1,31,129
32771,15,8,5,1,1,14
32772,124,66,23,4,31,93
32773,86,32,33,7,14,72
32774,17,10,0,2,5,12
32775,80,23,17,19,21,59
32776,8,2,3,0,3,5
32777,35,13,14,2,6,29
32778,76,55,7,3,11,65
32779,47,31,6,0,10,37
32780,16,3,8,0,5,11
32781,233,124,62,3,44,189
32782,16,7,8,0,1,15
32783,162,116,21,0,25,137
32784,32,18,6,1,7,25
32785,47,30,5,0,12,35
32786,256,195,15,0,46,210
32787,32,21,9,0,2,30
32788,56,15,21,0,20,36
32789,514,258,98,50,108,406
32790,117,43,35,14,25,92
32791,51,22,17,2,10,41
32792,253,189,13,0,51,202
32793,32,0,29,1,2,30
32794,97,36,37,8,16,81
32795,82,21,33,13,15,67
32796,143,61,32,16,34,109
32797,2,0,1,0,1,1
32798,26,5,16,0,5,21
32799,408,302,20,0,86,322
32800,46,18,20,0,8,38
32801,136,54,54,2,26,110
32802,236,155,35,0,46,190
32803,217,163,18,2,34,183
32804,60,39,5,2,14,46
32805,32,21,9,0,2,30
32806,632,371,137,15,109,523
32807,153,63,32,23,35,118
32808,118,55,31,8,24,94
32809,9,4,4,0,1,8
32810,20,5,12,0,3,17
32811,51,25,9,5,12,39
32812,65,33,23,0,9,56
32813,80,44,17,0,19,61
32814,97,16,54,7,20,77
32815,56,35,8,0,13,43
32816,34,8,22,0,4,30
32817,33,19,8,0,6,27
32818,138,61,29,17,31,107
32819,49,33,10,0,6,43
32820,56,11,26,4,15,41
32821,86,38,28,5,15,71
32822,23,9,9,1,4,19
32823,112,45,15,18,34,78
32824,31,12,11,0,8,23
32825,79,43,10,4,22,57
32826,68,38,18,4,8,60
32827,41,24,13,0,4,37
32828,7,4,0,0,3,4
32829,32,21,9,0,2,30
32830,37,7,14,4,12,25
32831,20,7,7,0,6,14
32832,22,13,6,0,3,19
32833,164,61,49,24,30,134
32834,65,43,15,1,6,59
32835,13,6,7,0,0,13
32836,0,0,0,0,0,0
32837,4,3,1,0,0,4
32838,69,21,31,3,14,55
32839,58,14,34,1,9,49
32840,96,43,24,12,17,79
32841,95,21,51,3,20,75
32842,122,55,17,17,33,89
32843,177,125,15,2,35,142
32844,41,10,17,7,7,34
32845,58,33,15,0,10,48
32846,201,86,42,25,48,153
32847,55,38,6,2,9,46
32848,43,7,24,2,10,33
32849,51,13,26,3,9,42
32850,66,43,13,0,10,56
32851,107,47,36,5,19,88
32852,88,42,31,1,14,74
32853,64,22,26,2,14,50
32854,1064,394,426,46,198,866
32855,157,44,50,26,37,120
32856,98,23,53,2,20,78
32857,466,213,159,9,85,381
32858,76,19,37,7,13,63
32859,151,24,98,1,28,123
32860,248,16,185,0,47,201
32861,144,48,46,22,28,116
32862,12,7,2,0,3,9
32863,17,1,10,1,5,12
32864,39,29,5,5,0,39
32865,141,79,39,13,10,131
32866,651,368,156,22,105,546
32867,63,11,41,0,11,52
32868,31,16,3,4,8,23
32869,152,114,3,1,34,118
32870,64,42,7,2,13,51
32871,18,12,1,4,1,17
32872,55,32,15,2,6,49
32873,13,8,2,0,3,10
32874,95,24,55,2,14,81
32875,43,28,1,0,14,29
32876,250,154,37,0,59,191
32877,71,23,20,10,18,53
32878,44,35,2,0,7,37
32879,111,45,9,37,20,91
32880,45,9,21,0,15,30
32881,87,47,24,4,12,75
32882,340,176,95,1,68,272
32883,108,30,60,0,18,90
32884,114,55,38,0,21,93
32885,61,17,30,2,12,49
32886,263,15,196,0,52,211
32887,36,4,22,2,8,28
32888,10,7,1,0,2,8
32889,46,18,20,0,8,38
32890,583,330,112,13,128,455
32891,21,8,7,0,6,15
32892,42,20,17,0,5,37
32893,72,35,21,1,15,57
32894,63,37,16,0,10,53
32895,39,2,18,13,6,33
32896,96,37,27,9,23,73
32897,97,86,2,9,0,97
32898,89,67,5,4,13,76
32899,517,239,121,49,108,409
32900,17,5,2,3,7,10
32901,45,11,28,0,6,39
32902,19,12,4,0,3,16
32903,47,19,19,1,8,39
32904,43,20,15,0,8,35
32905,9,3,5,0,1,8
32906,198,13,148,0,37,161
32907,95,25,54,2,14,81
32908,27,7,11,0,9,18
32909,275,91,125,14,45,230
32910,42,21,11,1,9,33
32911,35,3,21,0,11,24
32912,77,44,17,0,16,61
32913,308,166,70,19,53,255
32914,77,75,0,2,0,77
32915,242,135,53,14,40,202
32916,19,11,5,1,2,17
32917,41,21,17,2,1,40
32918,46,28,8,4,6,40
32919,118,51,40,4,23,95
32920,166,98,38,1,29,137
32921,238,78,109,3,48,190
32922,12,0,8,0,4,8
32923,53,7,29,4,13,40
32924,34,15,4,3,12,22
32925,38,21,12,0,5,33
32926,20,10,7,0,3,17
32927,72,12,48,0,12,60
32928,33,10,17,0,6,27
32929,47,10,26,1,10,37
32930,14,7,5,0,2,12
32931,247,103,15,82,47,200
32932,10,4,6,0,0,10
32933,37,7,10,15,5,32
32934,39,15,19,1,4,35
32935,17,0,14,0,3,14
32936,37,19,11,0,7,30
32937,20,7,12,0,1,19
32938,11,3,3,1,4,7
32939,279,147,87,0,45,234
32940,457,211,99,48,99,358
32941,350,186,93,15,56,294
32942,67,2,39,19,7,60
32943,43,27,15,0,1,42
32944,39,23,8,0,8,31
32945,50,27,12,2,9,41
32946,4,0,4,0,0,4
32947,6,3,2,0,1,5
32948,674,375,165,24,110,564
32949,70,40,8,7,15,55
32950,144,29,87,1,27,117
32951,22,1,12,1,8,14
32952,98,45,26,1,26,72
32953,21,17,1,0,3,18
32954,12,4,5,0,3,9
32955,14,7,4,0,3,11
32956,388,199,114,2,73,315
32957,77,51,17,0,9,68
32958,28,12,6,0,10,18
32959,37,23,6,4,4,33
32960,76,38,19,1,18,58
32961,55,37,2,0,16,39
32962,51,20,20,3,8,43
32963,54,37,6,1,10,44
32964,50,30,10,0,10,40
32965,39,5,27,1,6,33
32966,27,8,10,2,7,20
32967,169,57,82,0,30,139
32968,105,27,27,21,30,75
32969,6,1,5,0,0,6
32970,170,51,40,44,35,135
32971,81,42,9,19,11,70
32972,29,1,20,0,8,21
32973,59,20,33,0,6,53
32974,39,12,18,0,9,30
32975,49,10,30,0,9,40
32976,47,13,23,4,7,40
32977,77,17,36,7,17,60
32978,33,26,3,0,4,29
32979,101,37,35,13,16,85
32980,71,15,39,1,16,55
32981,100,41,40,1,18,82
32982,7,5,0,0,2,5
32983,97,54,18,7,18,79
32984,21,8,9,0,4,17
32985,46,18,20,0,8,38
32986,81,28,35,0,18,63
32987,128,42,46,7,33,95
32988,62,19,22,5,16,46
32989,66,48,3,0,15,51
32990,41,3,23,0,15,26
32991,68,46,7,0,15,53
32992,172,63,74,0,35,137
32993,108,42,36,10,20,88
32994,179,82,55,12,30,149
32995,77,43,20,0,14,63
32996,276,91,126,14,45,231
32997,183,146,9,0,28,155
32998,111,48,33,0,30,81
32999,122,65,28,6,23,99
33000,67,29,23,0,15,52
33001,68,21,34,0,13,55
33002,277,135,82,5,55,222
33003,61,36,12,2,11,50
33004,9,1,3,4,1,8
33005,35,13,8,7,7,28
33006,15,4,8,1,2,13
33007,65,48,12,0,5,60
33008,48,34,2,3,9,39
33009,26,8,5,7,6,20
33010,16,8,5,0,3,13
33011,17,11,4,0,2,15
33012,33,25,1,0,7,26
33013,596,394,73,4,125,471
33014,24,15,4,1,4,20
33015,87,43,24,0,20,67
33016,43,29,3,0,11,32
33017,92,37,23,13,19,73
33018,468,219,148,13,88,380
33019,33,5,7,10,11,22
33020,107,34,44,10,19,88
33021,293,119,121,3,50,243
33022,20,0,14,0,6,14
33023,123,91,6,0,26,97
33024,109,54,35,0,20,89
33025,158,90,33,0,35,123
33026,119,80,12,2,25,94
33027,73,44,14,1,14,59
33028,52,31,2,3,16,36
33029,121,71,26,0,24,97
33030,247,103,14,83,47,200
33031,37,17,10,0,10,27
33032,53,37,10,0,6,47
33033,419,194,128,14,83,336
33034,49,38,1,0,10,39
33035,31,14,8,1,8,23
33036,39,16,9,7,7,32
33037,3,0,3,0,0,3
33038,87,59,10,0,18,69
33039,40,7,21,3,9,31
33040,64,30,21,0,13,51
33041,93,36,37,7,13,80
33042,137,93,24,0,20,117
33043,21,10,7,1,3,18
33044,18,0,14,1,3,15
33045,84,50,16,0,18,66
33046,82,52,5,11,14,68
33047,37,14,16,1,6,31
33048,202,58,109,5,30,172
33049,4,2,2,0,0,4
33050,419,209,128,6,76,343
33051,34,13,13,0,8,26
33052,58,11,33,4,10,48
33053,143,79,14,22,28,115
33054,65,29,26,0,10,55
33055,109,21,64,1,23,86
33056,75,41,19,0,15,60
33057,171,113,27,1,30,141
33058,17,1,12,1,3,14
33059,91,43,31,0,17,74
33060,62,14,34,4,10,52
33061,60,36,13,3,8,52
33062,219,74,82,14,49,170
33063,98,34,40,1,23,75
33064,24,11,10,0,3,21
33065,46,6,24,4,12,34
33066,45,2,36,0,7,38
33067,45,11,23,3,8,37
33068,27,12,11,0,4,23
33069,38,5,23,0,10,28
33070,63,22,9,21,11,52
33071,39,25,7,1,6,33
33072,21,6,1,7,7,14
33073,37,3,25,0,9,28
33074,33,5,22,0,6,27
33075,110,105,0,5,0,110
33076,80,35,23,0,22,58
33077,21,6,9,1,5,16
33078,45,9,25,0,11,34
33079,32,21,9,0,2,30
33080,29,6,15,0,8,21
33081,52,16,13,16,7,45
33082,94,43,14,11,26,68
33083,40,17,13,0,10,30
33084,58,47,0,1,10,48
33085,32,19,8,0,5,27
33086,69,48,9,1,11,58
33087,24,8,12,1,3,21
33088,59,16,28,2,13,46
33089,391,89,173,40,89,302
33090,18,9,3,3,3,15
33091,121,44,33,16,28,93
33092,371,189,87,13,82,289
33093,85,41,21,1,22,63
33094,54,24,19,1,10,44
33095,26,19,3,1,3,23
33096,99,35,39,10,15,84
33097,52,17,18,8,9,43
33098,11,3,5,0,3,8
33099,16,3,9,0,4,12
33100,25,10,10,0,5,20
33101,59,28,16,1,14,45
33102,328,91,154,6,77,251
33103,174,74,60,6,34,140
33104,26,13,6,1,6,20
33105,36,12,20,1,3,33
33106,74,45,9,0,20,54
33107,128,52,25,27,24,104
33108,11,3,6,1,1,10
33109,595,433,40,1,121,474
33110,16,5,11,0,0,16
33111,11,3,5,0,3,8
33112,25,16,3,1,5,20
33113,24,3,19,0,2,22
33114,262,197,13,0,52,210
33115,97,50,29,1,17,80
33116,21,11,6,0,4,17
33117,266,60,141,7,58,208
33118,48,13,19,2,14,34
33119,11,8,0,2,1,10
33120,51,38,1,0,12,39
33121,60,41,12,5,2,58
33122,78,23,36,4,15,63
33123,36,15,11,0,10,26
33124,146,56,47,15,28,118
33125,40,20,10,0,10,30
33126,2,1,0,0,1,1
33127,68,28,19,3,18,50
33128,75,36,21,6,12,63
33129,53,16,18,3,16,37
33130,17,12,2,0,3,14
33131,32,21,9,0,2,30
33132,44,15,19,2,8,36
33133,46,18,20,0,8,38
33134,46,24,7,8,7,39
33135,43,23,2,10,8,35
33136,37,27,0,2,8,29
33137,73,39,13,8,13,60
33138,37,20,11,0,6,31
33139,28,2,12,7,7,21
33140,26,13,11,1,1,25
33141,74,40,16,4,14,60
33142,473,133,198,38,104,369
33143,68,19,21,11,17,51
33144,49,12,32,0,5,44
33145,22,14,2,0,6,16
33146,14,5,4,0,5,9
33147,55,32,15,2,6,49
33148,25,17,4,1,3,22
33149,34,23,7,0,4,30
33150,140,106,5,2,27,113
33151,159,77,48,1,33,126
33152,106,37,25,25,19,87
33153,404,137,160,17,90,314
33154,56,6,41,0,9,47
33155,6,4,1,0,1,5
33156,35,9,16,3,7,28
33157,202,108,61,0,33,169
33158,200,40,55,65,40,160
33159,91,26,41,5,19,72
33160,56,22,12,8,14,42
33161,243,101,14,83,45,198
33162,71,34,12,7,18,53
33163,36,4,26,2,4,32
33164,39,12,18,0,9,30
33165,32,21,9,0,2,30
33166,13,6,7,0,0,13
33167,216,75,94,2,45,171
33168,181,101,32,1,47,134
33169,34,8,20,4,2,32
33170,644,371,151,17,105,539
33171,90,29,32,11,18,72
33172,79,36,21,3,19,60
33173,12,1,9,0,2,10
33174,37,14,14,1,8,29
33175,91,29,46,0,16,75
33176,46,18,20,0,8,38
33177,12,4,7,0,1,11
33178,77,24,31,9,13,64
33179,56,38,7,1,10,46
33180,32,21,9,0,2,30
33181,200,48,103,14,35,165
33182,31,2,20,2,7,24
33183,26,8,10,0,8,18
33184,41,3,29,2,7,34
33185,53,27,9,2,15,38
33186,40,29,0,2,9,31
33187,283,178,42,0,63,220
33188,8,0,7,0,1,7
33189,58,31,12,0,15,43
33190,111,38,43,11,19,92
33191,357,193,90,15,59,298
33192,385,223,82,15,65,320
33193,115,32,32,27,24,91
33194,267,61,64,86,56,211
33195,92,66,7,0,19,73
33196,35,24,3,2,6,29
33197,424,313,20,0,91,333
33198,10,8,0,0,2,8
33199,68,23,21,1,23,45
33200,47,12,21,4,10,37
33201,150,80,31,7,32,118
33202,37,12,12,6,7,30
33203,55,32,15,2,6,49
33204,40,31,2,0,7,33
33205,30,6,16,0,8,22
33206,8,4,0,0,4,4
33207,45,18,19,0,8,37
33208,22,10,6,0,6,16
33209,120,60,40,9,11,109
33210,9,5,3,0,1,8
33211,23,4,3,10,6,17
33212,19,3,13,0,3,16
33213,241,105,75,17,44,197
33214,145,64,46,13,22,123
33215,49,26,7,8,8,41
33216,237,111,72,0,54,183
33217,20,12,1,2,5,15
33218,42,10,27,0,5,37
33219,16,6,2,3,5,11
33220,59,38,11,0,10,49
33221,48,16,20,0,12,36
33222,98,26,56,2,14,84
33223,58,41,7,0,10,48
33224,46,18,20,0,8,38
33225,179,134,3,2,40,139
33226,129,61,35,0,33,96
33227,50,7,29,0,14,36
33228,15,4,5,0,6,9
33229,99,43,33,4,19,80
33230,288,204,25,0,59,229
33231,682,402,139,21,120,562
33232,20,2,14,0,4,16
33233,205,50,40,78,37,168
33234,257,110,87,16,44,213
33235,9,1,6,0,2,7
33236,9,5,1,0,3,6
33237,79,45,18,2,14,65
33238,116,48,15,17,36,80
33239,19,1,12,3,3,16
33240,46,18,20,0,8,38
33241,23,2,19,0,2,21
33242,47,20,16,2,9,38
33243,33,3,5,17,8,25
33244,25,5,17,0,3,22
33245,81,35,32,0,14,67
33246,55,24,13,6,12,43
33247,12,3,6,0,3,9
33248,53,37,2,0,14,39
33249,28,6,7,6,9,19
33250,264,178,20,4,62,202
33251,120,60,38,0,22,98
33252,38,17,13,1,7,31
33253,84,24,37,6,17,67
33254,24,11,6,3,4,20
33255,55,37,7,1,10,45
33256,28,7,6,6,9,19
33257,96,27,40,4,25,71
33258,24,3,19,0,2,22
33259,65,25,6,17,17,48
33260,61,30,3,14,14,47
33261,9,7,0,0,2,7
33262,64,17,22,8,17,47
33263,235,112,68,4,51,184
33264,556,393,46,1,116,440
33265,169,121,7,3,38,131
33266,18,0,6,9,3,15
33267,19,11,5,0,3,16
33268,75,25,24,14,12,63
33269,444,210,142,11,81,363
33270,53,17,20,3,13,40
33271,120,88,7,4,21,99
33272,91,23,50,2,16,75
33273,44,7,27,4,6,38
33274,32,7,14,3,8,24
33275,14,2,11,0,1,13
33276,209,113,32,23,41,168
33277,8,5,1,1,1,7
33278,37,7,10,15,5,32
33279,101,27,55,0,19,82
33280,40,18,8,6,8,32
33281,154,50,75,0,29,125
33282,102,61,19,6,16,86
33283,5,0,3,0,2,3
33284,32,8,14,3,7,25
33285,24,9,7,2,6,18
33286,259,107,92,16,44,215
33287,15,4,9,0,2,13
33288,106,68,4,9,25,81
33289,56,32,13,2,9,47
33290,42,22,11,0,9,33
33291,9,0,8,0,1,8
33292,55,33,9,0,13,42
33293,6,6,0,0,0,6
33294,81,23,43,1,14,67
33295,67,49,3,0,15,52
33296,75,40,15,2,18,57
33297,37,21,7,3,6,31
33298,16,5,8,2,1,15
33299,42,11,19,2,10,32
33300,92,20,31,22,19,73
33301,118,30,46,10,32,86
33302,106,39,34,13,20,86
33303,66,38,3,13,12,54
33304,99,52,21,7,19,80
33305,65,21,26,7,11,54
33306,168,116,14,0,38,130
33307,162,115,11,0,36,126
33308,113,7,59,24,23,90
33309,34,12,10,4,8,26
33310,57,26,9,9,13,44
33311,20,4,7,3,6,14
33312,41,13,17,2,9,32
33313,27,2,15,5,5,22
33314,586,410,49,1,126,460
33315,87,58,19,1,9,78
33316,44,35,2,0,7,37
33317,138,107,7,2,22,116
33318,68,26,32,0,10,58
33319,55,12,27,2,14,41
33320,55,32,15,2,6,49
33321,23,9,5,2,7,16
33322,115,61,21,10,23,92
33323,56,33,15,0,8,48
33324,24,9,7,2,6,18
33325,57,15,4,27,11,46
33326,146,61,55,8,22,124
33327,140,67,41,10,22,118
33328,81,40,23,4,14,67
33329,36,11,16,1,8,28
33330,60,29,11,9,11,49
33331,349,185,89,15,60,289
33332,5,2,3,0,0,5
33333,52,13,24,3,12,40
33334,91,39,31,1,20,71
33335,121,43,42,12,24,97
33336,55,33,10,0,12,43
33337,290,141,84,4,61,229
33338,257,192,17,0,48,209
33339,18,4,9,0,5,13
33340,29,14,12,0,3,26
33341,54,26,13,2,13,41
33342,38,17,10,4,7,31
33343,52,25,17,2,8,44
33344,55,25,13,5,12,43
33345,14,4,7,0,3,11
33346,171,88,33,20,30,141
33347,10,0,6,0,4,6
33348,15,6,3,4,2,13
33349,8,4,1,2,1,7
33350,39,13,24,0,2,37
33351,78,36,26,0,16,62
33352,14,3,6,0,5,9
33353,113,44,11,38,20,93
33354,359,159,124,6,70,289
33355,274,130,92,4,48,226
33356,46,18,20,0,8,38
33357,362,211,78,14,59,303
33358,173,110,41,14,8,165
33359,90,26,37,6,21,69
33360,15,3,4,4,4,11
33361,52,17,21,2,12,40
33362,37,19,11,0,7,30
33363,143,98,24,1,20,123
33364,45,26,10,0,9,36
33365,123,66,13,14,30,93
33366,54,26,21,0,7,47
33367,78,46,19,0,13,65
33368,12,5,4,0,3,9
33369,189,88,47,16,38,151
33370,58,26,23,2,7,51
33371,88,58,12,1,17,71
33372,15,3,5,1,6,9
33373,15,13,1,0,1,14
33374,342,145,121,6,70,272
33375,55,33,10,0,12,43
33376,46,13,22,0,11,35
33377,282,76,34,126,46,236
33378,110,39,48,8,15,95
33379,40,25,4,0,11,29
33380,84,11,50,4,19,65
33381,19,4,8,2,5,14
33382,59,26,26,0,7,52
33383,37,7,14,4,12,25
33384,42,5,28,0,9,33
33385,22,16,1,0,5,17
33386,59,19,30,0,10,49
33387,68,3,56,0,9,59
33388,35,13,13,1,8,27
33389,173,56,86,0,31,142
33390,161,94,37,1,29,132
33391,30,22,0,0,8,22
33392,79,36,5,16,22,57
33393,2,1,1,0,0,2
33394,32,21,9,0,2,30
33395,32,21,9,0,2,30
33396,361,160,125,6,70,291
33397,62,22,29,1,10,52
33398,207,70,91,2,44,163
33399,38,8,20,0,10,28
33400,315,132,116,6,61,254
33401,30,6,14,2,8,22
33402,32,21,9,0,2,30
33403,65,34,15,4,12,53
33404,66,33,11,7,15,51
33405,4,1,2,0,1,3
33406,72,46,8,2,16,56
33407,94,56,19,4,15,79
33408,99,35,34,6,24,75
33409,49,27,8,4,10,39
33410,278,73,150,1,54,224
33411,214,14,162,0,38,176
33412,40,22,7,4,7,33
33413,1,0,1,0,0,1
33414,134,53,40,15,26,108
33415,31,12,7,6,6,25
33416,34,7,17,2,8,26
33417,10,7,3,0,0,10
33418,60,41,5,1,13,47
33419,223,171,8,0,44,179
33420,15,8,3,0,4,11
33421,114,67,26,3,18,96
33422,113,34,40,15,24,89
33423,43,5,29,0,9,34
33424,37,21,6,2,8,29
33425,23,4,3,10,6,17
33426,124,52,46,1,25,99
33427,7,5,2,0,0,7
33428,16,8,4,0,4,12
33429,82,55,13,0,14,68
33430,163,86,41,6,30,133
33431,139,51,41,20,27,112
33432,43,15,18,2,8,35
33433,75,34,28,0,13,62
33434,180,92,51,0,37,143
33435,118,33,62,0,23,95
33436,330,222,36,1,71,259
33437,246,102,15,82,47,199
33438,53,6,34,0,13,40
33439,383,222,68,16,77,306
33440,399,233,83,17,66,333
33441,76,43,14,3,16,60
33442,20,13,2,1,4,16
33443,31,13,14,0,4,27
33444,25,10,6,0,9,16
33445,35,16,8,2,9,26
33446,54,12,24,1,17,37
33447,34,20,7,0,7,27
33448,533,293,116,13,111,422
33449,4,2,2,0,0,4
33450,191,137,15,2,37,154
33451,156,45,84,4,23,133
33452,88,46,19,2,21,67
33453,80,61,5,4,10,70
33454,118,45,41,11,21,97
33455,26,12,5,0,9,17
33456,71,33,21,2,15,56
33457,212,93,86,5,28,184
33458,10,3,3,0,4,6
33459,78,47,11,2,18,60
33460,77,16,35,12,14,63
33461,26,19,4,0,3,23
33462,629,367,137,15,110,519
33463,123,39,33,28,23,100
33464,23,16,5,2,0,23
33465,399,183,134,11,71,328
33466,14,3,4,4,3,11
33467,58,14,34,1,9,49
33468,12,5,7,0,0,12
33469,54,16,19,7,12,42
33470,14,6,2,0,6,8
33471,21,13,1,3,4,17
33472,200,51,46,70,33,167
33473,218,91,14,76,37,181
33474,223,171,8,0,44,179
33475,13,5,6,0,2,11
33476,24,5,13,0,6,18
33477,98,39,4,42,13,85
33478,5,1,1,0,3,2
33479,46,19,16,2,9,37
33480,90,29,18,23,20,70
33481,143,60,54,0,29,114
33482,141,79,40,13,9,132
33483,134,55,28,21,30,104
33484,85,34,30,6,15,70
33485,87,41,26,2,18,69
33486,98,33,37,7,21,77
33487,109,48,30,11,20,89
33488,9,3,2,0,4,5
33489,51,30,2,9,10,41
33490,15,3,9,1,2,13
33491,57,41,10,5,1,56
33492,58,20,23,4,11,47
33493,57,30,13,0,14,43
33494,41,3,29,0,9,32
33495,12,2,9,0,1,11
33496,29,4,20,0,5,24
33497,69,34,25,1,9,60
33498,120,54,16,18,32,88
33499,63,29,16,5,13,50
33500,31,0,10,16,5,26
33501,38,20,8,1,9,29
33502,34,4,26,0,4,30
33503,32,21,9,0,2,30
33504,223,116,52,13,42,181
33505,418,200,111,20,87,331
33506,42,8,25,3,6,36
33507,18,8,6,0,4,14
33508,109,33,62,0,14,95
33509,4,1,1,2,0,4
33510,32,7,15,1,9,23
33511,22,9,8,1,4,18
33512,41,7,26,4,4,37
33513,65,35,3,15,12,53
33514,92,24,43,16,9,83
33515,49,24,3,14,8,41
33516,7,3,1,0,3,4
33517,31,2,21,0,8,23
33518,11,6,3,0,2,9
33519,14,12,1,0,1,13
33520,311,143,109,2,57,254
33521,407,213,111,17,66,341
33522,190,142,14,1,33,157
33523,147,64,54,0,29,118
33524,33,0,27,0,6,27
33525,2,1,0,1,0,2
33526,14,8,3,0,3,11
33527,39,15,17,3,4,35
33528,2,2,0,0,0,2
33529,40,25,10,1,4,36
33530,27,15,9,0,3,24
33531,45,23,3,11,8,37
33532,72,36,11,7,18,54
33533,27,14,10,0,3,24
33534,22,5,11,1,5,17
33535,16,9,3,0,4,12
33536,32,21,9,0,2,30
33537,138,34,46,29,29,109
33538,71,39,23,2,7,64
33539,236,75,110,12,39,197
33540,18,8,6,0,4,14
33541,172,84,31,26,31,141
33542,106,33,53,7,13,93
33543,31,15,9,2,5,26
33544,472,275,64,37,96,376
33545,119,80,20,9,10,109
33546,175,47,56,37,35,140
33547,396,227,88,0,81,315
33548,38,17,16,0,5,33
33549,27,18,5,1,3,24
33550,230,161,51,3,15,215
33551,6,3,2,0,1,5
33552,10,2,3,0,5,5
33553,146,13,100,2,31,115
33554,22,10,11,0,1,21
33555,146,43,45,22,36,110
33556,660,386,141,17,116,544
33557,640,357,157,23,103,537
33558,118,61,24,11,22,96
33559,36,9,16,3,8,28
33560,7,7,0,0,0,7
33561,14,4,2,3,5,9
33562,301,140,96,11,54,247
33563,83,54,16,0,13,70
33564,32,21,9,0,2,30
33565,113,25,41,25,22,91
33566,43,15,18,1,9,34
33567,28,6,17,0,5,23
33568,83,26,41,5,11,72
33569,121,43,51,6,21,100
33570,98,66,9,3,20,78
33571,81,40,20,0,21,60
33572,28,16,7,0,5,23
33573,86,45,9,10,22,64
33574,55,32,7,0,16,39
33575,66,50,11,0,5,61
33576,49,13,27,1,8,41
33577,23,17,0,0,6,17
33578,0,0,0,0,0,0
33579,46,18,20,0,8,38
33580,90,41,5,32,12,78
33581,351,188,93,15,55,296
33582,29,11,15,0,3,26
33583,7,1,4,0,2,5
33584,130,61,41,3,25,105
33585,27,15,5,0,7,20
33586,47,30,9,0,8,39
33587,473,226,151,13,83,390
33588,158,74,28,19,37,121
33589,74,49,11,1,13,61
33590,41,23,14,0,4,37
33591,148,61,32,20,35,113
33592,151,86,38,1,26,125
33593,121,47,54,0,20,101
33594,41,18,16,0,7,34
33595,55,33,13,0,9,46
33596,225,48,116,4,57,168
33597,33,22,8,0,3,30
33598,63,5,44,0,14,49
33599,244,108,75,18,43,201
33600,6,1,3,0,2,4
33601,0,0,0,0,0,0
33602,319,162,88,15,54,265
33603,471,226,113,30,102,369
33604,466,218,144,12,92,374
33605,468,235,86,42,105,363
33606,43,14,22,1,6,37
33607,269,190,17,4,58,211
33608,224,123,31,26,44,180
33609,19,3,15,0,1,18
33610,61,31,18,0,12,49
33611,60,31,10,2,17,43
33612,50,29,11,1,9,41
33613,25,16,2,0,7,18
33614,159,70,53,5,31,128
33615,28,19,6,0,3,25
33616,24,8,12,1,3,21
33617,23,10,10,1,2,21
33618,150,95,29,0,26,124
33619,29,12,14,0,3,26
33620,26,10,8,4,4,22
33621,56,34,13,0,9,47
33622,12,9,3,0,0,12
33623,57,11,26,6,14,43
33624,168,115,17,0,36,132
33625,109,45,23,17,24,85
33626,138,72,37,0,29,109
33627,160,105,24,1,30,130
33628,79,36,29,4,10,69
33629,88,50,15,4,19,69
33630,165,97,38,1,29,136
33631,62,29,25,2,6,56
33632,58,12,36,1,9,49
33633,2,0,1,0,1,1
33634,699,397,165,23,114,585
33635,45,31,1,0,13,32
33636,100,56,23,0,21,79
33637,19,2,12,0,5,14
33638,29,9,11,0,9,20
33639,195,92,63,0,40,155
33640,38,27,0,1,10,28
33641,136,73,25,10,28,108
33642,27,6,17,3,1,26
33643,12,6,3,0,3,9
33644,45,21,15,3,6,39
33645,9,3,4,0,2,7
33646,231,122,35,29,45,186
33647,50,21,13,1,15,35
33648,63,47,12,0,4,59
33649,58,36,14,0,8,50
33650,79,39,21,3,16,63
33651,89,38,32,1,18,71
33652,453,232,113,12,96,357
33653,45,20,14,2,9,36
33654,37,23,9,2,3,34
33655,30,15,6,1,8,22
33656,32,16,10,0,6,26
33657,215,14,164,0,37,178
33658,32,21,9,0,2,30
33659,160,92,21,19,28,132
33660,5,1,3,0,1,4
33661,164,81,49,2,32,132
33662,42,23,9,0,10,32
33663,0,0,0,0,0,0
33664,83,46,13,0,24,59
33665,243,164,58,4,17,226
33666,78,49,13,8,8,70
33667,49,21,12,4,12,37
33668,152,40,69,4,39,113
33669,129,92,7,2,28,101
33670,70,45,13,0,12,58
33671,118,36,44,14,24,94
33672,391,200,116,2,73,318
33673,75,28,33,1,13,62
33674,72,25,21,16,10,62
33675,49,27,13,2,7,42
33676,48,10,27,1,10,38
33677,47,21,9,5,12,35
33678,74,45,10,4,15,59
33679,17,4,11,1,1,16
33680,32,24,2,0,6,26
33681,47,20,13,6,8,39
33682,26,7,14,0,5,21
33683,117,60,21,13,23,94
33684,428,237,93,11,87,341
33685,84,17,44,9,14,70
33686,148,60,45,9,34,114
33687,70,46,10,0,14,56
33688,42,26,7,3,6,36
33689,41,11,19,1,10,31
33690,226,97,15,76,38,188
33691,144,76,31,7,30,114
33692,13,5,4,0,4,9
33693,16,10,2,0,4,12
33694,124,44,36,15,29,95
33695,35,0,31,1,3,32
33696,33,2,23,0,8,25
33697,38,16,10,0,12,26
33698,31,0,10,16,5,26
33699,57,20,25,0,12,45
33700,78,28,17,17,16,62
33701,56,37,12,0,7,49
33702,635,372,138,15,110,525
33703,3,1,1,0,1,2
33704,80,48,17,3,12,68
33705,150,62,33,19,36,114
33706,167,59,62,18,28,139
33707,86,22,38,9,17,69
33708,30,19,4,0,7,23
33709,155,49,52,22,32,123
33710,13,7,2,0,4,9
33711,261,200,12,0,49,212
33712,37,27,1,2,7,30
33713,30,21,4,0,5,25
33714,206,78,54,29,45,161
33715,84,17,41,9,17,67
33716,41,5,27,0,9,32
33717,76,19,26,15,16,60
33718,89,19,42,17,11,78
33719,20,2,10,0,8,12
33720,33,9,16,0,8,25
33721,234,60,31,103,40,194
33722,173,58,68,12,35,138
33723,82,33,8,18,23,59
33724,242,101,15,82,44,198
33725,22,8,8,0,6,16
33726,38,9,23,3,3,35
33727,531,267,114,38,112,419
33728,477,222,156,11,88,389
33729,62,31,12,9,10,52
33730,53,33,9,2,9,44
33731,94,44,22,7,21,73
33732,13,1,10,0,2,11
33733,83,35,33,4,11,72
33734,379,94,154,47,84,295
33735,11,5,6,0,0,11
33736,46,18,20,0,8,38
33737,32,6,16,4,6,26
33738,56,30,14,0,12,44
33739,510,270,90,44,106,404
33740,160,88,21,22,29,131
33741,20,4,14,0,2,18
33742,11,5,2,0,4,7
33743,12,6,2,1,3,9
33744,129,53,33,19,24,105
33745,122,44,17,39,22,100
33746,7,1,3,0,3,4
33747,613,409,66,4,134,479
33748,78,44,18,2,14,64
33749,60,13,7,29,11,49
33750,65,21,22,11,11,54
33751,14,4,6,0,4,10
33752,500,278,120,19,83,417
33753,295,95,134,5,61,234
33754,81,32,36,0,13,68
33755,7,3,4,0,0,7
33756,182,116,13,12,41,141
33757,44,15,17,0,12,32
33758,247,103,15,82,47,200
33759,59,16,31,0,12,47
33760,45,22,14,1,8,37
33761,15,4,5,0,6,9
33762,25,17,1,0,7,18
33763,14,5,3,1,5,9
33764,61,32,12,0,17,44
33765,44,34,0,0,10,34
33766,110,46,22,15,27,83
33767,135,85,15,9,26,109
33768,86,34,15,16,21,65
33769,19,12,4,1,2,17
33770,226,88,14,81,43,183
33771,22,14,3,0,5,17
33772,56,18,11,16,11,45
33773,56,17,30,0,9,47
33774,34,12,13,0,9,25
33775,51,17,26,0,8,43
33776,84,35,9,22,18,66
33777,51,21,19,1,10,41
33778,95,34,33,2,26,69
33779,650,363,157,24,106,544
33780,123,47,44,16,16,107
33781,4,4,0,0,0,4
33782,60,14,5,31,10,50
33783,42,16,16,0,10,32
33784,153,66,47,9,31,122
33785,34,24,0,0,10,24
33786,12,2,8,1,1,11
33787,68,15,35,7,11,57
33788,302,153,102,0,47,255
33789,26,1,16,0,9,17
33790,101,67,1,12,21,80
33791,71,49,4,0,18,53
33792,19,15,2,0,2,17
33793,44,13,10,11,10,34
33794,7,1,5,0,1,6
33795,49,23,17,0,9,40
33796,117,53,48,3,13,104
33797,111,45,9,37,20,91
33798,42,35,2,0,5,37
33799,28,14,5,1,8,20
33800,32,21,9,0,2,30
33801,58,14,36,0,8,50
33802,22,1,14,4,3,19
33803,264,61,138,7,58,206
33804,183,86,47,15,35,148
33805,60,4,47,0,9,51
33806,44,11,25,1,7,37
33807,65,16,18,15,16,49
33808,44,35,2,0,7,37
33809,48,17,15,0,16,32
33810,80,37,5,15,23,57
33811,138,40,66,1,31,107
33812,32,16,8,3,5,27
33813,22,11,8,1,2,20
33814,37,25,4,0,8,29
33815,16,6,5,0,5,11
33816,54,25,16,0,13,41
33817,317,121,97,32,67,250
33818,397,235,80,15,67,330
33819,31,7,17,1,6,25
33820,546,255,129,43,119,427
33821,20,10,5,0,5,15
33822,22,0,18,2,2,20
33823,8,4,4,0,0,8
33824,591,381,83,4,123,468
33825,15,1,13,0,1,14
33826,84,16,52,1,15,69
33827,13,10,1,0,2,11
33828,52,28,14,0,10,42
33829,236,102,15,77,42,194
33830,60,24,24,1,11,49
33831,76,42,19,0,15,61
33832,12,3,8,0,1,11
33833,69,29,26,1,13,56
33834,41,13,19,2,7,34
33835,79,43,10,6,20,59
33836,58,40,6,1,11,47
33837,142,56,30,25,31,111
33838,47,28,11,0,8,39
33839,116,64,31,0,21,95
33840,106,25,51,4,26,80
33841,54,37,4,1,12,42
33842,153,100,30,0,23,130
33843,168,84,48,0,36,132
33844,67,23,28,2,14,53
33845,68,51,6,0,11,57
33846,105,87,3,3,12,93
33847,24,10,9,3,2,22
33848,59,31,18,0,10,49
33849,93,56,16,5,16,77
33850,9,0,8,0,1,8
33851,5,1,2,0,2,3
33852,19,7,10,0,2,17
33853,36,17,12,0,7,29
33854,8,0,4,0,4,4
33855,46,18,20,0,8,38
33856,30,17,6,2,5,25
33857,10,2,6,0,2,8
33858,97,52,26,2,17,80
33859,89,46,12,2,29,60
33860,219,161,12,2,44,175
33861,20,18,0,0,2,18
33862,90,41,27,3,19,71
33863,87,62,4,2,19,68
33864,16,0,10,2,4,12
33865,75,36,21,1,17,58
33866,52,8,28,3,13,39
33867,26,4,15,4,3,23
33868,101,59,19,6,17,84
33869,507,365,34,1,107,400
33870,187,72,44,30,41,146
33871,174,48,54,37,35,139
33872,15,6,7,0,2,13
33873,13,3,6,1,3,10
33874,33,9,16,0,8,25
33875,46,36,3,0,7,39
33876,55,31,12,2,10,45
33877,91,48,21,5,17,74
33878,38,10,21,0,7,31
33879,26,9,12,1,4,22
33880,675,392,153,18,112,563
33881,29,17,5,3,4,25
33882,59,19,16,5,19,40
33883,61,45,5,4,7,54
33884,36,15,12,0,9,27
33885,283,102,124,14,43,240
33886,149,49,47,23,30,119
33887,35,7,23,0,5,30
33888,98,48,17,2,31,67
33889,114,51,43,1,19,95
33890,45,23,18,0,4,41
33891,264,177,66,3,18,246
33892,32,21,9,0,2,30
33893,31,0,26,0,5,26
33894,7,5,0,0,2,5
33895,80,37,23,2,18,62
33896,169,91,28,20,30,139
33897,35,25,5,5,0,35
33898,96,52,19,6,19,77
33899,17,10,3,0,4,13
33900,17,1,10,1,5,12
33901,30,14,7,4,5,25
33902,16,11,1,2,2,14
33903,461,169,151,41,100,361
33904,32,3,19,2,8,24
33905,0,0,0,0,0,0
33906,99,89,1,9,0,99
33907,688,405,142,19,122,566
33908,51,10,26,1,14,37
33909,32,21,9,0,2,30
33910,29,2,22,0,5,24
33911,82,55,9,3,15,67
33912,30,9,15,3,3,27
33913,33,7,21,0,5,28
33914,218,117,34,22,45,173
33915,0,0,0,0,0,0
33916,35,10,13,1,11,24
33917,46,23,4,6,13,33
33918,49,20,17,0,12,37
33919,65,21,29,1,14,51
33920,43,13,20,2,8,35
33921,193,88,47,20,38,155
33922,213,117,45,14,37,176
33923,57,25,15,4,13,44
33924,89,32,36,2,19,70
33925,32,8,11,6,7,25
33926,27,9,15,0,3,24
33927,228,145,63,3,17,211
33928,116,32,46,10,28,88
33929,16,11,3,0,2,14
33930,36,4,24,3,5,31
33931,15,4,9,0,2,13
33932,238,103,46,30,59,179
33933,14,3,9,0,2,12
33934,111,23,53,14,21,90
33935,146,114,5,0,27,119
33936,18,5,11,0,2,16
33937,16,10,4,0,2,14
33938,42,21,10,3,8,34
33939,23,7,13,0,3,20
33940,233,155,32,0,46,187
33941,567,402,46,1,118,449
33942,30,13,9,0,8,22
33943,17,9,0,3,5,12
33944,0,0,0,0,0,0
33945,35,16,10,3,6,29
33946,38,18,9,1,10,28
33947,31,11,14,0,6,25
33948,15,6,3,4,2,13
33949,72,38,16,6,12,60
33950,29,9,7,10,3,26
33951,95,42,27,1,25,70
33952,39,2,19,12,6,33
33953,207,119,46,7,35,172
33954,62,38,13,1,10,52
33955,62,14,35,3,10,52
33956,27,8,12,1,6,21
33957,6,0,6,0,0,6
33958,53,13,25,2,13,40
33959,37,23,9,0,5,32
33960,8,0,7,0,1,7
33961,46,18,20,0,8,38
33962,266,199,15,0,52,214
33963,38,2,31,0,5,33
33964,124,56,34,8,26,98
33965,178,91,50,0,37,141
33966,101,36,44,8,13,88
33967,26,9,6,3,8,18
33968,15,6,7,0,2,13
33969,2,1,0,0,1,1
33970,81,43,5,17,16,65
33971,31,0,10,16,5,26
33972,453,223,121,14,95,358
33973,193,103,32,21,37,156
33974,28,12,9,1,6,22
33975,33,23,7,1,2,31
33976,4,2,1,0,1,3
33977,11,3,6,0,2,9
33978,151,58,38,25,30,121
33979,35,13,12,0,10,25
33980,126,54,20,18,34,92
33981,25,9,10,2,4,21
33982,32,16,7,4,5,27
33983,321,194,58,0,69,252
33984,73,29,33,1,10,63
33985,146,59,31,26,30,116
33986,53,14,20,0,19,34
33987,281,71,157,1,52,229
33988,41,16,17,0,8,33
33989,16,6,6,0,4,12
33990,28,5,15,2,6,22
33991,73,52,7,3,11,62
33992,461,134,193,35,99,362
33993,336,108,141,16,71,265
33994,55,17,25,2,11,44
33995,55,38,6,1,10,45
33996,94,33,30,5,26,68
33997,12,3,7,0,2,10
33998,14,6,8,0,0,14
33999,175,87,55,6,27,148
34000,117,53,26,13,25,92
34001,68,35,10,7,16,52
34002,188,74,43,30,41,147
34003,541,253,127,44,117,424
34004,7,1,5,0,1,6
34005,39,9,11,7,12,27
34006,52,20,14,3,15,37
34007,37,23,7,1,6,31
34008,163,91,36,0,36,127
34009,168,115,15,0,38,130
34010,55,34,6,1,14,41
34011,466,173,150,44,99,367
34012,66,24,26,2,14,52
34013,112,46,30,12,24,88
34014,84,47,19,1,17,67
34015,114,35,65,0,14,100
34016,40,11,17,2,10,30
34017,125,46,26,21,32,93
34018,74,36,21,7,10,64
34019,35,4,6,20,5,30
34020,83,49,18,0,16,67
34021,51,13,25,3,10,41
34022,81,44,14,5,18,63
34023,306,139,100,11,56,250
34024,114,25,57,2,30,84
34025,42,26,10,0,6,36
34026,153,67,30,23,33,120
34027,28,26,0,0,2,26
34028,32,21,9,0,2,30
34029,280,118,99,17,46,234
34030,19,3,5,8,3,16
34031,18,10,4,0,4,14
34032,26,13,12,0,1,25
34033,303,154,81,15,53,250
34034,125,50,39,14,22,103
34035,91,47,7,17,20,71
34036,53,12,32,0,9,44
34037,32,21,3,0,8,24
34038,82,37,19,12,14,68
34039,113,63,20,5,25,88
34040,159,71,52,5,31,128
34041,81,38,29,4,10,71
34042,294,79,33,133,49,245
34043,25,8,11,2,4,21
34044,67,40,8,7,12,55
34045,154,68,25,24,37,117
34046,33,5,23,1,4,29
34047,44,16,16,0,12,32
34048,92,48,27,3,14,78
34049,100,51,27,5,17,83
34050,109,47,22,15,25,84
34051,7,6,0,0,1,6
34052,36,21,7,0,8,28
34053,165,100,51,1,13,152
34054,361,102,139,34,86,275
34055,126,47,52,12,15,111
34056,108,52,41,2,13,95
34057,127,75,21,3,28,99
34058,69,7,51,0,11,58
34059,3,2,1,0,0,3
34060,71,26,17,14,14,57
34061,323,154,90,11,68,255
34062,40,1,33,0,6,34
34063,103,25,54,3,21,82
34064,87,46,16,5,20,67
34065,76,46,9,11,10,66
34066,266,181,63,2,20,246
34067,40,24,8,0,8,32
34068,12,1,9,0,2,10
34069,56,3,40,1,12,44
34070,445,143,182,19,101,344
34071,14,2,8,2,2,12
34072,20,3,12,1,4,16
34073,32,21,9,0,2,30
34074,78,32,23,7,16,62
34075,196,109,28,23,36,160
34076,69,39,18,0,12,57
34077,37,10,15,0,12,25
34078,4,2,1,0,1,3
34079,186,87,42,19,38,148
34080,114,56,19,12,27,87
34081,32,21,9,0,2,30
34082,322,246,19,0,57,265
34083,101,47,15,24,15,86
34084,283,178,42,0,63,220
34085,44,28,11,0,5,39
34086,60,14,40,0,6,54
34087,18,10,5,0,3,15
34088,335,92,160,6,77,258
34089,75,27,33,1,14,61
34090,79,31,34,4,10,69
34091,10,7,1,0,2,8
34092,206,18,148,2,38,168
34093,46,16,16,0,14,32
34094,35,15,10,5,5,30
34095,31,16,4,4,7,24
34096,306,81,146,6,73,233
34097,327,238,18,0,71,256
34098,87,53,19,0,15,72
34099,53,15,27,0,11,42
34100,2,2,0,0,0,2
34101,34,17,12,3,2,32
34102,13,6,7,0,0,13
34103,62,26,27,0,9,53
34104,40,16,9,8,7,33
34105,74,31,23,8,12,62
34106,18,7,6,0,5,13
34107,48,30,6,0,12,36
34108,92,66,7,0,19,73
34109,43,12,24,0,7,36
34110,345,202,68,0,75,270
34111,183,146,9,0,28,155
34112,99,45,7,23,24,75
34113,553,382,54,1,116,437
34114,55,38,6,1,10,45
34115,82,27,31,11,13,69
34116,4,2,2,0,0,4
34117,31,9,12,0,10,21
34118,26,10,11,0,5,21
34119,344,186,88,15,55,289
34120,659,383,142,18,116,543
34121,32,21,9,0,2,30
34122,114,48,39,1,26,88
34123,42,21,13,3,5,37
34124,371,201,100,3,67,304
34125,170,125,19,0,26,144
34126,73,7,43,9,14,59
34127,32,21,9,0,2,30
34128,132,40,56,8,28,104
34129,102,24,46,11,21,81
34130,32,16,11,0,5,27
34131,32,21,9,0,2,30
34132,19,5,5,2,7,12
34133,249,107,81,17,44,205
34134,56,34,16,2,4,52
34135,47,34,4,3,6,41
34136,72,35,17,0,20,52
34137,39,35,0,0,4,35
34138,44,2,27,7,8,36
34139,62,16,22,5,19,43
34140,128,39,48,20,21,107
34141,53,14,17,15,7,46
34142,125,37,48,19,21,104
34143,46,18,20,0,8,38
34144,31,5,16,1,9,22
34145,109,38,27,23,21,88
34146,56,34,14,0,8,48
34147,122,45,44,9,24,98
34148,290,20,212,2,56,234
34149,106,83,8,0,15,91
34150,68,31,20,0,17,51
34151,329,197,60,0,72,257
34152,35,22,3,4,6,29
34153,72,25,27,6,14,58
34154,451,140,187,26,98,353
34155,100,46,15,24,15,85
34156,35,15,13,0,7,28
34157,35,9,15,0,11,24
34158,475,218,157,13,87,388
34159,81,26,39,2,14,67
34160,267,82,125,17,43,224
34161,44,25,8,3,8,36
34162,394,204,101,20,69,325
34163,116,72,16,3,25,91
34164,99,41,32,10,16,83
34165,46,18,20,0,8,38
34166,86,6,49,14,17,69
34167,94,47,14,2,31,63
34168,89,51,21,4,13,76
34169,343,134,117,23,69,274
34170,75,16,35,8,16,59
34171,96,60,20,0,16,80
34172,17,4,11,0,2,15
34173,72,15,38,6,13,59
34174,49,32,6,2,9,40
34175,18,9,5,0,4,14
34176,37,10,16,0,11,26
34177,73,49,7,1,16,57
34178,84,25,41,1,17,67
34179,95,60,9,5,21,74
34180,2,0,2,0,0,2
34181,33,24,5,0,4,29
34182,428,202,120,14,92,336
34183,362,160,120,11,71,291
34184,62,37,7,2,16,46
34185,76,38,17,2,19,57
34186,85,15,44,7,19,66
34187,22,12,5,0,5,17
34188,23,7,4,3,9,14
34189,46,18,20,0,8,38
34190,15,13,0,0,2,13
34191,155,122,5,4,24,131
34192,84,21,45,2,16,68
34193,108,52,38,1,17,91
34194,59,17,31,2,9,50
34195,193,106,38,14,35,158
34196,40,9,22,1,8,32
34197,66,27,19,11,9,57
34198,235,146,5,31,53,182
34199,9,2,4,1,2,7
34200,175,48,55,33,39,136
34201,164,49,89,4,22,142
34202,66,43,13,0,10,56
34203,57,13,19,13,12,45
34204,43,24,6,2,11,32
34205,37,20,11,0,6,31
34206,376,184,98,12,82,294
34207,137,36,70,4,27,110
34208,11,2,6,0,3,8
34209,179,126,14,1,38,141
34210,81,38,4,16,23,58
34211,33,8,17,4,4,29
34212,9,0,4,2,3,6
34213,89,46,24,0,19,70
34214,75,49,8,0,18,57
34215,164,93,22,20,29,135
34216,47,10,22,4,11,36
34217,38,5,28,1,4,34
34218,8,0,3,0,5,3
34219,12,0,10,0,2,10
34220,44,29,9,0,6,38
34221,169,75,54,7,33,136
34222,44,21,11,1,11,33
34223,92,58,15,0,19,73
34224,66,44,12,0,10,56
34225,69,30,29,0,10,59
34226,220,149,30,0,41,179
34227,7,1,2,0,4,3
34228,35,15,14,0,6,29
34229,61,41,12,0,8,53
34230,91,42,14,12,23,68
34231,30,10,14,1,5,25
34232,349,182,103,3,61,288
34233,51,27,13,0,11,40
34234,38,5,25,0,8,30
34235,55,37,2,2,14,41
34236,39,23,9,0,7,32
34237,6,4,0,0,2,4
34238,169,118,15,2,34,135
34239,250,99,22,82,47,203
34240,41,11,10,10,10,31
34241,97,34,35,0,28,69
34242,123,55,44,1,23,100
34243,206,76,90,3,37,169
34244,100,30,35,11,24,76
34245,7,1,4,0,2,5
34246,4,3,0,0,1,3
34247,101,62,28,7,4,97
34248,54,36,7,1,10,44
34249,440,202,151,9,78,362
34250,124,47,51,12,14,110
34251,36,15,15,0,6,30
34252,61,27,21,1,12,49
34253,24,9,11,0,4,20
34254,47,14,24,1,8,39
34255,89,28,41,1,19,70
34256,50,11,26,1,12,38
34257,142,76,14,23,29,113
34258,76,51,7,1,17,59
34259,98,36,25,17,20,78
34260,39,17,13,2,7,32
34261,78,13,41,7,17,61
34262,240,181,13,0,46,194
34263,160,68,65,8,19,141
34264,44,23,10,1,10,34
34265,44,24,14,0,6,38
34266,34,15,9,0,10,24
34267,161,67,56,8,30,131
34268,14,5,7,0,2,12
34269,491,246,93,50,102,389
34270,89,57,14,10,8,81
34271,61,35,14,1,11,50
34272,72,32,33,0,7,65
34273,19,10,7,1,1,18
34274,183,116,52,1,14,169
34275,54,26,22,1,5,49
34276,58,20,21,5,12,46
34277,44,19,9,7,9,35
34278,54,23,16,5,10,44
34279,99,45,27,2,25,74
34280,48,16,24,0,8,40
34281,191,54,98,8,31,160
34282,112,43,33,15,21,91
34283,57,13,32,1,11,46
34284,139,82,11,17,29,110
34285,85,56,12,0,17,68
34286,491,277,121,13,80,411
34287,561,308,121,13,119,442
34288,76,21,35,3,17,59
34289,75,9,42,5,19,56
34290,62,31,23,2,6,56
34291,301,185,50,0,66,235
34292,37,23,5,8,1,36
34293,90,43,34,2,11,79
34294,35,13,11,4,7,28
34295,38,22,2,0,14,24
34296,149,53,46,22,28,121
34297,24,14,4,0,6,18
34298,97,60,8,8,21,76
34299,1324,539,184,339,262,1062
34300,16,6,9,0,1,15
34301,350,188,92,15,55,295
34302,27,11,10,0,6,21
34303,48,12,24,3,9,39
34304,155,75,48,1,31,124
34305,71,43,13,3,12,59
34306,33,8,17,0,8,25
34307,103,20,50,15,18,85
34308,95,32,45,2,16,79
34309,44,6,25,3,10,34
34310,46,18,20,0,8,38
34311,26,9,12,1,4,22
34312,77,47,10,1,19,58
34313,342,146,120,6,70,272
34314,163,81,37,10,35,128
34315,484,266,104,14,100,384
34316,28,4,15,2,7,21
34317,35,16,9,0,10,25
34318,91,63,6,8,14,77
34319,92,57,22,10,3,89
34320,287,36,196,2,53,234
34321,66,28,22,4,12,54
34322,8,4,2,0,2,6
34323,67,30,24,1,12,55
34324,39,5,28,0,6,33
34325,34,13,10,3,8,26
34326,120,65,28,0,27,93
34327,82,39,22,4,17,65
34328,96,33,38,10,15,81
34329,20,8,8,0,4,16
34330,214,54,31,94,35,179
34331,9,3,4,1,1,8
34332,82,48,22,0,12,70
34333,156,99,3,17,37,119
34334,120,58,37,4,21,99
34335,35,12,17,1,5,30
34336,175,58,70,12,35,140
34337,15,4,6,1,4,11
34338,84,56,8,0,20,64
34339,41,15,14,4,8,33
34340,182,47,92,4,39,143
34341,93,26,41,9,17,76
34342,46,17,20,0,9,37
34343,133,73,23,4,33,100
34344,99,47,15,22,15,84
34345,42,17,19,1,5,37
34346,123,35,63,0,25,98
34347,55,10,28,5,12,43
34348,47,21,18,0,8,39
34349,25,10,14,0,1,24
34350,9,3,2,0,4,5
34351,101,93,0,8,0,101
34352,65,17,30,0,18,47
34353,58,16,33,0,9,49
34354,30,12,9,0,9,21
34355,78,23,25,11,19,59
34356,124,79,16,4,25,99
34357,26,13,0,7,6,20
34358,102,78,5,0,19,83
34359,53,28,11,0,14,39
34360,109,75,13,0,21,88
34361,279,135,69,18,57,222
34362,129,2,108,0,19,110
34363,48,11,26,1,10,38
34364,45,32,5,1,7,38
34365,278,124,101,5,48,230
34366,38,19,11,1,7,31
34367,52,16,16,10,10,42
34368,170,75,26,28,41,129
34369,190,82,55,10,43,147
34370,123,75,27,5,16,107
34371,244,101,15,83,45,199
34372,37,13,5,9,10,27
34373,19,2,14,0,3,16
34374,265,136,89,0,40,225
34375,32,21,9,0,2,30
34376,75,38,16,2,19,56
34377,151,24,98,1,28,123
34378,77,49,17,0,11,66
34379,45,13,16,1,15,30
34380,150,24,97,1,28,122
34381,54,18,26,0,10,44
34382,28,0,7,17,4,24
34383,110,26,48,10,26,84
34384,8,5,2,1,0,8
34385,13,6,3,1,3,10
34386,20,15,2,0,3,17
34387,54,34,13,4,3,51
34388,343,142,128,6,67,276
34389,17,9,4,0,4,13
34390,2,0,2,0,0,2
34391,55,20,24,1,10,45
34392,45,7,17,11,10,35
34393,33,24,5,0,4,29
34394,190,128,45,4,13,177
34395,93,58,14,6,15,78
34396,38,15,17,0,6,32
34397,91,56,19,0,16,75
34398,47,17,18,2,10,37
34399,101,56,17,5,23,78
34400,347,188,88,15,56,291
34401,162,110,26,0,26,136
34402,72,28,25,3,16,56
34403,30,20,4,0,6,24
34404,128,93,18,0,17,111
34405,84,65,4,4,11,73
34406,250,135,74,0,41,209
34407,118,46,38,15,19,99
34408,146,87,27,4,28,118
34409,196,78,82,4,32,164
34410,95,39,31,6,19,76
34411,67,38,3,13,13,54
34412,41,22,14,0,5,36
34413,62,14,42,0,6,56
34414,59,27,22,0,10,49
34415,20,11,5,0,4,16
34416,75,31,31,3,10,65
34417,27,7,17,0,3,24
34418,29,8,8,10,3,26
34419,72,40,10,9,13,59
34420,24,9,12,0,3,21
34421,101,32,26,24,19,82
34422,79,33,9,17,20,59
34423,88,35,37,1,15,73
34424,133,62,42,6,23,110
34425,152,24,98,1,29,123
34426,26,14,10,1,1,25
34427,33,8,18,3,4,29
34428,51,21,6,16,8,43
34429,91,55,19,3,14,77
34430,85,44,19,0,22,63
34431,40,0,31,0,9,31
34432,42,19,14,2,7,35
34433,29,23,3,0,3,26
34434,55,24,13,6,12,43
34435,68,25,33,0,10,58
34436,64,5,44,0,15,49
34437,32,6,20,1,5,27
34438,78,18,17,31,12,66
34439,20,1,12,1,6,14
34440,70,38,15,0,17,53
34441,67,34,15,1,17,50
34442,128,28,40,25,35,93
34443,55,33,15,1,6,49
34444,104,32,53,0,19,85
34445,156,97,33,1,25,131
34446,49,6,30,0,13,36
34447,536,377,47,1,111,425
34448,75,51,9,0,15,60
34449,196,99,35,27,35,161
34450,7,2,3,1,1,6
34451,46,18,20,0,8,38
34452,102,46,30,6,20,82
34453,29,9,0,10,10,19
34454,46,3,33,0,10,36
34455,22,8,8,0,6,16
34456,123,53,31,15,24,99
34457,65,17,38,0,10,55
34458,24,16,1,0,7,17
34459,5,3,1,0,1,4
34460,28,16,8,0,4,24
34461,336,141,119,6,70,266
34462,24,10,7,2,5,19
34463,91,66,12,0,13,78
34464,58,11,33,4,10,48
34465,46,18,20,0,8,38
34466,12,7,4,0,1,11
34467,39,29,4,0,6,33
34468,271,61,142,7,61,210
34469,265,60,151,1,53,212
34470,81,27,29,6,19,62
34471,57,28,12,6,11,46
34472,142,108,4,3,27,115
34473,22,0,19,1,2,20
34474,143,45,50,12,36,107
34475,205,126,35,5,39,166
34476,32,21,9,0,2,30
34477,98,53,20,10,15,83
34478,32,17,2,6,7,25
34479,17,12,1,2,2,15
34480,152,92,31,5,24,128
34481,59,35,14,1,9,50
34482,29,22,0,0,7,22
34483,137,46,48,19,24,113
34484,33,9,16,0,8,25
34485,32,21,9,0,2,30
34486,69,37,23,0,9,60
34487,346,167,112,2,65,281
34488,31,19,5,0,7,24
34489,31,19,3,0,9,22
34490,47,12,24,0,11,36
34491,78,62,5,0,11,67
34492,73,20,25,9,19,54
34493,122,96,5,0,21,101
34494,62,4,43,3,12,50
34495,57,34,14,0,9,48
34496,18,4,7,0,7,11
34497,60,41,5,1,13,47
34498,22,8,4,4,6,16
34499,6,3,2,0,1,5
34500,44,25,9,0,10,34
34501,43,11,19,0,13,30
34502,51,33,6,3,9,42
34503,116,79,10,3,24,92
34504,183,40,101,11,31,152
34505,136,70,34,5,27,109
34506,64,46,13,5,0,64
34507,8,3,2,0,3,5
34508,34,21,6,1,6,28
34509,177,88,53,6,30,147
34510,186,116,15,13,42,144
34511,123,54,50,3,16,107
34512,46,18,20,0,8,38
34513,46,21,10,1,14,32
34514,106,55,22,7,22,84
34515,73,21,34,2,16,57
34516,33,2,26,1,4,29
34517,39,23,8,0,8,31
34518,73,33,19,9,12,61
34519,25,8,13,1,3,22
34520,55,39,5,1,10,45
34521,13,7,2,0,4,9
34522,437,202,145,9,81,356
34523,16,12,0,0,4,12
34524,67,32,25,0,10,57
34525,78,41,25,4,8,70
34526,25,12,10,0,3,22
34527,58,5,9,27,17,41
34528,289,134,101,2,52,237
34529,50,24,18,0,8,42
34530,17,8,5,0,4,13
34531,65,42,10,3,10,55
34532,46,18,20,0,8,38
34533,46,16,22,2,6,40
34534,13,6,4,1,2,11
34535,194,82,46,21,45,149
34536,104,57,24,4,19,85
34537,156,97,33,1,25,131
34538,61,14,21,7,19,42
34539,299,210,31,1,57,242
34540,154,40,73,4,37,117
34541,16,5,9,1,1,15
34542,64,46,1,0,17,47
34543,14,7,3,1,3,11
34544,37,0,29,2,6,31
34545,155,4,127,0,24,131
34546,59,19,25,1,14,45
34547,32,1,24,1,6,26
34548,348,150,123,6,69,279
34549,27,12,5,6,4,23
34550,175,50,44,44,37,138
34551,55,26,16,1,12,43
34552,30,8,14,0,8,22
34553,140,57,52,3,28,112
34554,113,47,25,20,21,92
34555,129,46,27,24,32,97
34556,42,20,10,1,11,31
34557,6,0,3,0,3,3
34558,87,6,62,5,14,73
34559,19,18,0,0,1,18
34560,235,56,33,107,39,196
34561,20,10,5,3,2,18
34562,40,4,27,0,9,31
34563,27,23,2,0,2,25
34564,30,19,3,0,8,22
34565,11,2,7,0,2,9
34566,30,6,13,1,10,20
34567,82,21,33,1,27,55
34568,55,20,22,3,10,45
34569,66,35,6,10,15,51
34570,44,35,2,0,7,37
34571,329,139,115,6,69,260
34572,592,412,51,1,128,464
34573,31,15,3,5,8,23
34574,74,25,30,0,19,55
34575,80,46,17,2,15,65
34576,34,5,12,9,8,26
34577,55,24,14,3,14,41
34578,44,27,7,0,10,34
34579,10,7,1,0,2,8
34580,82,35,23,3,21,61
34581,52,30,9,3,10,42
34582,54,18,23,2,11,43
34583,267,120,97,2,48,219
34584,159,92,25,11,31,128
34585,188,96,66,0,26,162
34586,8,0,6,1,1,7
34587,120,44,16,39,21,99
34588,33,9,16,0,8,25
34589,37,20,7,0,10,27
34590,70,45,4,10,11,59
34591,54,11,22,13,8,46
34592,29,20,5,1,3,26
34593,3,1,2,0,0,3
34594,43,20,8,5,10,33
34595,81,38,16,14,13,68
34596,44,29,8,0,7,37
34597,74,18,27,14,15,59
34598,102,34,34,5,29,73
34599,36,15,15,0,6,30
34600,259,189,15,0,55,204
34601,6,5,1,0,0,6
34602,257,73,109,16,59,198
34603,35,6,7,10,12,23
34604,45,21,15,0,9,36
34605,141,53,53,0,35,106
34606,27,2,17,2,6,21
34607,25,12,2,6,5,20
34608,32,21,9,0,2,30
34609,116,28,33,22,33,83
34610,72,33,20,5,14,58
34611,70,29,20,3,18,52
34612,24,10,6,4,4,20
34613,115,38,39,10,28,87
34614,85,24,49,0,12,73
34615,16,4,9,2,1,15
34616,16,9,6,1,0,16
34617,53,21,12,6,14,39
34618,544,278,101,52,113,431
34619,124,56,40,5,23,101
34620,238,179,18,2,39,199
34621,107,24,46,14,23,84
34622,13,8,2,0,3,10
34623,160,76,50,1,33,127
34624,31,2,20,1,8,23
34625,56,31,15,0,10,46
34626,32,21,9,0,2,30
34627,65,46,8,3,8,57
34628,69,52,10,6,1,68
34629,70,29,24,0,17,53
34630,35,15,10,0,10,25
34631,172,49,53,35,35,137
34632,68,25,28,1,14,54
34633,24,6,13,1,4,20
34634,190,60,80,12,38,152
34635,7,4,0,0,3,4
34636,69,37,18,0,14,55
34637,5,4,0,1,0,5
34638,138,47,31,30,30,108
34639,93,45,25,5,18,75
34640,40,2,29,0,9,31
34641,141,62,28,19,32,109
34642,52,31,2,3,16,36
34643,244,102,15,81,46,198
34644,192,53,34,70,35,157
34645,98,48,25,9,16,82
34646,76,50,9,0,17,59
34647,168,12,92,30,34,134
34648,162,65,58,9,30,132
34649,15,4,8,0,3,12
34650,88,33,35,7,13,75
34651,66,28,26,6,6,60
34652,10,3,4,0,3,7
34653,35,16,9,3,7,28
34654,90,48,18,3,21,69
34655,163,123,3,1,36,127
34656,97,40,43,1,13,84
34657,31,15,8,0,8,23
34658,148,96,34,11,7,141
34659,44,1,9,27,7,37
34660,19,11,3,0,5,14
34661,21,7,8,0,6,15
34662,34,13,12,2,7,27
34663,40,22,13,5,0,40
34664,112,77,13,2,20,92
34665,275,18,201,2,54,221
34666,56,3,40,1,12,44
34667,17,0,15,0,2,15
34668,35,16,8,4,7,28
34669,65,39,15,2,9,56
34670,38,25,7,0,6,32
34671,78,13,41,7,17,61
34672,129,43,49,12,25,104
34673,176,61,66,18,31,145
34674,278,96,126,14,42,236
34675,7,0,5,0,2,5
34676,148,66,45,10,27,121
34677,44,21,11,3,9,35
34678,162,123,8,4,27,135
34679,78,52,13,0,13,65
34680,301,174,57,6,64,237
34681,33,0,30,1,2,31
34682,62,14,42,0,6,56
34683,37,9,24,1,3,34
34684,9,7,0,0,2,7
34685,177,61,80,0,36,141
34686,183,105,15,21,42,141
34687,70,15,41,0,14,56
34688,197,97,36,32,32,165
34689,324,74,163,6,81,243
34690,65,14,35,7,9,56
34691,77,33,33,0,11,66
34692,104,50,29,6,19,85
34693,50,29,7,0,14,36
34694,10,0,9,0,1,9
34695,41,9,23,3,6,35
34696,8,0,4,2,2,6
34697,32,18,6,1,7,25
34698,33,14,12,0,7,26
34699,122,64,29,7,22,100
34700,103,49,23,4,27,76
34701,80,39,27,1,13,67
34702,107,84,3,0,20,87
34703,5,0,2,0,3,2
34704,344,177,88,19,60,284
34705,49,11,25,1,12,37
34706,350,150,123,6,71,279
34707,3,0,2,0,1,2
34708,13,7,2,1,3,10
34709,32,16,3,5,8,24
34710,90,47,21,0,22,68
34711,42,17,13,6,6,36
34712,45,6,30,3,6,39
34713,159,108,26,0,25,134
34714,240,145,9,31,55,185
34715,93,38,18,18,19,74
34716,51,6,33,2,10,41
34717,429,135,170,30,94,335
34718,106,76,12,3,15,91
34719,353,158,121,11,63,290
34720,348,200,70,7,71,277
34721,32,24,2,0,6,26
34722,32,21,9,0,2,30
34723,39,23,5,1,10,29
34724,7,1,5,1,0,7
34725,301,131,103,4,63,238
34726,344,201,68,0,75,269
34727,38,30,1,0,7,31
34728,153,49,44,32,28,125
34729,60,38,8,0,14,46
34730,39,7,14,11,7,32
34731,25,11,6,3,5,20
34732,339,142,120,6,71,268
34733,12,6,4,0,2,10
34734,39,9,25,1,4,35
34735,84,37,30,2,15,69
34736,74,43,13,2,16,58
34737,12,2,8,1,1,11
34738,95,30,47,0,18,77
34739,45,35,6,0,4,41
34740,19,2,12,0,5,14
34741,53,27,10,7,9,44
34742,61,17,32,3,9,52
34743,113,43,46,0,24,89
34744,44,27,8,0,9,35
34745,37,8,17,2,10,27
34746,50,15,24,4,7,43
34747,81,39,28,0,14,67
34748,350,90,170,7,83,267
34749,126,64,11,23,28,98
34750,59,43,4,0,12,47
34751,21,6,8,1,6,15
34752,29,2,21,0,6,23
34753,15,1,12,0,2,13
34754,361,164,121,6,70,291
34755,154,67,32,23,32,122
34756,103,22,64,0,17,86
34757,77,28,32,0,17,60
34758,61,23,23,0,15,46
34759,263,58,63,87,55,208
34760,54,36,5,4,9,45
34761,77,50,14,0,13,64
34762,193,125,24,7,37,156
34763,173,134,13,1,25,148
34764,31,12,11,1,7,24
34765,17,6,5,0,6,11
34766,36,17,16,0,3,33
34767,72,41,10,0,21,51
34768,116,48,14,18,36,80
34769,48,13,19,2,14,34
34770,33,12,9,7,5,28
34771,14,0,12,0,2,12
34772,142,45,31,39,27,115
34773,419,237,103,0,79,340
34774,23,5,13,0,5,18
34775,84,41,22,0,21,63
34776,55,28,14,6,7,48
34777,33,1,26,0,6,27
34778,63,35,14,0,14,49
34779,40,28,5,1,6,34
34780,65,48,12,0,5,60
34781,25,16,3,1,5,20
34782,29,16,6,1,6,23
34783,95,35,30,14,16,79
34784,15,4,7,0,4,11
34785,74,39,15,2,18,56
34786,49,11,15,11,12,37
34787,32,21,9,0,2,30
34788,121,46,39,12,24,97
34789,25,15,6,0,4,21
34790,36,19,12,0,5,31
34791,30,14,8,0,8,22
34792,103,25,53,3,22,81
34793,43,14,15,4,10,33
34794,11,8,0,0,3,8
34795,29,14,9,0,6,23
34796,39,22,8,1,8,31
34797,113,63,35,7,8,105
34798,217,74,80,15,48,169
34799,158,22,100,1,35,123
34800,80,44,9,17,10,70
34801,23,10,7,0,6,17
34802,41,32,1,0,8,33
34803,139,74,34,0,31,108
34804,31,15,8,1,7,24
34805,34,21,7,1,5,29
34806,131,43,35,29,24,107
34807,198,107,30,23,38,160
34808,66,15,35,1,15,51
34809,6,1,5,0,0,6
34810,11,3,7,0,1,10
34811,406,189,121,11,85,321
34812,15,5,8,1,1,14
34813,560,320,116,16,108,452
34814,309,201,42,9,57,252
34815,391,131,158,14,88,303
34816,522,377,34,1,110,412
34817,78,53,0,5,20,58
34818,37,25,2,3,7,30
34819,81,24,30,9,18,63
34820,111,46,24,21,20,91
34821,46,18,20,0,8,38
34822,13,7,2,0,4,9
34823,55,17,32,0,6,49
34824,19,6,1,7,5,14
34825,10,4,4,0,2,8
34826,90,34,29,9,18,72
34827,21,6,10,1,4,17
34828,12,3,5,0,4,8
34829,100,54,28,1,17,83
34830,10,1,5,0,4,6
34831,58,41,7,0,10,48
34832,35,9,17,1,8,27
34833,39,18,12,0,9,30
34834,96,44,32,4,16,80
34835,59,6,43,0,10,49
34836,127,43,46,6,32,95
34837,113,62,12,13,26,87
34838,94,20,48,11,15,79
34839,17,6,5,3,3,14
34840,253,187,16,0,50,203
34841,55,33,10,0,12,43
34842,1,1,0,0,0,1
34843,40,0,26,0,14,26
34844,7,4,1,0,2,5
34845,78,18,8,31,21,57
34846,54,43,1,0,10,44
34847,50,14,22,2,12,38
34848,58,13,35,1,9,49
34849,12,11,0,0,1,11
34850,108,49,35,5,19,89
34851,49,31,5,1,12,37
34852,172,72,57,3,40,132
34853,16,7,6,1,2,14
34854,13,0,9,0,4,9
34855,72,45,5,8,14,58
34856,47,17,16,2,12,35
34857,139,75,26,7,31,108
34858,80,46,18,2,14,66
34859,66,30,23,3,10,56
34860,272,170,41,0,61,211
34861,12,5,4,0,3,9
34862,23,2,18,0,3,20
34863,44,13,18,0,13,31
34864,33,14,12,0,7,26
34865,65,46,3,0,16,49
34866,442,201,153,9,79,363
34867,129,72,34,13,10,119
34868,47,33,6,1,7,40
34869,101,47,15,24,15,86
34870,146,91,28,0,27,119
34871,190,138,17,0,35,155
34872,14,1,8,3,2,12
34873,435,207,117,19,92,343
34874,537,305,124,19,89,448
34875,186,137,14,3,32,154
34876,67,40,14,2,11,56
34877,32,21,9,0,2,30
34878,42,14,18,4,6,36
34879,186,129,10,9,38,148
34880,25,14,7,0,4,21
34881,66,39,17,0,10,56
34882,55,25,23,0,7,48
34883,40,9,5,18,8,32
34884,12,7,4,0,1,11
34885,76,37,16,5,18,58
34886,106,88,3,3,12,94
34887,48,28,12,0,8,40
34888,64,45,9,1,9,55
34889,91,29,21,23,18,73
34890,15,5,3,3,4,11
34891,154,51,44,31,28,126
34892,45,28,11,0,6,39
34893,12,6,2,0,4,8
34894,70,34,21,0,15,55
34895,117,87,16,3,11,106
34896,160,49,82,0,29,131
34897,37,14,10,6,7,30
34898,69,5,47,4,13,56
34899,34,18,11,1,4,30
34900,26,18,3,0,5,21
34901,103,67,1,12,23,80
34902,44,11,19,2,12,32
34903,255,149,52,0,54,201
34904,582,333,110,13,126,456
34905,70,40,18,0,12,58
34906,8,1,4,0,3,5
34907,46,18,20,0,8,38
34908,22,8,7,0,7,15
34909,64,29,24,1,10,54
34910,3,2,0,0,1,2
34911,182,145,9,0,28,154
34912,161,68,55,16,22,139
34913,445,238,105,14,88,357
34914,57,6,41,1,9,48
34915,27,11,6,0,10,17
34916,21,1,3,13,4,17
34917,36,6,19,0,11,25
34918,77,30,34,2,11,66
34919,10,5,0,2,3,7
34920,41,24,8,0,9,32
34921,51,33,10,0,8,43
34922,90,66,5,0,19,71
34923,69,48,4,0,17,52
34924,2,1,1,0,0,2
34925,107,68,19,2,18,89
34926,75,38,19,3,15,60
34927,62,37,14,1,10,52
34928,88,30,31,2,25,63
34929,122,103,2,0,17,105
34930,105,54,22,9,20,85
34931,58,40,11,5,2,56
34932,49,23,15,0,11,38
34933,315,163,83,16,53,262
34934,15,6,2,3,4,11
34935,333,139,122,10,62,271
34936,33,26,1,0,6,27
34937,160,28,68,27,37,123
34938,17,3,9,1,4,13
34939,583,339,119,18,107,476
34940,32,21,9,0,2,30
34941,138,71,23,19,25,113
34942,18,11,4,1,2,16
34943,117,69,10,20,18,99
34944,25,10,6,0,9,16
34945,46,18,20,0,8,38
34946,13,9,2,0,2,11
34947,82,27,40,2,13,69
34948,67,37,21,2,7,60
34949,13,8,2,2,1,12
34950,410,216,102,20,72,338
34951,84,53,16,0,15,69
34952,21,13,6,0,2,19
34953,78,12,47,2,17,61
34954,30,6,13,5,6,24
34955,59,34,17,0,8,51
34956,85,34,22,12,17,68
34957,33,5,20,0,8,25
34958,28,7,7,5,9,19
34959,430,203,120,14,93,337
34960,142,105,9,0,28,114
34961,46,18,20,0,8,38
34962,21,13,1,3,4,17
34963,153,99,3,17,34,119
34964,46,18,20,0,8,38
34965,88,42,5,25,16,72
34966,46,20,10,7,9,37
34967,57,19,26,0,12,45
34968,140,80,23,3,34,106
34969,12,6,3,2,1,11
34970,433,244,84,15,90,343
34971,32,21,9,0,2,30
34972,35,17,10,2,6,29
34973,29,2,18,3,6,23
34974,50,10,30,0,10,40
34975,83,47,16,2,18,65
34976,457,141,192,29,95,362
34977,146,58,45,9,34,112
34978,50,11,30,2,7,43
34979,341,255,19,1,66,275
34980,375,207,76,15,77,298
34981,15,7,4,1,3,12
34982,509,276,110,17,106,403
34983,13,7,4,0,2,11
34984,458,159,154,48,97,361
34985,46,18,20,0,8,38
34986,47,26,6,2,13,34
34987,30,22,0,0,8,22
34988,22,5,13,3,1,21
34989,408,190,139,7,72,336
34990,205,53,38,79,35,170
34991,44,12,20,2,10,34
34992,19,9,6,0,4,15
34993,246,99,22,80,45,201
34994,55,27,15,1,12,43
34995,98,41,35,1,21,77
34996,32,21,9,0,2,30
34997,3,2,1,0,0,3
34998,69,19,29,2,19,50
34999,51,17,22,0,12,39
35000,92,21,32,19,20,72
35001,140,80,23,3,34,106
35002,95,40,13,20,22,73
35003,432,206,118,20,88,344
35004,11,8,2,0,1,10
35005,141,48,69,0,24,117
35006,43,9,4,21,9,34
35007,38,21,7,3,7,31
35008,42,23,14,0,5,37
35009,102,74,7,0,21,81
35010,127,69,24,11,23,104
35011,8,4,4,0,0,8
35012,66,22,3,29,12,54
35013,32,16,7,1,8,24
35014,60,38,7,0,15,45
35015,125,57,39,4,25,100
35016,21,4,14,0,3,18
35017,88,20,43,14,11,77
35018,1073,392,428,46,207,866
35019,40,16,12,0,12,28
35020,65,30,18,3,14,51
35021,263,142,61,13,47,216
35022,61,40,6,1,14,47
35023,40,17,14,0,9,31
35024,52,31,8,2,11,41
35025,10,3,2,0,5,5
35026,144,35,77,1,31,113
35027,445,201,106,43,95,350
35028,70,48,8,4,10,60
35029,76,13,7,35,21,55
35030,19,7,7,0,5,14
35031,76,25,29,9,13,63
35032,60,6,16,25,13,47
35033,157,76,49,1,31,126
35034,226,75,85,15,51,175
35035,29,14,7,4,4,25
35036,66,45,9,1,11,55
35037,210,156,17,2,35,175
35038,232,51,119,5,57,175
35039,416,194,119,13,90,326
35040,172,87,64,4,17,155
35041,162,74,30,18,40,122
35042,12,7,4,0,1,11
35043,27,12,11,0,4,23
35044,60,35,9,3,13,47
35045,46,18,20,0,8,38
35046,11,2,8,0,1,10
35047,273,159,23,33,58,215
35048,56,37,12,0,7,49
35049,73,32,30,0,11,62
35050,55,36,10,0,9,46
35051,8,5,1,0,2,6
35052,57,21,15,2,19,38
35053,76,19,26,16,15,61
35054,142,35,77,1,29,113
35055,13,4,6,0,3,10
35056,55,25,14,3,13,42
35057,95,57,26,8,4,91
35058,68,21,25,2,20,48
35059,54,8,35,0,11,43
35060,32,6,19,1,6,26
35061,32,21,9,0,2,30
35062,254,151,19,32,52,202
35063,99,52,28,3,16,83
35064,522,291,111,12,108,414
35065,206,46,52,71,37,169
35066,13,8,3,0,2,11
35067,123,76,30,0,17,106
35068,47,30,8,1,8,39
35069,73,27,31,0,15,58
35070,24,0,17,0,7,17
35071,45,28,8,0,9,36
35072,21,8,8,0,5,16
35073,44,36,2,0,6,38
35074,86,31,24,9,22,64
35075,25,11,8,0,6,19
35076,50,20,23,0,7,43
35077,151,69,46,6,30,121
35078,309,141,93,14,61,248
35079,154,48,79,4,23,131
35080,27,1,23,0,3,24
35081,167,110,38,12,7,160
35082,92,35,28,9,20,72
35083,55,38,6,1,10,45
35084,220,120,36,23,41,179
35085,69,15,38,1,15,54
35086,156,54,8,67,27,129
35087,43,23,8,1,11,32
35088,79,25,33,8,13,66
35089,22,9,10,0,3,19
35090,52,14,28,0,10,42
35091,7,0,6,0,1,6
35092,116,47,25,21,23,93
35093,21,10,8,0,3,18
35094,45,28,8,1,8,37
35095,16,4,10,0,2,14
35096,44,11,15,11,7,37
35097,283,85,133,18,47,236
35098,39,29,5,5,0,39
35099,43,22,10,3,8,35
35100,92,5,60,8,19,73
35101,4,1,1,1,1,3
35102,20,11,6,1,2,18
35103,7,2,3,0,2,5
35104,60,24,4,22,10,50
35105,54,23,13,9,9,45
35106,69,46,8,0,15,54
35107,210,112,48,0,50,160
35108,170,52,86,0,32,138
35109,448,141,183,21,103,345
35110,45,13,14,9,9,36
35111,77,19,37,9,12,65
35112,72,40,9,10,13,59
35113,14,2,11,0,1,13
35114,16,3,7,3,3,13
35115,199,54,43,63,39,160
35116,37,4,23,2,8,29
35117,42,5,31,0,6,36
35118,32,21,9,0,2,30
35119,39,8,26,1,4,35
35120,16,2,6,0,8,8
35121,142,87,28,0,27,115
35122,44,22,10,1,11,33
35123,174,133,15,1,25,149
35124,12,2,8,0,2,10
35125,401,189,135,7,70,331
35126,13,8,5,0,0,13
35127,144,66,44,11,23,121
35128,105,52,34,0,19,86
35129,11,4,3,0,4,7
35130,82,55,7,1,19,63
35131,27,9,13,1,4,23
35132,34,20,6,1,7,27
35133,153,40,78,1,34,119
35134,445,178,123,47,97,348
35135,43,23,11,0,9,34
35136,520,332,79,3,106,414
35137,161,53,82,4,22,139
35138,2,1,1,0,0,2
35139,12,4,7,0,1,11
35140,111,45,14,17,35,76
35141,2,1,1,0,0,2
35142,76,39,24,0,13,63
35143,53,26,9,7,11,42
35144,66,21,17,8,20,46
35145,285,120,98,20,47,238
35146,90,33,43,1,13,77
35147,121,68,30,0,23,98
35148,13,10,1,2,0,13
35149,100,45,35,4,16,84
35150,10,8,0,0,2,8
35151,94,55,20,0,19,75
35152,170,61,57,17,35,135
35153,24,3,18,0,3,21
35154,14,1,7,0,6,8
35155,218,91,14,76,37,181
35156,232,166,14,1,51,181
35157,65,19,19,9,18,47
35158,53,24,19,2,8,45
35159,48,29,9,2,8,40
35160,26,15,6,1,4,22
35161,34,16,11,1,6,28
35162,84,39,19,12,14,70
35163,344,147,120,6,71,273
35164,11,1,5,1,4,7
35165,44,19,8,8,9,35
35166,41,8,26,3,4,37
35167,25,2,13,0,10,15
35168,80,39,29,1,11,69
35169,109,39,39,6,25,84
35170,76,34,5,15,22,54
35171,59,2,47,0,10,49
35172,30,14,5,0,11,19
35173,80,22,39,11,8,72
35174,77,29,31,9,8,69
35175,440,151,149,47,93,347
35176,189,38,52,60,39,150
35177,184,102,20,20,42,142
35178,84,55,12,0,17,67
35179,10,2,6,0,2,8
35180,403,215,100,20,68,335
35181,232,155,32,0,45,187
35182,35,16,11,0,8,27
35183,64,39,16,3,6,58
35184,87,65,5,4,13,74
35185,19,11,5,0,3,16
35186,45,26,9,0,10,35
35187,195,111,26,21,37,158
35188,527,306,90,9,122,405
35189,100,62,23,1,14,86
35190,74,19,9,29,17,57
35191,39,15,11,3,10,29
35192,40,26,7,0,7,33
35193,126,29,58,4,35,91
35194,32,21,9,0,2,30
35195,91,57,8,6,20,71
35196,29,13,6,2,8,21
35197,41,15,19,0,7,34
35198,71,43,11,2,15,56
35199,27,14,7,2,4,23
35200,94,30,39,6,19,75
35201,53,27,19,0,7,46
35202,21,1,13,0,7,14
35203,15,1,13,0,1,14
35204,191,108,25,23,35,156
35205,3,0,3,0,0,3
35206,46,18,20,0,8,38
35207,67,24,17,5,21,46
35208,69,32,22,0,15,54
35209,64,4,49,0,11,53
35210,56,37,12,0,7,49
35211,14,5,5,0,4,10
35212,65,20,25,3,17,48
35213,76,38,23,2,13,63
35214,209,88,43,28,50,159
35215,87,34,30,1,22,65
35216,79,63,5,1,10,69
35217,62,34,15,0,13,49
35218,75,57,6,1,11,64
35219,78,22,44,1,11,67
35220,485,259,83,44,99,386
35221,132,36,46,17,33,99
35222,13,6,5,1,1,12
35223,29,19,4,2,4,25
35224,53,3,39,3,8,45
35225,98,43,33,4,18,80
35226,17,4,11,0,2,15
35227,53,16,22,4,11,42
35228,47,19,15,1,12,35
35229,12,0,9,0,3,9
35230,38,25,7,0,6,32
35231,86,40,30,0,16,70
35232,70,44,15,0,11,59
35233,54,15,19,3,17,37
35234,55,22,19,1,13,42
35235,15,1,12,0,2,13
35236,126,74,21,3,28,98
35237,194,142,18,0,34,160
35238,53,34,6,1,12,41
35239,129,92,10,0,27,102
35240,82,54,16,0,12,70
35241,13,3,7,1,2,11
35242,161,123,15,1,22,139
35243,57,41,10,5,1,56
35244,66,39,13,2,12,54
35245,63,20,12,21,10,53
35246,200,49,29,86,36,164
35247,28,12,11,0,5,23
35248,167,84,48,1,34,133
35249,139,63,26,16,34,105
35250,78,27,20,8,23,55
35251,46,18,20,0,8,38
35252,200,101,35,28,36,164
35253,212,93,86,5,28,184
35254,114,61,31,0,22,92
35255,55,32,15,0,8,47
35256,29,10,13,0,6,23
35257,30,17,1,7,5,25
35258,290,140,84,4,62,228
35259,12,2,8,0,2,10
35260,16,9,6,0,1,15
35261,38,28,3,2,5,33
35262,82,30,25,6,21,61
35263,15,11,3,0,1,14
35264,23,17,3,0,3,20
35265,102,38,35,6,23,79
35266,99,68,15,0,16,83
35267,54,27,9,8,10,44
35268,90,39,28,3,20,70
35269,48,35,2,5,6,42
35270,373,188,112,1,72,301
35271,110,40,33,14,23,87
35272,73,47,5,10,11,62
35273,94,62,8,3,21,73
35274,224,134,39,7,44,180
35275,6,1,3,1,1,5
35276,46,18,20,0,8,38
35277,198,54,37,69,38,160
35278,155,71,49,5,30,125
35279,23,3,13,0,7,16
35280,2,0,1,0,1,1
35281,580,395,58,1,126,454
35282,53,26,15,0,12,41
35283,411,129,183,11,88,323
35284,230,156,32,0,42,188
35285,31,21,4,0,6,25
35286,41,27,5,4,5,36
35287,75,47,19,8,1,74
35288,68,44,12,0,12,56
35289,81,24,45,0,12,69
35290,15,1,13,0,1,14
35291,36,22,9,0,5,31
35292,41,3,30,2,6,35
35293,14,4,1,6,3,11
35294,32,21,9,0,2,30
35295,121,29,40,29,23,98
35296,122,48,48,10,16,106
35297,80,41,16,0,23,57
35298,285,34,199,2,50,235
35299,63,7,51,0,5,58
35300,48,20,17,1,10,38
35301,22,9,8,0,5,17
35302,46,18,20,0,8,38
35303,129,101,7,0,21,108
35304,38,7,14,11,6,32
35305,49,15,22,1,11,38
35306,73,21,36,4,12,61
35307,11,7,2,0,2,9
35308,166,85,40,0,41,125
35309,128,82,33,0,13,115
35310,128,79,24,3,22,106
35311,340,144,120,6,70,270
35312,169,31,105,1,32,137
35313,60,27,16,2,15,45
35314,128,70,29,0,29,99
35315,147,13,79,25,30,117
35316,157,92,28,1,36,121
35317,32,21,9,0,2,30
35318,40,6,23,2,9,31
35319,70,35,17,1,17,53
35320,100,22,46,13,19,81
35321,32,21,9,0,2,30
35322,53,20,18,5,10,43
35323,49,16,4,20,9,40
35324,179,127,14,1,37,142
35325,10,1,8,0,1,9
35326,203,48,21,100,34,169
35327,130,34,59,7,30,100
35328,68,30,24,3,11,57
35329,463,241,79,44,99,364
35330,38,23,4,3,8,30
35331,57,33,15,0,9,48
35332,70,25,30,1,14,56
35333,569,415,37,1,116,453
35334,202,147,11,2,42,160
35335,33,14,10,0,9,24
35336,55,21,13,10,11,44
35337,38,13,20,1,4,34
35338,10,5,5,0,0,10
35339,151,112,9,4,26,125
35340,86,19,41,9,17,69
35341,52,33,5,0,14,38
35342,32,8,20,0,4,28
35343,585,421,44,1,119,466
35344,35,15,11,2,7,28
35345,96,57,17,0,22,74
35346,98,75,3,0,20,78
35347,609,359,133,15,102,507
35348,42,20,14,1,7,35
35349,674,398,136,20,120,554
35350,37,21,12,0,4,33
35351,37,8,18,0,11,26
35352,149,49,71,0,29,120
35353,68,22,26,2,18,50
35354,103,70,8,5,20,83
35355,46,18,20,0,8,38
35356,186,58,77,14,37,149
35357,61,25,26,0,10,51
35358,29,7,15,0,7,22
35359,60,31,9,6,14,46
35360,39,12,18,0,9,30
35361,18,10,2,3,3,15
35362,88,53,16,2,17,71
35363,21,14,5,0,2,19
35364,539,256,123,40,120,419
35365,197,81,30,40,46,151
35366,94,55,24,1,14,80
35367,27,15,2,3,7,20
35368,50,13,24,2,11,39
35369,86,67,6,1,12,74
35370,321,195,56,0,70,251
35371,28,6,7,6,9,19
35372,25,14,2,0,9,16
35373,81,46,17,0,18,63
35374,62,43,8,4,7,55
35375,16,6,6,0,4,12
35376,145,94,29,0,22,123
35377,43,7,24,6,6,37
35378,111,46,38,5,22,89
35379,65,33,9,8,15,50
35380,30,10,16,0,4,26
35381,59,36,10,1,12,47
35382,30,15,9,1,5,25
35383,661,384,150,16,111,550
35384,146,80,28,1,37,109
35385,48,19,19,1,9,39
35386,27,12,6,5,4,23
35387,40,17,8,4,11,29
35388,112,43,33,20,16,96
35389,197,104,58,6,29,168
35390,302,132,100,6,64,238
35391,198,85,42,23,48,150
35392,143,72,36,0,35,108
35393,575,405,47,1,122,453
35394,16,12,3,0,1,15
35395,43,36,1,0,6,37
35396,1,0,1,0,0,1
35397,79,26,37,2,14,65
35398,24,15,0,6,3,21
35399,79,40,16,8,15,64
35400,115,65,25,0,25,90
35401,217,64,100,5,48,169
35402,31,11,15,1,4,27
35403,140,11,79,18,32,108
35404,88,46,11,2,29,59
35405,69,26,28,3,12,57
35406,343,143,127,6,67,276
35407,77,10,43,5,19,58
35408,83,30,32,4,17,66
35409,236,155,35,0,46,190
35410,49,14,25,1,9,40
35411,76,29,27,4,16,60
35412,491,251,117,19,104,387
35413,392,89,173,41,89,303
35414,85,27,31,14,13,72
35415,36,15,14,1,6,30
35416,8,5,2,0,1,7
35417,63,23,31,1,8,55
35418,46,19,10,8,9,37
35419,44,35,2,0,7,37
35420,33,6,19,0,8,25
35421,13,10,0,0,3,10
35422,51,9,31,3,8,43
35423,42,5,28,0,9,33
35424,148,85,17,22,24,124
35425,479,266,74,41,98,381
35426,354,153,126,6,69,285
35427,8,0,7,0,1,7
35428,32,10,9,9,4,28
35429,64,22,30,2,10,54
35430,44,11,19,0,14,30
35431,17,10,4,0,3,14
35432,80,9,52,3,16,64
35433,73,17,25,19,12,61
35434,148,104,20,0,24,124
35435,15,1,13,0,1,14
35436,148,64,27,20,37,111
35437,31,17,9,1,4,27
35438,111,77,10,11,13,98
35439,436,130,184,31,91,345
35440,32,21,9,0,2,30
35441,210,119,41,4,46,164
35442,51,13,28,1,9,42
35443,10,2,5,0,3,7
35444,35,17,16,0,2,33
35445,202,145,9,10,38,164
35446,150,37,77,1,35,115
35447,149,102,2,12,33,116
35448,102,42,34,9,17,85
35449,425,199,138,11,77,348
35450,103,47,28,2,26,77
35451,31,9,18,0,4,27
35452,129,40,50,14,25,104
35453,12,8,2,1,1,11
35454,124,74,28,0,22,102
35455,46,31,6,0,9,37
35456,46,18,20,0,8,38
35457,37,28,5,1,3,34
35458,32,21,9,0,2,30
35459,500,260,117,16,107,393
35460,225,74,86,15,50,175
35461,38,20,8,1,9,29
35462,121,51,45,0,25,96
35463,22,9,6,0,7,15
35464,32,21,9,0,2,30
35465,19,6,9,0,4,15
35466,40,25,2,1,12,28
35467,28,12,13,0,3,25
35468,54,16,18,6,14,40
35469,79,35,28,4,12,67
35470,2,0,1,0,1,1
35471,25,9,11,0,5,20
35472,87,56,15,0,16,71
35473,76,51,16,6,3,73
35474,32,21,3,0,8,24
35475,46,18,20,0,8,38
35476,14,1,9,0,4,10
35477,62,14,28,3,17,45
35478,144,88,29,0,27,117
35479,136,62,48,3,23,113
35480,4,4,0,0,0,4
35481,34,8,15,4,7,27
35482,12,6,4,2,0,12
35483,32,21,9,0,2,30
35484,26,8,12,0,6,20
35485,94,77,1,2,14,80
35486,426,217,104,12,93,333
35487,60,33,17,0,10,50
35488,42,28,7,0,7,35
35489,439,214,133,13,79,360
35490,73,63,2,0,8,65
35491,80,47,17,3,13,67
35492,82,44,21,1,16,66
35493,86,22,39,5,20,66
35494,94,50,30,7,7,87
35495,228,153,34,0,41,187
35496,178,79,59,4,36,142
35497,55,31,7,2,15,40
35498,10,4,5,0,1,9
35499,38,19,9,1,9,29
35500,21,7,10,0,4,17
35501,50,22,13,3,12,38
35502,393,201,95,13,84,309
35503,12,2,7,0,3,9
35504,10,0,8,0,2,8
35505,26,16,6,0,4,22
35506,123,54,35,0,34,89
35507,66,49,12,0,5,61
35508,311,140,109,2,60,251
35509,148,89,29,0,30,118
35510,44,18,10,5,11,33
35511,54,18,21,4,11,43
35512,140,105,4,2,29,111
35513,65,55,2,0,8,57
35514,142,53,61,4,24,118
35515,89,32,37,4,16,73
35516,167,79,51,3,34,133
35517,18,9,1,2,6,12
35518,59,25,4,15,15,44
35519,19,2,10,0,7,12
35520,221,90,41,38,52,169
35521,6,2,4,0,0,6
35522,151,113,9,4,25,126
35523,95,68,10,0,17,78
35524,54,29,11,2,12,42
35525,51,30,2,11,8,43
35526,54,9,35,2,8,46
35527,61,42,1,4,14,47
35528,5,2,2,0,1,4
35529,56,16,20,8,12,44
35530,188,107,24,22,35,153
35531,147,64,46,10,27,120
35532,485,241,92,51,101,384
35533,9,5,2,0,2,7
35534,50,36,3,3,8,42
35535,147,59,57,8,23,124
35536,106,71,11,1,23,83
35537,281,25,197,2,57,224
35538,37,13,13,4,7,30
35539,197,125,25,10,37,160
35540,214,122,48,4,40,174
35541,352,189,92,15,56,296
35542,25,3,13,1,8,17
35543,20,6,0,7,7,13
35544,100,72,14,0,14,86
35545,36,22,10,0,4,32
35546,59,26,20,2,11,48
35547,70,20,38,1,11,59
35548,43,21,13,0,9,34
35549,39,23,8,0,8,31
35550,181,128,20,2,31,150
35551,64,31,6,11,16,48
35552,84,31,17,14,22,62
35553,404,302,20,0,82,322
35554,23,19,2,0,2,21
35555,232,127,51,15,39,193
35556,87,50,16,3,18,69
35557,258,62,132,7,57,201
35558,224,106,67,2,49,175
35559,109,55,16,15,23,86
35560,32,21,9,0,2,30
35561,45,13,20,4,8,37
35562,57,39,11,5,2,55
35563,95,21,31,24,19,76
35564,98,49,29,2,18,80
35565,26,17,6,3,0,26
35566,127,74,22,3,28,99
35567,35,18,13,1,3,32
35568,89,56,16,2,15,74
35569,449,204,152,11,82,367
35570,201,43,54,63,41,160
35571,61,28,24,2,7,54
35572,51,30,14,0,7,44
35573,49,6,35,0,8,41
35574,46,18,20,0,8,38
35575,28,6,7,6,9,19
35576,28,11,10,0,7,21
35577,68,45,13,0,10,58
35578,38,20,9,0,9,29
35579,9,1,7,0,1,8
35580,133,41,49,19,24,109
35581,39,8,25,4,2,37
35582,51,35,5,2,9,42
35583,27,6,14,0,7,20
35584,141,55,44,9,33,108
35585,238,118,65,0,55,183
35586,32,21,9,0,2,30
35587,54,21,9,11,13,41
35588,37,29,1,0,7,30
35589,8,1,7,0,0,8
35590,367,100,171,8,88,279
35591,67,35,15,0,17,50
35592,3,0,2,1,0,3
35593,172,83,50,4,35,137
35594,15,3,9,0,3,12
35595,78,38,21,3,16,62
35596,319,142,107,4,66,253
35597,172,107,5,20,40,132
35598,603,416,56,1,130,473
35599,17,9,2,1,5,12
35600,98,25,57,2,14,84
35601,138,103,6,0,29,109
35602,66,42,7,0,17,49
35603,67,46,6,0,15,52
35604,343,161,97,13,72,271
35605,87,46,7,16,18,69
35606,44,14,15,8,7,37
35607,45,11,24,0,10,35
35608,46,18,20,0,8,38
35609,2,1,0,0,1,1
35610,122,50,31,18,23,99
35611,85,26,33,6,20,65
35612,56,27,12,3,14,42
35613,90,53,19,0,18,72
35614,41,9,23,0,9,32
35615,149,75,37,0,37,112
35616,26,13,8,0,5,21
35617,194,105,33,20,36,158
35618,75,55,4,0,16,59
35619,383,125,162,9,87,296
35620,51,13,28,1,9,42
35621,80,12,46,6,16,64
35622,332,175,87,15,55,277
35623,177,78,28,28,43,134
35624,16,7,5,1,3,13
35625,116,40,46,0,30,86
35626,130,43,29,23,35,95
35627,406,177,111,33,85,321
35628,94,37,21,15,21,73
35629,88,59,10,0,19,69
35630,51,16,21,3,11,40
35631,11,2,7,0,2,9
35632,34,18,11,0,5,29
35633,88,24,39,9,16,72
35634,674,394,140,21,119,555
35635,49,17,25,0,7,42
35636,114,69,22,0,23,91
35637,56,23,22,0,11,45
35638,35,19,9,1,6,29
35639,176,64,55,25,32,144
35640,57,21,20,6,10,47
35641,90,28,20,23,19,71
35642,44,19,17,1,7,37
35643,122,65,33,0,24,98
35644,51,23,4,12,12,39
35645,79,48,21,1,9,70
35646,8,3,4,0,1,7
35647,29,8,14,2,5,24
35648,44,23,17,0,4,40
35649,131,59,27,15,30,101
35650,573,406,45,1,121,452
35651,24,2,20,0,2,22
35652,63,32,19,2,10,53
35653,36,9,24,0,3,33
35654,123,43,25,28,27,96
35655,128,38,62,3,25,103
35656,23,6,13,0,4,19
35657,181,84,44,15,38,143
35658,639,371,146,16,106,533
35659,20,5,8,2,5,15
35660,45,9,28,0,8,37
35661,32,21,9,0,2,30
35662,11,7,2,0,2,9
35663,112,36,53,3,20,92
35664,45,16,20,0,9,36
35665,49,17,9,12,11,38
35666,221,119,51,10,41,180
35667,100,31,50,0,19,81
35668,130,65,29,14,22,108
35669,81,40,19,0,22,59
35670,127,52,46,3,26,101
35671,394,295,20,0,79,315
35672,82,26,30,14,12,70
35673,46,18,20,0,8,38
35674,138,43,63,4,28,110
35675,85,42,24,4,15,70
35676,25,4,19,0,2,23
35677,42,32,2,0,8,34
35678,83,6,63,2,12,71
35679,132,40,35,23,34,98
35680,39,26,1,0,12,27
35681,18,7,8,0,3,15
35682,92,19,40,12,21,71
35683,16,8,5,0,3,13
35684,38,17,7,2,12,26
35685,47,24,12,2,9,38
35686,40,30,1,2,7,33
35687,48,20,12,5,11,37
35688,43,8,26,1,8,35
35689,19,7,8,3,1,18
35690,35,27,1,0,7,28
35691,128,47,61,0,20,108
35692,38,17,12,1,8,30
35693,32,21,9,0,2,30
35694,18,8,5,2,3,15
35695,107,26,61,4,16,91
35696,67,34,11,5,17,50
35697,504,267,90,43,104,400
35698,141,26,89,1,25,116
35699,72,15,31,8,18,54
35700,8,0,5,0,3,5
35701,38,21,12,0,5,33
35702,59,18,25,7,9,50
35703,97,63,20,0,14,83
35704,76,38,17,2,19,57
35705,17,0,12,0,5,12
35706,61,28,19,0,14,47
35707,66,37,8,9,12,54
35708,54,26,20,0,8,46
35709,575,418,40,1,116,459
35710,448,208,140,11,89,359
35711,44,17,19,1,7,37
35712,6,1,3,0,2,4
35713,116,48,28,16,24,92
35714,120,40,34,14,32,88
35715,10,7,2,0,1,9
35716,54,16,18,6,14,40
35717,517,245,124,35,113,404
35718,119,78,15,3,23,96
35719,14,4,7,0,3,11
35720,27,10,11,0,6,21
35721,21,15,2,1,3,18
35722,45,16,15,0,14,31
35723,53,11,21,8,13,40
35724,29,20,3,0,6,23
35725,170,40,16,86,28,142
35726,241,98,22,78,43,198
35727,176,6,142,0,28,148
35728,4,1,3,0,0,4
35729,70,40,14,0,16,54
35730,385,127,160,17,81,304
35731,180,84,40,19,37,143
35732,7,4,0,0,3,4
35733,13,6,3,1,3,10
35734,262,178,34,3,47,215
35735,77,60,2,0,15,62
35736,122,56,34,0,32,90
35737,60,22,23,1,14,46
35738,115,30,61,0,24,91
35739,62,11,30,4,17,45
35740,132,62,36,0,34,98
35741,87,43,18,7,19,68
35742,36,7,23,1,5,31
35743,13,2,10,0,1,12
35744,4,1,2,0,1,3
35745,322,163,84,14,61,261
35746,176,125,18,2,31,145
35747,130,83,16,4,27,103
35748,16,3,13,0,0,16
35749,39,3,30,1,5,34
35750,1,0,0,0,1,0
35751,6,1,3,0,2,4
35752,13,13,0,0,0,13
35753,148,36,80,1,31,117
35754,21,15,4,0,2,19
35755,103,54,23,0,26,77
35756,62,36,18,0,8,54
35757,88,53,20,0,15,73
35758,171,113,27,1,30,141
35759,46,18,20,0,8,38
35760,19,10,5,1,3,16
35761,147,64,53,1,29,118
35762,12,10,1,0,1,11
35763,133,43,54,8,28,105
35764,138,79,13,19,27,111
35765,212,90,61,18,43,169
35766,25,15,6,0,4,21
35767,30,14,6,1,9,21
35768,46,11,16,7,12,34
35769,40,26,7,0,7,33
35770,60,30,11,2,17,43
35771,188,88,47,15,38,150
35772,173,84,53,3,33,140
35773,80,44,16,4,16,64
35774,19,4,10,0,5,14
35775,424,204,110,25,85,339
35776,31,19,3,0,9,22
35777,54,36,8,2,8,46
35778,46,26,11,1,8,38
35779,68,45,11,0,12,56
35780,400,174,136,13,77,323
35781,86,39,17,9,21,65
35782,144,51,37,29,27,117
35783,14,1,9,1,3,11
35784,135,75,24,7,29,106
35785,33,1,25,1,6,27
35786,121,99,5,0,17,104
35787,71,37,3,20,11,60
35788,97,59,22,11,5,92
35789,346,163,98,17,68,278
35790,124,88,15,0,21,103
35791,388,224,85,0,79,309
35792,161,38,17,81,25,136
35793,15,2,9,1,3,12
35794,56,14,26,2,14,42
35795,21,10,4,0,7,14
35796,2,0,0,0,2,0
35797,38,11,19,0,8,30
35798,264,180,19,3,62,202
35799,18,5,9,1,3,15
35800,112,90,7,2,13,99
35801,515,287,82,41,105,410
35802,4,0,3,0,1,3
35803,23,1,18,0,4,19
35804,49,25,14,2,8,41
35805,47,25,13,0,9,38
35806,63,22,29,4,8,55
35807,74,29,15,8,22,52
35808,40,26,3,5,6,34
35809,33,18,13,0,2,31
35810,353,159,119,6,69,284
35811,268,180,19,2,67,201
35812,154,120,6,0,28,126
35813,9,3,2,1,3,6
35814,416,198,114,17,87,329
35815,14,7,4,0,3,11
35816,1,1,0,0,0,1
35817,261,191,15,0,55,206
35818,29,3,19,0,7,22
35819,40,20,11,0,9,31
35820,95,52,18,10,15,80
35821,91,5,59,8,19,72
35822,46,18,20,0,8,38
35823,27,5,13,1,8,19
35824,41,9,23,3,6,35
35825,116,43,37,15,21,95
35826,20,9,7,1,3,17
35827,480,253,108,17,102,378
35828,99,53,20,11,15,84
35829,624,348,155,22,99,525
35830,66,35,11,2,18,48
35831,104,39,46,0,19,85
35832,32,21,9,0,2,30
35833,669,394,139,18,118,551
35834,98,41,18,13,26,72
35835,100,46,15,24,15,85
35836,50,30,11,0,9,41
35837,209,57,35,82,35,174
35838,26,9,10,1,6,20
35839,121,68,31,12,10,111
35840,173,86,47,4,36,137
35841,81,26,42,0,13,68
35842,14,7,4,1,2,12
35843,671,392,143,17,119,552
35844,4,1,1,2,0,4
35845,123,55,18,17,33,90
35846,81,52,19,1,9,72
35847,123,64,25,11,23,100
35848,114,53,36,1,24,90
35849,74,27,36,1,10,64
35850,184,48,18,87,31,153
35851,119,77,9,14,19,100
35852,28,8,15,1,4,24
35853,20,3,11,0,6,14
35854,184,145,11,0,28,156
35855,136,81,30,0,25,111
35856,35,21,6,0,8,27
35857,15,13,0,0,2,13
35858,148,45,35,39,29,119
35859,142,57,32,24,29,113
35860,29,6,14,3,6,23
35861,14,3,8,1,2,12
35862,222,74,83,15,50,172
35863,11,6,1,1,3,8
35864,29,9,17,0,3,26
35865,48,26,15,0,7,41
35866,23,5,16,0,2,21
35867,52,18,11,17,6,46
35868,121,67,32,12,10,111
35869,110,21,65,1,23,87
35870,163,125,7,0,31,132
35871,58,42,9,7,0,58
35872,472,137,194,37,104,368
35873,18,9,6,2,1,17
35874,86,54,16,0,16,70
35875,233,124,35,29,45,188
35876,52,17,21,2,12,40
35877,64,41,5,0,18,46
35878,200,151,18,1,30,170
35879,35,12,14,1,8,27
35880,157,48,82,4,23,134
35881,444,141,182,20,101,343
35882,32,13,11,2,6,26
35883,79,27,20,9,23,56
35884,24,7,10,0,7,17
35885,179,72,38,27,42,137
35886,25,12,11,0,2,23
35887,24,10,11,0,3,21
35888,46,18,20,0,8,38
35889,47,30,6,1,10,37
35890,33,3,6,16,8,25
35891,61,36,16,1,8,53
35892,58,32,8,6,12,46
35893,54,17,23,2,12,42
35894,33,15,8,2,8,25
35895,42,24,14,0,4,38
35896,338,145,121,11,61,277
35897,267,64,149,1,53,214
35898,163,30,102,1,30,133
35899,107,32,42,6,27,80
35900,212,52,26,99,35,177
35901,68,28,26,0,14,54
35902,39,19,9,3,8,31
35903,13,2,4,2,5,8
35904,86,59,5,0,22,64
35905,36,15,14,1,6,30
35906,137,79,21,3,34,103
35907,219,92,14,76,37,182
35908,31,8,17,0,6,25
35909,38,5,25,0,8,30
35910,99,44,33,4,18,81
35911,112,48,39,4,21,91
35912,124,42,36,14,32,92
35913,102,31,29,22,20,82
35914,119,34,62,0,23,96
35915,395,229,83,15,68,327
35916,44,22,11,3,8,36
35917,33,18,3,4,8,25
35918,469,175,152,44,98,371
35919,600,415,54,1,130,470
35920,46,18,20,0,8,38
35921,60,41,5,1,13,47
35922,7,1,2,0,4,3
35923,58,2,48,1,7,51
35924,1076,393,430,46,207,869
35925,46,18,20,0,8,38
35926,70,42,13,0,15,55
35927,93,49,31,7,6,87
35928,93,49,13,16,15,78
35929,19,4,10,2,3,16
35930,59,5,50,0,4,55
35931,68,43,14,0,11,57
35932,55,39,5,1,10,45
35933,46,8,30,0,8,38
35934,71,45,17,0,9,62
35935,8,4,2,0,2,6
35936,1,0,1,0,0,1
35937,46,18,20,0,8,38
35938,107,64,21,0,22,85
35939,73,40,17,0,16,57
35940,5,1,2,0,2,3
35941,148,60,45,9,34,114
35942,133,88,23,0,22,111
35943,48,13,28,1,6,42
35944,37,20,9,0,8,29
35945,73,26,34,3,10,63
35946,10,0,9,0,1,9
35947,41,13,18,0,10,31
35948,10,1,9,0,0,10
35949,95,30,25,21,19,76
35950,39,24,5,0,10,29
35951,13,8,1,3,1,12
35952,46,18,20,0,8,38
35953,23,4,16,0,3,20
35954,126,64,11,23,28,98
35955,46,14,25,1,6,40
35956,62,24,26,0,12,50
35957,37,28,1,1,7,30
35958,39,2,19,12,6,33
35959,56,3,40,1,12,44
35960,68,51,6,0,11,57
35961,169,85,51,6,27,142
35962,12,2,5,0,5,7
35963,40,25,9,0,6,34
35964,14,5,6,2,1,13
35965,26,7,14,0,5,21
35966,192,108,27,19,38,154
35967,43,17,16,2,8,35
35968,19,6,10,0,3,16
35969,13,6,3,0,4,9
35970,56,23,19,1,13,43
35971,62,32,22,0,8,54
35972,578,406,49,1,122,456
35973,85,43,14,7,21,64
35974,142,111,2,1,28,114
35975,86,39,25,10,12,74
35976,2,1,0,0,1,1
35977,56,2,24,14,16,40
35978,78,37,22,4,15,63
35979,215,90,67,20,38,177
35980,53,17,13,16,7,46
35981,18,4,11,0,3,15
35982,97,53,17,5,22,75
35983,27,15,8,0,4,23
35984,77,21,41,2,13,64
35985,107,24,58,3,22,85
35986,86,25,22,21,18,68
35987,2,0,2,0,0,2
35988,6,0,5,0,1,5
35989,16,2,9,1,4,12
35990,29,11,11,0,7,22
35991,222,150,31,0,41,181
35992,101,48,20,2,31,70
35993,8,0,5,0,3,5
35994,83,30,40,0,13,70
35995,32,21,9,0,2,30
35996,94,40,19,11,24,70
35997,65,46,1,0,18,47
35998,493,353,33,1,106,387
35999,75,4,52,1,18,57
36000,46,18,20,0,8,38
36001,22,5,12,0,5,17
36002,22,5,14,0,3,19
36003,63,20,26,3,14,49
36004,77,24,31,9,13,64
36005,32,13,14,0,5,27
36006,59,24,19,3,13,46
36007,32,21,9,0,2,30
36008,39,6,24,2,7,32
36009,60,13,40,1,6,54
36010,78,22,18,26,12,66
36011,145,80,28,1,36,109
36012,24,9,7,2,6,18
36013,19,8,8,1,2,17
36014,38,8,17,1,12,26
36015,32,21,9,0,2,30
36016,42,8,19,0,15,27
36017,108,101,0,7,0,108
36018,38,22,8,0,8,30
36019,16,9,4,0,3,13
36020,73,55,6,0,12,61
36021,22,11,9,1,1,21
36022,78,25,27,14,12,66
36023,60,6,15,26,13,47
36024,37,5,19,5,8,29
36025,73,63,2,0,8,65
36026,83,40,23,4,16,67
36027,52,6,32,0,14,38
36028,10,0,5,2,3,7
36029,34,13,16,0,5,29
36030,155,47,81,4,23,132
36031,21,6,10,1,4,17
36032,110,72,13,1,24,86
36033,202,112,29,21,40,162
36034,140,49,36,29,26,114
36035,77,35,22,0,20,57
36036,155,66,34,22,33,122
36037,81,39,17,6,19,62
36038,523,213,145,49,116,407
36039,29,10,11,0,8,21
36040,23,14,6,0,3,20
36041,77,41,23,0,13,64
36042,107,63,17,3,24,83
36043,23,14,6,1,2,21
36044,63,24,28,0,11,52
36045,75,18,26,10,21,54
36046,62,35,20,2,5,57
36047,54,0,34,3,17,37
36048,41,17,15,2,7,34
36049,10,6,3,0,1,9
36050,342,145,120,6,71,271
36051,97,53,24,3,17,80
36052,18,7,3,1,7,11
36053,222,58,44,74,46,176
36054,36,6,21,0,9,27
36055,29,5,20,0,4,25
36056,37,7,24,0,6,31
36057,9,1,5,0,3,6
36058,34,19,9,0,6,28
36059,13,6,4,0,3,10
36060,54,22,11,16,5,49
36061,25,2,16,1,6,19
36062,17,13,2,0,2,15
36063,168,116,14,0,38,130
36064,83,66,0,4,13,70
36065,78,53,14,1,10,68
36066,41,9,18,5,9,32
36067,23,12,7,0,4,19
36068,155,66,34,25,30,125
36069,46,18,20,0,8,38
36070,30,12,14,0,4,26
36071,247,103,15,82,47,200
36072,143,87,28,0,28,115
36073,163,76,47,7,33,130
36074,191,95,33,30,33,158
36075,40,30,1,2,7,33
36076,12,0,9,0,3,9
36077,137,72,42,0,23,114
36078,61,19,31,1,10,51
36079,24,12,8,2,2,22
36080,31,7,15,2,7,24
36081,80,26,27,10,17,63
36082,7,0,0,6,1,6
36083,39,28,0,0,11,28
36084,358,159,124,6,69,289
36085,48,20,16,0,12,36
36086,69,39,14,0,16,53
36087,48,32,2,2,12,36
36088,442,221,112,13,96,346
36089,16,6,5,0,5,11
36090,324,131,120,6,67,257
36091,140,68,37,0,35,105
36092,138,55,52,3,28,110
36093,67,24,6,28,9,58
36094,90,37,19,9,25,65
36095,55,33,10,0,12,43
36096,59,8,33,7,11,48
36097,526,380,37,0,109,417
36098,46,18,20,0,8,38
36099,55,34,9,0,12,43
36100,42,26,8,2,6,36
36101,587,382,71,7,127,460
36102,152,57,48,21,26,126
36103,6,2,4,0,0,6
36104,18,15,0,0,3,15
36105,166,131,10,1,24,142
36106,492,261,84,43,104,388
36107,93,63,14,0,16,77
36108,269,116,90,17,46,223
36109,28,14,4,5,5,23
36110,281,145,94,0,42,239
36111,413,193,88,48,84,329
36112,13,2,10,0,1,12
36113,33,19,4,1,9,24
36114,148,61,56,8,23,125
36115,30,9,17,0,4,26
36116,101,36,36,13,16,85
36117,138,76,30,8,24,114
36118,30,4,23,0,3,27
36119,89,39,27,3,20,69
36120,57,22,4,21,10,47
36121,80,19,46,1,14,66
36122,35,10,21,0,4,31
36123,141,38,79,0,24,117
36124,86,41,29,0,16,70
36125,72,37,4,15,16,56
36126,120,70,27,0,23,97
36127,457,208,104,47,98,359
36128,16,14,0,0,2,14
36129,20,8,9,0,3,17
36130,542,297,113,13,119,423
36131,38,1,27,0,10,28
36132,189,55,97,2,35,154
36133,160,12,91,23,34,126
36134,23,9,8,0,6,17
36135,101,34,42,11,14,87
36136,220,118,66,0,36,184
36137,27,22,3,0,2,25
36138,110,64,18,7,21,89
36139,49,28,9,0,12,37
36140,71,32,16,13,10,61
36141,208,113,49,0,46,162
36142,88,32,19,8,29,59
36143,45,20,17,1,7,38
36144,101,30,36,10,25,76
36145,55,38,6,1,10,45
36146,324,131,131,5,57,267
36147,188,87,47,16,38,150
36148,256,187,13,1,55,201
36149,42,19,3,15,5,37
36150,343,145,121,6,71,272
36151,16,8,7,0,1,15
36152,132,54,32,19,27,105
36153,90,36,35,2,17,73
36154,185,102,35,1,47,138
36155,105,44,22,19,20,85
36156,105,75,12,10,8,97
36157,30,16,9,0,5,25
36158,1,1,0,0,0,1
36159,139,55,44,8,32,107
36160,85,48,15,3,19,66
36161,24,18,3,0,3,21
36162,194,38,52,64,40,154
36163,148,114,6,0,28,120
36164,266,102,110,6,48,218
36165,95,25,54,2,14,81
36166,47,34,4,2,7,40
36167,43,5,29,0,9,34
36168,41,32,5,0,4,37
36169,121,46,46,7,22,99
36170,158,121,2,1,34,124
36171,82,18,41,6,17,65
36172,65,41,6,0,18,47
36173,32,21,9,0,2,30
36174,74,37,20,7,10,64
36175,384,224,81,15,64,320
36176,399,186,131,5,77,322
36177,26,13,7,0,6,20
36178,11,4,7,0,0,11
36179,116,43,36,7,30,86
36180,106,26,28,29,23,83
36181,24,8,10,0,6,18
36182,227,99,14,76,38,189
36183,225,91,41,38,55,170
36184,9,6,0,1,2,7
36185,53,17,12,17,7,46
36186,78,41,28,1,8,70
36187,34,17,11,0,6,28
36188,43,18,17,1,7,36
36189,199,144,15,1,39,160
36190,109,58,25,4,22,87
36191,80,57,8,0,15,65
36192,26,2,20,0,4,22
36193,129,67,13,21,28,101
36194,121,45,35,17,24,97
36195,86,54,18,0,14,72
36196,166,86,36,9,35,131
36197,24,4,14,1,5,19
36198,13,2,7,0,4,9
36199,32,14,10,0,8,24
36200,43,15,19,0,9,34
36201,54,14,31,0,9,45
36202,199,104,36,22,37,162
36203,151,98,27,0,26,125
36204,21,2,15,0,4,17
36205,32,21,9,0,2,30
36206,52,23,18,0,11,41
36207,22,18,2,0,2,20
36208,35,16,10,0,9,26
36209,32,21,9,0,2,30
36210,33,8,20,3,2,31
36211,117,24,56,15,22,95
36212,106,56,16,11,23,83
36213,61,12,31,0,18,43
36214,4,0,4,0,0,4
36215,25,1,17,0,7,18
36216,59,13,40,0,6,53
36217,46,18,20,0,8,38
36218,148,48,41,32,27,121
36219,25,1,13,4,7,18
36220,55,11,36,1,7,48
36221,204,92,56,13,43,161
36222,33,17,6,0,10,23
36223,35,8,15,1,11,24
36224,83,36,19,5,23,60
36225,152,66,54,1,31,121
36226,10,5,2,0,3,7
36227,27,10,6,7,4,23
36228,127,28,44,30,25,102
36229,9,7,0,2,0,9
36230,59,19,15,13,12,47
36231,127,57,36,8,26,101
36232,259,19,191,1,48,211
36233,38,22,5,2,9,29
36234,105,68,9,4,24,81
36235,122,66,22,7,27,95
36236,84,39,29,0,16,68
36237,195,61,81,13,40,155
36238,6,1,3,0,2,4
36239,219,115,53,11,40,179
36240,209,130,62,4,13,196
36241,68,46,7,0,15,53
36242,189,126,46,3,14,175
36243,176,13,127,0,36,140
36244,56,34,9,4,9,47
36245,32,2,24,2,4,28
36246,44,18,7,11,8,36
36247,17,5,4,3,5,12
36248,73,35,20,5,13,60
36249,11,6,3,0,2,9
36250,11,3,5,0,3,8
36251,108,37,41,11,19,89
36252,106,55,31,3,17,89
36253,79,44,13,6,16,63
36254,38,17,16,0,5,33
36255,146,60,32,20,34,112
36256,66,32,20,4,10,56
36257,3,2,0,0,1,2
36258,32,21,9,0,2,30
36259,39,11,19,1,8,31
36260,176,48,14,83,31,145
36261,36,15,16,0,5,31
36262,295,217,12,2,64,231
36263,59,38,7,0,14,45
36264,140,48,21,29,42,98
36265,46,5,30,0,11,35
36266,46,17,13,4,12,34
36267,95,44,32,4,15,80
36268,175,128,13,1,33,142
36269,67,10,45,0,12,55
36270,461,120,195,39,107,354
36271,79,47,15,2,15,64
36272,135,79,28,0,28,107
36273,45,13,21,0,11,34
36274,50,14,24,0,12,38
36275,10,1,8,0,1,9
36276,185,70,47,28,40,145
36277,84,44,14,8,18,66
36278,78,43,15,2,18,60
36279,37,14,17,0,6,31
36280,111,48,34,2,27,84
36281,231,147,67,1,16,215
36282,29,3,14,5,7,22
36283,54,36,5,1,12,42
36284,14,7,4,0,3,11
36285,154,116,3,0,35,119
36286,70,47,7,1,15,55
36287,46,6,27,0,13,33
36288,97,24,58,2,13,84
36289,93,32,27,18,16,77
36290,243,165,17,3,58,185
36291,8,4,0,0,4,4
36292,46,18,20,0,8,38
36293,86,45,26,0,15,71
36294,223,171,5,2,45,178
36295,15,10,2,0,3,12
36296,56,3,40,1,12,44
36297,1,1,0,0,0,1
36298,155,71,49,5,30,125
36299,100,64,9,5,22,78
36300,79,34,29,5,11,68
36301,32,21,9,0,2,30
36302,74,17,42,0,15,59
36303,228,78,85,15,50,178
36304,32,21,9,0,2,30
36305,98,30,48,3,17,81
36306,27,14,10,0,3,24
36307,44,26,7,2,9,35
36308,191,146,14,1,30,161
36309,69,11,43,0,15,54
36310,42,20,4,10,8,34
36311,127,29,41,31,26,101
36312,79,40,19,2,18,61
36313,73,37,17,0,19,54
36314,2,1,0,1,0,2
36315,42,18,11,0,13,29
36316,20,9,4,0,7,13
36317,54,3,40,0,11,43
36318,61,29,23,2,7,54
36319,48,6,37,0,5,43
36320,86,40,22,1,23,63
36321,26,15,6,1,4,22
36322,42,19,8,0,15,27
36323,25,16,4,2,3,22
36324,33,12,17,0,4,29
36325,53,18,16,7,12,41
36326,59,13,40,0,6,53
36327,12,4,4,0,4,8
36328,71,37,6,9,19,52
36329,183,130,15,2,36,147
36330,25,4,10,4,7,18
36331,156,93,31,8,24,132
36332,78,25,32,9,12,66
36333,50,25,17,0,8,42
36334,20,2,0,10,8,12
36335,54,13,31,0,10,44
36336,13,6,6,0,1,12
36337,69,22,12,25,10,59
36338,446,138,183,24,101,345
36339,46,18,20,0,8,38
36340,77,11,53,0,13,64
36341,45,16,15,0,14,31
36342,74,57,5,3,9,65
36343,3,2,1,0,0,3
36344,244,123,57,20,44,200
36345,377,223,77,14,63,314
36346,17,0,14,0,3,14
36347,88,21,13,33,21,67
36348,349,182,104,2,61,288
36349,22,11,7,0,4,18
36350,41,6,24,3,8,33
36351,5,0,4,0,1,4
36352,138,49,66,0,23,115
36353,90,42,29,4,15,75
36354,235,100,15,79,41,194
36355,30,7,12,2,9,21
36356,117,32,55,3,27,90
36357,84,47,16,0,21,63
36358,43,10,23,0,10,33
36359,19,6,5,1,7,12
36360,295,23,215,2,55,240
36361,38,18,15,0,5,33
36362,570,401,45,1,123,447
36363,401,129,175,10,87,314
36364,132,43,50,8,31,101
36365,39,2,23,0,14,25
36366,160,101,29,0,30,130
36367,66,35,10,9,12,54
36368,156,66,47,11,32,124
36369,59,13,40,0,6,53
36370,340,92,163,7,78,262
36371,92,30,42,1,19,73
36372,34,20,7,1,6,28
36373,604,414,58,1,131,473
36374,46,26,13,0,7,39
36375,186,39,65,41,41,145
36376,247,121,65,14,47,200
36377,43,4,30,0,9,34
36378,41,25,6,1,9,32
36379,233,79,91,14,49,184
36380,156,50,46,33,27,129
36381,143,87,30,3,23,120
36382,62,29,25,0,8,54
36383,89,36,36,0,17,72
36384,31,12,13,0,6,25
36385,105,91,3,0,11,94
36386,34,12,12,1,9,25
36387,46,20,18,1,7,39
36388,44,29,1,0,14,30
36389,62,30,14,5,13,49
36390,72,54,6,0,12,60
36391,145,79,27,7,32,113
36392,105,52,37,0,16,89
36393,47,15,18,1,13,34
36394,373,217,79,0,77,296
36395,49,25,11,4,9,40
36396,56,7,42,1,6,50
36397,36,15,9,2,10,26
36398,100,60,9,8,23,77
36399,60,27,12,7,14,46
36400,23,1,15,2,5,18
36401,40,22,7,4,7,33
36402,41,11,20,2,8,33
36403,31,21,4,0,6,25
36404,32,18,6,1,7,25
36405,43,24,8,2,9,34
36406,74,14,43,2,15,59
36407,61,24,20,2,15,46
36408,48,14,15,8,11,37
36409,62,35,5,8,14,48
36410,167,41,63,24,39,128
36411,294,204,33,1,56,238
36412,30,2,24,0,4,26
36413,17,8,3,3,3,14
36414,74,39,19,0,16,58
36415,505,264,90,45,106,399
36416,353,203,74,0,76,277
36417,19,12,3,1,3,16
36418,30,18,6,0,6,24
36419,83,57,5,7,14,69
36420,96,57,15,5,19,77
36421,281,181,74,4,22,259
36422,42,10,20,0,12,30
36423,49,19,20,1,9,40
36424,16,6,5,0,5,11
36425,57,43,8,6,0,57
36426,99,40,21,17,21,78
36427,259,160,38,0,61,198
36428,29,12,14,0,3,26
36429,25,17,1,0,7,18
36430,46,18,20,0,8,38
36431,32,21,9,0,2,30
36432,81,35,23,10,13,68
36433,245,160,65,4,16,229
36434,121,43,52,1,25,96
36435,115,40,34,16,25,90
36436,218,121,43,14,40,178
36437,23,6,13,3,1,22
36438,98,43,33,4,18,80
36439,5,1,4,0,0,5
36440,36,15,9,2,10,26
36441,56,3,40,1,12,44
36442,116,65,17,8,26,90
36443,147,63,51,7,26,121
36444,11,1,9,0,1,10
36445,11,3,5,0,3,8
36446,105,68,16,3,18,87
36447,148,80,38,0,30,118
36448,27,9,14,0,4,23
36449,33,23,5,1,4,29
36450,17,4,9,0,4,13
36451,324,159,67,37,61,263
36452,4,0,1,3,0,4
36453,256,113,97,5,41,215
36454,194,101,35,22,36,158
36455,30,15,3,4,8,22
36456,628,352,155,19,102,526
36457,39,18,7,8,6,33
36458,65,21,33,0,11,54
36459,90,27,39,1,23,67
36460,119,70,8,12,29,90
36461,260,117,82,17,44,216
36462,432,200,140,11,81,351
36463,48,10,29,0,9,39
36464,10,1,8,0,1,9
36465,123,65,25,11,22,101
36466,81,42,9,19,11,70
36467,28,14,4,5,5,23
36468,78,20,26,15,17,61
36469,68,34,23,0,11,57
36470,58,5,41,1,11,47
36471,97,38,43,2,14,83
36472,140,58,33,18,31,109
36473,28,14,6,3,5,23
36474,42,15,22,1,4,38
36475,41,22,5,6,8,33
36476,79,34,29,1,15,64
36477,82,36,25,10,11,71
36478,107,32,38,10,27,80
36479,255,57,64,82,52,203
36480,192,85,62,13,32,160
36481,91,40,32,5,14,77
36482,78,52,15,1,10,68
36483,91,40,27,0,24,67
36484,37,16,14,0,7,30
36485,13,8,4,0,1,12
36486,147,45,62,3,37,110
36487,21,5,11,1,4,17
36488,133,103,11,0,19,114
36489,42,22,10,0,10,32
36490,49,34,5,0,10,39
36491,33,7,19,1,6,27
36492,183,70,44,30,39,144
36493,165,112,24,1,28,137
36494,38,23,5,2,8,30
36495,191,140,14,0,37,154
36496,78,23,39,3,13,65
36497,497,251,92,51,103,394
36498,75,36,20,0,19,56
36499,26,8,14,0,4,22
36500,122,65,38,9,10,112
36501,28,14,8,0,6,22
36502,31,10,7,9,5,26
36503,558,384,51,1,122,436
36504,114,46,25,21,22,92
36505,94,30,24,21,19,75
36506,31,16,5,2,8,23
36507,8,5,2,0,1,7
36508,71,5,50,1,15,56
36509,20,12,0,6,2,18
36510,70,47,10,0,13,57
36511,24,12,7,0,5,19
36512,26,16,5,0,5,21
36513,73,41,12,1,19,54
36514,29,2,21,1,5,24
36515,47,23,15,0,9,38
36516,71,38,20,2,11,60
36517,136,55,53,2,26,110
36518,26,1,21,1,3,23
36519,200,13,148,0,39,161
36520,214,54,31,94,35,179
36521,222,147,22,3,50,172
36522,37,14,4,10,9,28
36523,51,32,9,1,9,42
36524,78,36,4,26,12,66
36525,55,33,10,0,12,43
36526,221,121,64,0,36,185
36527,7,2,2,2,1,6
36528,104,48,32,5,19,85
36529,67,20,30,3,14,53
36530,84,36,25,4,19,65
36531,125,38,56,6,25,100
36532,204,112,29,22,41,163
36533,295,181,47,0,67,228
36534,24,5,13,0,6,18
36535,253,80,122,11,40,213
36536,81,20,42,4,15,66
36537,55,31,14,1,9,46
36538,64,40,12,1,11,53
36539,139,107,8,2,22,117
36540,35,17,3,8,7,28
36541,463,137,196,30,100,363
36542,114,35,47,10,22,92
36543,41,22,11,2,6,35
36544,172,121,14,2,35,137
36545,42,27,10,1,4,38
36546,40,21,12,2,5,35
36547,55,21,17,4,13,42
36548,69,16,35,0,18,51
36549,211,77,89,2,43,168
36550,105,38,4,49,14,91
36551,25,6,10,3,6,19
36552,84,28,28,10,18,66
36553,41,24,12,0,5,36
36554,434,136,189,12,97,337
36555,122,44,17,39,22,100
36556,62,45,1,0,16,46
36557,153,99,3,17,34,119
36558,35,20,7,0,8,27
36559,62,19,32,1,10,52
36560,24,7,11,0,6,18
36561,137,94,18,1,24,113
36562,12,4,5,0,3,9
36563,27,22,2,3,0,27
36564,63,35,15,0,13,50
36565,256,149,22,33,52,204
36566,137,58,26,23,30,107
36567,72,22,35,2,13,59
36568,40,32,3,0,5,35
36569,28,12,13,0,3,25
36570,40,18,7,2,13,27
36571,122,46,4,53,19,103
36572,101,30,37,13,21,80
36573,104,49,35,4,16,88
36574,6,4,0,2,0,6
36575,12,6,6,0,0,12
36576,40,17,16,2,5,35
36577,137,50,45,18,24,113
36578,668,369,164,23,112,556
36579,195,126,25,7,37,158
36580,12,1,9,0,2,10
36581,32,21,9,0,2,30
36582,39,23,8,0,8,31
36583,48,26,16,0,6,42
36584,27,12,11,0,4,23
36585,13,6,4,2,1,12
36586,341,141,126,6,68,273
36587,516,366,44,1,105,411
36588,7,1,4,0,2,5
36589,25,6,10,3,6,19
36590,41,19,10,1,11,30
36591,7,2,5,0,0,7
36592,161,122,9,4,26,135
36593,243,179,13,0,51,192
36594,522,360,49,1,112,410
36595,140,42,65,4,29,111
36596,34,16,6,1,11,23
36597,30,15,7,0,8,22
36598,66,51,1,0,14,52
36599,19,10,6,1,2,17
36600,111,64,23,7,17,94
36601,2,0,1,0,1,1
36602,8,2,0,4,2,6
36603,30,22,0,0,8,22
36604,93,60,15,0,18,75
36605,281,176,42,0,63,218
36606,105,22,50,15,18,87
36607,32,21,9,0,2,30
36608,75,21,35,2,17,58
36609,121,99,3,3,16,105
36610,62,43,8,4,7,55
36611,134,111,5,0,18,116
36612,179,89,42,7,41,138
36613,114,50,47,3,14,100
36614,65,24,21,7,13,52
36615,24,4,14,2,4,20
36616,82,16,42,3,21,61
36617,32,21,9,0,2,30
36618,205,136,22,0,47,158
36619,18,9,7,1,1,17
36620,236,155,35,0,46,190
36621,273,130,76,12,55,218
36622,21,1,15,0,5,16
36623,122,50,30,18,24,98
36624,223,74,85,15,49,174
36625,102,32,29,22,19,83
36626,258,105,98,6,49,209
36627,513,273,86,49,105,408
36628,123,62,39,0,22,101
36629,193,61,80,13,39,154
36630,145,63,52,1,29,116
36631,36,9,19,0,8,28
36632,60,31,13,6,10,50
36633,274,98,118,14,44,230
36634,120,38,50,7,25,95
36635,111,49,29,13,20,91
36636,157,66,53,15,23,134
36637,157,101,3,17,36,121
36638,113,53,25,13,22,91
36639,21,8,5,0,8,13
36640,133,74,14,19,26,107
36641,285,79,38,120,48,237
36642,446,142,183,21,100,346
36643,74,36,20,5,13,61
36644,17,5,6,2,4,13
36645,61,19,23,5,14,47
36646,46,7,26,6,7,39
36647,22,13,2,0,7,15
36648,27,5,19,0,3,24
36649,40,27,1,1,11,29
36650,50,24,10,7,9,41
36651,76,15,31,15,15,61
36652,36,23,1,0,12,24
36653,4,1,0,3,0,4
36654,181,40,91,1,49,132
36655,85,53,17,2,13,72
36656,102,40,23,15,24,78
36657,159,123,13,1,22,137
36658,58,32,16,0,10,48
36659,107,47,38,1,21,86
36660,10,2,5,0,3,7
36661,8,2,4,0,2,6
36662,78,29,26,7,16,62
36663,32,6,20,1,5,27
36664,138,79,13,19,27,111
36665,57,33,10,0,14,43
36666,97,55,16,8,18,79
36667,421,196,122,13,90,331
36668,16,8,4,0,4,12
36669,90,25,53,0,12,78
36670,73,30,20,1,22,51
36671,44,16,19,1,8,36
36672,50,29,13,0,8,42
36673,40,30,1,2,7,33
36674,321,144,105,6,66,255
36675,105,37,27,22,19,86
36676,154,58,36,23,37,117
36677,46,23,16,1,6,40
36678,14,2,10,0,2,12
36679,124,51,38,14,21,103
36680,25,16,5,1,3,22
36681,8,6,0,0,2,6
36682,47,12,18,8,9,38
36683,31,10,10,4,7,24
36684,32,18,7,0,7,25
36685,51,29,9,0,13,38
36686,365,190,105,5,65,300
36687,34,17,12,0,5,29
36688,161,124,7,0,30,131
36689,226,60,120,7,39,187
36690,51,30,14,0,7,44
36691,3,0,2,0,1,2
36692,59,32,17,0,10,49
36693,62,18,33,1,10,52
36694,89,23,35,10,21,68
36695,165,57,54,25,29,136
36696,133,103,1,1,28,105
36697,56,26,24,0,6,50
36698,11,4,4,0,3,8
36699,7,2,4,0,1,6
36700,105,35,46,4,20,85
36701,275,206,15,0,54,221
36702,86,31,31,4,20,66
36703,112,42,29,18,23,89
36704,230,60,98,15,57,173
36705,78,43,18,3,14,64
36706,25,17,1,0,7,18
36707,12,7,3,0,2,10
36708,37,7,15,3,12,25
36709,46,18,20,0,8,38
36710,19,16,0,0,3,16
36711,1,1,0,0,0,1
36712,61,17,33,1,10,51
36713,8,2,5,0,1,7
36714,19,6,8,0,5,14
36715,340,144,120,6,70,270
36716,71,36,16,3,16,55
36717,141,78,36,0,27,114
36718,91,42,26,0,23,68
36719,25,10,8,0,7,18
36720,85,35,9,22,19,66
36721,6,1,5,0,0,6
36722,31,15,7,4,5,26
36723,106,47,35,2,22,84
36724,61,33,18,0,10,51
36725,23,11,9,1,2,21
36726,10,2,4,1,3,7
36727,75,10,50,0,15,60
36728,31,9,15,2,5,26
36729,104,36,37,6,25,79
36730,48,27,15,1,5,43
36731,16,8,4,0,4,12
36732,30,12,14,0,4,26
36733,6,0,4,0,2,4
36734,74,37,24,4,9,65
36735,128,58,38,11,21,107
36736,101,28,47,8,18,83
36737,34,0,29,0,5,29
36738,171,113,27,1,30,141
36739,16,8,4,0,4,12
36740,98,42,34,4,18,80
36741,63,6,9,29,19,44
36742,98,43,28,1,26,72
36743,194,93,61,0,40,154
36744,15,3,7,3,2,13
36745,39,27,5,2,5,34
36746,285,147,79,12,47,238
36747,147,63,28,21,35,112
36748,53,18,22,7,6,47
36749,91,23,50,2,16,75
36750,42,19,12,2,9,33
36751,116,45,13,38,20,96
36752,26,8,8,0,10,16
36753,231,101,15,75,40,191
36754,63,32,23,1,7,56
36755,4,1,3,0,0,4
36756,11,4,2,0,5,6
36757,64,33,14,0,17,47
36758,71,35,12,6,18,53
36759,206,136,22,0,48,158
36760,57,30,8,9,10,47
36761,12,4,7,0,1,11
36762,19,8,8,0,3,16
36763,81,38,5,15,23,58
36764,19,12,5,0,2,17
36765,1058,390,423,46,199,859
36766,68,37,17,1,13,55
36767,21,6,12,0,3,18
36768,628,348,157,22,101,527
36769,41,21,15,0,5,36
36770,67,35,10,6,16,51
36771,30,8,14,0,8,22
36772,143,106,8,0,29,114
36773,22,12,2,4,4,18
36774,23,9,2,3,9,14
36775,7,3,4,0,0,7
36776,63,19,29,1,14,49
36777,107,38,26,24,19,88
36778,25,5,1,15,4,21
36779,34,14,11,0,9,25
36780,23,5,14,0,4,19
36781,119,64,36,9,10,109
36782,148,75,50,10,13,135
36783,69,19,38,0,12,57
36784,118,24,56,16,22,96
36785,36,13,15,0,8,28
36786,126,74,21,3,28,98
36787,21,1,4,12,4,17
36788,72,17,33,3,19,53
36789,47,12,26,3,6,41
36790,65,48,12,0,5,60
36791,74,39,21,0,14,60
36792,160,111,23,0,26,134
36793,215,153,48,3,11,204
36794,138,74,33,0,31,107
36795,87,6,65,4,12,75
36796,280,144,80,0,56,224
36797,39,20,12,0,7,32
36798,140,59,39,15,27,113
36799,44,21,16,0,7,37
36800,13,9,1,0,3,10
36801,74,42,12,4,16,58
36802,33,13,8,7,5,28
36803,28,13,9,0,6,22
36804,133,88,23,0,22,111
36805,177,75,25,30,47,130
36806,37,22,5,2,8,29
36807,417,235,82,15,85,332
36808,23,10,4,2,7,16
36809,173,82,54,3,34,139
36810,217,109,77,3,28,189
36811,69,56,0,2,11,58
36812,16,8,5,0,3,13
36813,53,23,18,1,11,42
36814,278,96,126,13,43,235
36815,35,1,29,0,5,30
36816,79,37,21,3,18,61
36817,24,11,9,1,3,21
36818,76,48,13,1,14,62
36819,29,15,8,0,6,23
36820,47,28,11,3,5,42
36821,75,17,43,0,15,60
36822,57,21,25,1,10,47
36823,97,42,34,5,16,81
36824,361,191,103,4,63,298
36825,68,32,14,13,9,59
36826,68,30,29,0,9,59
36827,41,21,8,2,10,31
36828,53,33,6,2,12,41
36829,45,7,28,3,7,38
36830,41,20,9,0,12,29
36831,97,25,40,8,24,73
36832,58,38,3,1,16,42
36833,5,3,1,0,1,4
36834,455,205,159,11,80,375
36835,8,2,4,1,1,7
36836,49,20,19,1,9,40
36837,37,19,11,0,7,30
36838,96,52,24,4,16,80
36839,76,41,19,0,16,60
36840,31,17,4,0,10,21
36841,51,20,25,1,5,46
36842,76,27,7,27,15,61
36843,53,12,23,1,17,36
36844,74,35,16,0,23,51
36845,39,2,18,13,6,33
36846,4,0,2,1,1,3
36847,36,16,17,0,3,33
36848,18,7,6,0,5,13
36849,49,24,11,2,12,37
36850,270,142,67,0,61,209
36851,111,66,21,7,17,94
36852,281,63,151,3,64,217
36853,129,59,41,4,25,104
36854,216,124,68,6,18,198
36855,49,13,18,9,9,40
36856,44,37,2,0,5,39
36857,45,12,20,0,13,32
36858,93,32,40,7,14,79
36859,32,21,9,0,2,30
36860,15,9,2,0,4,11
36861,23,7,9,1,6,17
36862,27,14,6,3,4,23
36863,154,113,14,0,27,127
36864,88,33,15,14,26,62
36865,156,69,26,23,38,118
36866,19,7,9,1,2,17
36867,64,27,20,2,15,49
36868,81,1,62,0,18,63
36869,134,53,45,14,22,112
36870,62,41,5,0,16,46
36871,7,3,2,0,2,5
36872,148,108,6,0,34,114
36873,50,8,30,2,10,40
36874,100,53,22,1,24,76
36875,207,91,62,18,36,171
36876,197,95,58,1,43,154
36877,27,14,10,2,1,26
36878,101,66,1,12,22,79
